border_size=1
usage=map

Mm, Mm, Mm, Mm, Mm, Mm, Mm, Mm, Mm, Mm, Mm, Mm, Mm, Hh, Hh^Fms, Gs^Fms, Gll, Gll, Gs^Fms, Gs, Gs^Fms, Gs, Gs, Gs, Hh, Gs, Gs, Gs, Gs, Gs, Gs, Gs, Gs, Gs, Hh, Gs, Hh^Fms, Hh, Hh^Fms, Hh, Hh^Fms, Hh^Fms, Hh^Fms, Gs, Hh, Gs, Gs^Fms, Gs^Fms, Gs, Gll, Gs^Fms, Gs, Gs
Mm, Mm, Mm, Mm, Mm, Mm, Mm, Mm, Mm, Mm, Mm, Mm, Mm, Hh, Hh, Gs^Fms, Gs^Fms, Gs^Fms, Gll, Gs, Gs, Gs^Fms, Gll, Gs, Hh, Gs, Gs, Gs, Gs, Gs, Gs^Fms, Gs, Gs, Hh, Hh, Hh^Fms, Hh^Fms, Hh^Fms, Hh^Fms, Hh^Fms, Hh^Fms, Hh^Fms, Hh, Hh, Gs, Gs^Fms, Gs, Gs, Gs^Fms, Gll, Gs, Gs^Fms, Gs
Mm, Mm, Mm, Mm, Mm, Mm, Mm, Mm, Mm, Mm, Mm, Mm, Hh, Hh, Hh^Fms, Hh^Fms, Gs^Fms, Gs^Fms, Gs^Fms, Gll, Gll, Gs^Fms, Gs^Fms, Hh, Hh, Hh, Gs^Fms, Gs^Fms, Gll, Gs^Fms, Gll, Gs, Gs, Hh, Hh, Hh, Hh, Hh^Fms, Hh^Fms, Hh^Fms, Hh, Hh, Hh, Gs, Gs, Gs, Gs^Fms, Gs^Fms, Gll, Gs, Gs^Fms, Gs^Fms, Gs
Mm, Mm, Mm, Mm, Mm, Mm, Hh, Mm, Hh, Hh, Hh, Hh, Hh, Hh, Hh^Fms, Gll, Gs^Fms, Gs^Fms, Gs^Fms, Gs^Fms, Gll, Gs^Fms, Hh, Hh^Fms, Hh^Fms, Hh, Gs^Fms, Gll, Gs, Gs, Gs^Fms, Gs, Gs^Efm, Gs, Gs, Gs, Hh, Hh, Hh, Hh, Hh, Hh, Gs, Gs, Gs, Gll, Gs^Fms, Gll, Gs^Fms, Gs^Fms, Gll, Gs, Gs
Mm, Mm, Mm, Mm, Hh, Hh, Hh^Fms, Hh^Fms, Hh^Fms, Hh, Hh^Fms, Hh^Fms, Gll, Hh^Fms, Gs^Fms, Gs^Fms, Gll, Gll, Gs^Fms, Gs^Fms, Gll, Gs^Fms, Hh^Fms, Hh^Fms, Hh^Fms, Hh^Fms, Gs^Fms, Gs, Gs, Gs, Gs^Efm, Gs^Efm, Gs, Gs^Es, Gs, Gs, Gs, Hh, Gs, Hh, Gs^Eff, Gs, Gs, Gs, Gs^Fms, Gll, Gs^Fms, Gs^Fms, Gll, Gs^Fms, Gs^Fms, Gll, Gll
Mm, Mm, Hh, Hh, Hh^Fms, Gs, Gll, Hh^Fms, Hh^Fms, Hh^Fms, Gs^Fms, Gs^Fms, Gs^Fms, Gs^Fms, Gs^Fms, Gs^Fms, Gll, Gs^Fms, Gs^Fms, Re^Vct, Hh, Hh, Hh^Fms, Hh^Fms, Hh^Fms, Hh^Fms, Gs^Fms, Gs, Gs^Fms, Gs, Gs^Efm, Gs, Gs, Gs, Gs^Eff, Gs, Gs, Gs, Gs^Eff, Gs^Eff, Rmo^Vdm, Gs^Eff, Gs^Eff, Gs, Gs^Fms, Gs, Gs, Gll, Gs^Fms, Gll, Gs^Fms, Gs^Fms, Gll
Mm, Mm, Hh, Hh^Fms, Gs^Fms, Gs^Fms, Gs^Fms, Gs^Fms, Gs^Fms, Gs^Fms, Gs^Fms, Gs^Fms, Gll, Gs^Fms, Gs^Fms, Gll, Gs^Fms, Gs^Fms, Gs, Gs, Hh, Hh^Fms, Hh^Fms, Hh^Fms, Hh^Fms, Hh^Fms, Hh, Gs, Gll, Gs^Fms, Gs^Fms, Gs^Efm, Gs^Eff, Gs^Eff, Gs^Gvs, Gs^Eff, Gs^Eff, Gs^Eff, Re, Gs^Gvs, Gs^Gvs, Gs^Gvs, Gs^Gvs, Gs^Eff, Gs^Fms, Gs, Gs^Efm, Gs^Efm, Gs^Fms, Gs^Fms, Gll, Gll, Gs
Mm, Mm, Hh, Hh^Fms, Gs^Fms, Gs^Fms, Gll, Gs, Gll, Gs^Fms, Gs^Fms, Gll, Gs^Fms, Gs^Fms, Gs^Fms, Gll, Ce, Ce, Ce, Gs, Gs, Gs^Fms, Gs^Fms, Hh^Fms, Gs^Fms, Hh, Gll, Gs^Es, Gs, Gs^Fms, Gs^Eff, Gs^Eff, Rmo^Vdm, Gs^Gvs, Gs^Gvs, Gs^Gvs, Gs^Gvs, Re, Gs^Eff, Gs^Gvs, Gs^Gvs, Gs^Gvs, Gs^Eff, Gs^Eff, Gs, Gll, Gs^Efm, Gs, Gll, Gs^Fms, Gll, Gll, Gs
Mm, Mm, Hh, Hh, Gll, Gs^Fms, Gll, Gll, Gs^Fms, Gs^Fms, Gs, Gs^Fms, Gs^Fms, Gs^Fms, Gs, Gs, Ce, 2 Ke, Ce, Gs, Gs, Gs, Gs, Gs^Fms, Gs, Gs^Fms, Gs^Fms, Gs, Gs, Gs, Gs, Gs^Eff, Gs^Eff, Gs^Gvs, Gs^Gvs, Gs^Gvs, Re, Re, Gs^Gvs, Gs^Eff, Gs^Eff, Gs^Eff, Gs, Gs, Gs^Efm, Gs^Fms, Gs^Fms, Gs^Fms, Gs^Fms, Gs^Fms, Gs^Fms, Gs^Fms, Gs^Fms
Hh, Hh, Hh^Fms, Hh^Fms, Gs^Fms, Gs^Fms, Gll, Gs^Fms, Gll, Gll, Gll, Gll, Gs^Fms, Gs^Fms, Gs, Gs, Gs, Ce, Gs^Es, Gs, Gs^Fms, Gs, Gs, Gs^Es, Gs, Gs, Gs, Rmo^Vdm, Re, Gs, Gs^Eff, Gs^Eff, Gs^Gvs, Gs^Eff, Re, Re, Gs^Gvs, Gs^Gvs, Gs^Gvs, Gs^Gvs, Gs^Gvs, Gs^Eff, Gs^Eff, Gs, Gs^Efm, Gs, Gll, Gs^Fms, Gll, Gll, Gs^Fms, Gs, Gs
Hh^Fms, Hh^Fms, Hh^Fms, Hh^Fms, Gs^Fms, Gs^Fms, Gs^Fms, Gs^Fms, Gll, Gs, Gs^Fms, Gs^Fms, Gs, Gs^Fms, Gs, Gs, Gs, Gs, Gs^Fms, Gll, Gll, Gll, Gs^Fms, Gs, Gs, Gs, Gs^Efm, Gs, Re, Gs^Fms, Gs^Gvs, Gs^Gvs, Gs^Gvs, Gs^Gvs, Gs^Gvs, Gs^Eff, Gs^Eff, Gs^Gvs, Rmo^Vdm, Gs^Gvs, Gs^Eff, Gs^Eff, Gs, Gs^Efm, Gs, Gs, Gll, Gs^Fms, Gs^Fms, Gs^Fms, Gs, Gs^Es, Gll
Gs^Fms, Hh^Fms, Gs^Fms, Gs^Fms, Gs^Fms, Gs^Fms, Gs^Fms, Gll, Gs^Fms, Gs^Fms, Gll, Gll, Gs, Re^Vct, Gs, Gs^Es, Gs^Fms, Gs^Fms, Re^Vct, Gs^Fms, Gs^Fms, Gs^Fms, Gs^Fms, Gs^Fms, Gs, Gs^Efm, Gs^Efm, Gs, Re, Gs^Fms, Gs^Fms, Gs^Gvs, Rmo^Vdm, Gs^Gvs, Re, Gs^Eff, Re, Re, Gs^Fms, Gs^Eff, Gs, Gs^Fms, Gs^Fms, Gs^Fms, Gs, Gs, Gs^Fms, Gs^Fms, Gs^Fms, Gll, Gll, Gll, Gs
Gll, Gs^Fms, Gll, Gs^Fms, Gs^Fms, Gll, Gll, Gs^Fms, Gll, Gs^Fms, Gs, Gs, Gs, Gs, Gs^Fms, Gs^Fms, Gll, Gs^Fms, Gs^Fms, Gs^Fms, Gll, Gs^Fms, Gll, Gs^Fms, Gs^Fms, Gs, Gs, Gs^Efm, Gs, Re, Gs, Gs^Eff, Gs^Eff, Gs^Eff, Gs, Re, Re, Gs^Fms, Gs^Fms, Gs, Gll, Gs^Fms, Gll, Gs, Gs^Fms, Gs, Gs, Gs^Fms, Gll, Gs^Fms, Gs^Fms, Gs^Fms, Gs
Gs^Fms, Gs^Fms, Gll, Gs^Fms, Gs^Fms, Gs^Fms, Gs^Fms, Gll, Gll, Gs, Gs, Gs, Gs, Gs, Gs^Fms, Gll, Gs^Fms, Gs^Fms, Gs^Fms, Gs, Gll, Gs^Es, Gs^Es, Gll, Gs^Fms, Gs, Gs, Gs, Re, Re, Gs, Gs, Hh, Hh, Hh, Gs, Gs, Re, Gs^Fms, Gll, Gs^Fms, Gll, Gs^Fms, Gs^Fms, Gs^Fms, Gs^Fms, Gll, Gll, Gs^Fms, Hh, Gs^Fms, Hh^Fms, Hh^Fms
Gll, Gs^Fms, Gs^Fms, Gs^Fms, Gll, Gll, Gs^Fms, Gll, Gs, Gs, Gs, Gs, Gll, Gs^Fms, Gll, Gs^Fms, Gll, Gll, Hh^Fms, Gll, Hh^Fms, Gs, Gs^Fms, Gs^Fms, Gs, Gs, Re, Re, Gs, Gs, Hh, Hh, Hh^Fms, Hh^Fms, Hh^Fms, Hh, Gs, Re, Gs, Gs^Fms, Gs^Fms, Gs^Fms, Gs^Fms, Gs^Fms, Gll, Gs^Fms, Gs^Fms, Gs^Fms, Gs^Fms, Hh, Hh^Fms, Hh^Fms, Hh^Fms
Gs, Gll, Hh^Fms, Gs^Fms, Hh, Gs^Fms, Gll, Gs, Gs, Gs^Fms, Gs^Fms, Gll, Gs^Fms, Gs^Fms, Gll, Gs^Fms, Gs^Fms, Hh^Fms, Hh, Hh^Fms, Hh, Hh^Fms, Hh^Fms, Gs, Gs^Eff, Gs^Eff, Rmo^Vdm, Gs^Eff, Gs^Eff, Gs, Gs, Hh, Hh, Hh^Fms, Hh^Fms, Hh, Hh, Re, Re, Gs, Gs^Fms, Gs^Fms, Gs^Fms, Gs^Es, Gs^Fms, Gs^Fms, Gs^Fms, Gll, Hh^Fms, Hh, Hh^Fms, Hh^Fms, Hh^Fms
Gs, Gs, Hh^Fms, Hh^Fms, Hh^Fms, Hh, Hh, Gs, Gs, Gs^Fms, Gs, Gll, Gs^Fms, Gs^Fms, Gs, Gs, Hh^Fms, Hh^Fms, Hh, Hh, Hh, Hh, Hh, Gs, Re, Gs^Gvs, Gs^Gvs, Gs^Gvs, Gs^Gvs, Gs^Eff, Gs^Eff, Hh, Gs, Hh, Hh, Hh^Fms, Hh, Gs, Re, Gs^Fms, Gs, Gs^Fms, Gs^Fms, Gll, Gs^Fms, Gs^Fms, Gs^Fms, Gll, Hh^Fms, Gs^Fms, Hh^Fms, Hh^Fms, Hh^Fms
Gs, Hh^Fms, Hh^Fms, Hh^Fms, Hh^Fms, Hh^Fms, Hh, Gs, Gs, Gll, Gs, Gs, Gll, Gs^Fms, Gs^Fms, Gll, Gs, Hh, Hh, Hh, Hh, Hh^Fms, Gs, Re, Gs^Eff, Gs^Gvs, Gs^Gvs, Gs^Gvs, Gs^Eff, Gs^Eff, Gs^Gvs, Gs^Eff, Gs^Eff, Gs, Hh, Hh^Fms, Hh, Gs, Re, Gs, Gs, Gs, Gs, Gs^Fms, Gs^Fms, Gll, Gs^Fms, Gs, Gs, Hh, Hh^Fms, Hh^Fms, Hh^Fms
Gll, Gs^Fms, Hh^Fms, Hh^Fms, Hh^Fms, Hh, Hh, Gs, Gs^Es, Gll, Gs, Gs, Gs, Gll, Gs, Gll, Gs, Hh, Hh^Fms, Hh^Fms, Hh^Fms, Hh^Fms, Gs, Rmo^Vdm, Re, Gs^Eff, Gs^Eff, Gs^Eff, Gs^Gvs, Gs^Gvs, Gs^Gvs, Gs^Gvs, Gs^Gvs, Gs^Eff, Gs^Eff, Hh, Gs, Gs, Re, Gs^Fms, Gs^Fms, Gs^Fms, Gs, Gs, Gs^Fms, Gs^Fms, Gs^Fms, Gll, Gll, Hh, Hh, Hh^Fms, Hh
Gs, Gll, Gs^Fms, Hh^Fms, Hh^Fms, Hh^Fms, Hh, Gs, Gll, Gll, Gs^Fms, Gs, Gs^Efm, Gs, Gs, Gs^Fms, Gs, Gs, Gs, Gs^Es, Gs, Gs, Gs^Efm, Gs, Rmo, Gs, Gs, Gs^Eff, Gs^Eff, Gs^Gvs, Gs^Gvs, Gs^Gvs, Gs^Eff, Gs^Eff, Gs^Gvs, Gs^Eff, Gs^Eff, Gs, Re, Gs^Fms, Gs, Gs, Gs^Fms, Gs^Fms, Gs^Fms, Gs^Fms, Gs^Fms, Gs^Fms, Gs^Fms, Gs^Fms, Gs^Fms, Hh, Gs
Gs, Gll, Gll, Gs^Fms, Gs^Fms, Hh^Fms, Gll, Gll, Gs^Fms, Gs^Fms, Gs^Fms, Gs^Fms, Gs, Gs^Efm, Gs^Efm, Gs, Gs, Gs^Efm, Gs, Gs, Gs, Gs, Gs, Rmo, Cd, Cd, Cd, Gs, Gs, Gs^Eff, Gs^Eff, Gs^Eff, Gs^Gvs, Gs^Gvs, Gs^Gvs, Gs^Gvs, Rmo^Vdm, Gs^Eff, Gs^Eff, Re, Gs, Gs, Gs^Fms, Gs^Fms, Gs^Fms, Gs^Fms, Gll, Gs^Fms, Gs^Fms, Gs^Fms, Gs^Fms, Gs^Fms, Gs^Fms
Gll, Gs^Fms, Gs^Fms, Gs^Fms, Gs, Gs^Fms, Gs^Fms, Gs^Fms, Gs^Fms, Gs^Fms, Gs^Fms, Gs^Fms, Gs^Fms, Gs^Efm, Gs, Gs^Efm, Gs, Gs^Efm, Gs^Efm, Gs, Gs, Gs, Cd, Rmo, Rmo, Gs, Gs^Ecf, Cd, Rmo, Rmo, Rmo, Rmo, Gs^Eff, Gs^Gvs, Gs^Gvs, Gs^Gvs, Gs^Eff, Gs^Eff, Re, Re, Gs^Es, Gs, Gs^Fms, Gll, Gs^Fms, Gs^Fms, Gs^Fms, Gs^Fms, Gll, Gs^Fms, Gs^Fms, Gs^Fms, Gs^Fms
Gs^Fms, Gs^Fms, Gll, Gs, Gll, Gs, Gs^Fms, Gs^Fms, Gll, Gs^Fms, Gs^Fms, Gs^Fms, Gs^Fms, Gs^Fms, Gs^Fms, Gs^Fms, Gs, Gs, Gs^Efm, Gs^Efm, Gs, Cd, Rmo, Gs, Rmo, Rmo, Rmo, Rmo, Rmo, Cd, Cd, Gs, Gs, Gs^Eff, Gs^Eff, Gs^Eff, Re, Re, Gs, Gs, Gs^Fms, Gs, Gs^Fms, Gs^Fms, Gs^Fms, Gs^Fms, Gll, Gs^Fms, Gs^Fms, Gll, Gs^Fms, Gs^Fms, Gs^Fms
Gs^Fms, Gs^Fms, Gs^Fms, Gs, Gll, Gs^Fms, Gs^Fms, Gll, Gs^Fms, Gs, Gs, Gs^Fms, Rmo^Vdm, Gs^Fms, Gs, Gs, Rmo, Gs^Efm, Rmo, Gs, Gs, Cd, Gs, Rmo, Rmo, Rmo^Vdm, Rmo^Vdm, Rmo^Vdm, Rmo, Gs, Rmo, Cd, Gs, Gs, Gs, Re, Rmo^Vdm, Gs, Gs^Fms, Gs^Fms, Gs^Fms, Gs^Fms, Gll, Gs^Fms, Gs^Fms, Gs^Fms, Gs^Fms, Gll, Gs^Fms, Gs^Fms, Gs^Fms, Gs^Fms, Gs
Gll, Gs^Fms, Gs^Fms, Gll, Gll, Gs, Gs^Fms, Gll, Gs, Gs, Gs, Gs, Gs, Re, Re, Rmo, Gs, Rmo, Gs, Rmo, Rmo, Cd, Gs, Rmo, Rmo^Vdm, Cd, Cd, Cd, Rmo^Vdm, Rmo, Gs, Cd, Gs, Gs, Re, Re, Gs, Gs, Gs^Fms, Gs^Fms, Gs^Fms, Gll, Gs^Fms, Gs^Fms, Gll, Gs^Fms, Gs^Fms, Gs^Fms, Gs^Fms, Gs^Fms, Gs^Fms, Gs^Fms, Gs^Fms
Gs, Gll, Gs^Fms, Gll, Gs, Gll, Gs^Fms, Gs^Fms, Gs, Gs, Gs, Gs, Re^Vct, Re, Gs, Gs^Fms, Gs, Gs^Efm, Gs, Re, Gs, Rmo, Rmo, Rmo, Rmo^Vdm, Cd, 4 Kd, Cd, Rmo^Vdm, Rmo, Rmo, Cd, Rmo, Re, Gs, Gs^Efm, Gs, Gs, Gs, Gs^Fms, Gs^Fms, Gs^Fms, Gs^Fms, Gll, Gll, Gs^Fms, Gll, Gs^Fms, Hh^Fms, Hh^Fms, Hh^Fms, Hh^Fms, Hh^Fms
Gs, Gs^Fms, Gll, Gll, Gs, Gll, Gs^Fms, Re^Vct, Gs, Gs, Gs, Gs, Gs, Gs, Gs, Gs^Fms, Gs^Fms, Gs, Gs, Rmo^Vdm, Gs, Cd, Gs^Ecf, Rmo, Rmo, Cd, Cd, Cd, Rmo, Rmo, Gs^Ecf, Rmo, Gs, Re, Re, Gs^Es, Gs^Efm, Gs, Gs, Gs, Gs^Fms, Gs^Fms, Gs^Fms, Gll, Gs, Gs^Fms, Gs^Fms, Hh^Fms, Hh^Fms, Hh^Fms, Hh^Fms, Hh^Fms, Hh^Fms
Gs, Gs^Fms, Gll, Gs^Fms, Gs^Fms, Gs^Fms, Gs^Fms, Gs^Fms, Gs, Gs^Es, Gs, Gs, Gs, Gs, Gll, Gll, Gs^Fms, Gs, Gs, Gs, Gs, Cd, Rmo, Rmo, Rmo, Rmo^Vdm, Rmo, Rmo^Vdm, Rmo, Rmo, Rmo, Cd, Gs, Gs, Gs, Rmo^Vdm, Gs^Efm, Gs, Gs, Gs^Fms, Gs^Fms, Gll, Gs^Fms, Gll, Gll, Gs, Gll, Hh^Fms, Hh^Fms, Hh^Fms, Hh^Fms, Hh^Fms, Hh^Fms
Gs^Fms, Gs^Fms, Gs^Fms, Gs^Fms, Gll, Gs^Fms, Gs^Fms, Gs^Fms, Gs, Gs, Ce, Gs, Gs, Gs^Fms, Gs^Fms, Gs^Fms, Gs, Gs, Gs^Efm, Gs, Gs, Cd, Cd, Gs, Rmo, Rmo, Rmo, Rmo, Rmo, Gs, Cd, Cd, Gs, Gs, Gs, Gs, Gs, Gs, Gs^Fms, Gs^Fms, Gs^Fms, Gs^Fms, Gll, Gll, Gs, Gll, Gs^Fms, Hh^Fms, Hh^Fms, Hh^Fms, Hh^Fms, Hh^Fms, Hh^Fms
Gs^Fms, Gs^Fms, Gs^Fms, Gll, Gll, Gll, Gll, Gll, Gs, Ce, 3 Ke, Ce, Gs, Gs^Fms, Gs^Fms, Gs^Fms, Gs, Gs, Gs, Rmo^Vdm, Re, Gs, Gs, Cd, Rmo, Gs, Gs, Gs, Rmo, Rmo, Rmo, Gs, Gs, Gs, Gs, Gs^Efm, Gs, Gs^Fms, Gll, Gll, Gs^Fms, Gs^Fms, Gs, Gs, Gs, Gll, Gs^Fms, Gs^Fms, Hh^Fms, Hh^Fms, Hh^Fms, Hh^Fms, Hh^Fms
Gs^Fms, Gs^Fms, Gs^Fms, Gs^Fms, Gs^Fms, Gs^Fms, Gs^Fms, Gs, Gs, Ce, Ce, Ce, Gs, Gll, Gs^Fms, Gll, Gll, Gs, Gs, Gs, Gs, Re, Rmo, Rmo, Rmo, Cd, Cd, Cd, Gs, Rmo, Rmo, Rmo, Gs, Gs, Gs^Efm, Gs, Gs, Gs^Fms, Gs^Fms, Gs^Fms, Gs^Fms, Gll, Gs, Gs, Gs^Fms, Gs^Fms, Gs^Fms, Gs^Fms, Gll, Hh^Fms, Gs^Fms, Hh^Fms, Hh^Fms
Gs^Fms, Gs^Fms, Gs^Fms, Gs^Fms, Gll, Gll, Gll, Gs^Fms, Gs^Fms, Gs, Gs, Gs, Gs^Fms, Gs^Fms, Gs, Gs, Gs^Fms, Gs, Gs, Gs^Efm, Gs^Efm, Rmo, Rmo, Rmo, Gs, Gs, Gs, Gs, Re, Re, Rmo, Rmo, Rmo, Gs, Gs, Gs, Gs, Gs^Fms, Gs^Fms, Gll, Gs^Fms, Gll, Gs, Gs^Fms, Gs^Fms, Gll, Gs^Fms, Gll, Gs^Fms, Gs^Fms, Gll, Hh^Fms, Gs^Fms
Gs^Fms, Gs^Fms, Gs^Fms, Gs^Fms, Gs, Gll, Gs^Fms, Re^Vct, Gs^Fms, Gs, Gs, Gs, Gll, Gs, Gs, Gs, Gs, Gll, Gs, Gs, Rmo, Rmo, Rmo, Gs, Gs, Gs, Gs, Re, Gs^Efm, Gs, Gs, Rmo, Rmo, Rmo, Rmo, Gs, Gs, Gs^Es, Gs, Gs^Fms, Gs, Gs^Efm, Gs, Gs^Fms, Gs^Fms, Gll, Gll, Gs^Fms, Gs^Fms, Gll, Gs^Fms, Gs^Fms, Gs^Fms
Gs^Fms, Gs^Fms, Hh, Gs, Hh^Fms, Hh^Fms, Gs^Fms, Gs^Fms, Gs^Fms, Gll, Gll, Gs, Hh^Fms, Gs, Hh, Gs, Gs, Gs, Rmo, Rmo, Rmo, Rmo, Gs, Gs, Gs^Fms, Gll, Gs^Fms, Re, Gs^Efm, Gs^Efm, Gs, Gs, Gs, Rmo, Rmo, Rmo, Rmo, Gs, Gs, Gs, Gs, Gs, Gs^Fms, Gs^Fms, Gs^Fms, Gs^Fms, Gll, Gs, Gs^Fms, Gs^Fms, Gll, Gs^Fms, Gs^Fms
Gs^Fms, Gs^Fms, Hh, Hh^Fms, Hh^Fms, Hh^Fms, Hh^Fms, Gll, Gs^Fms, Gs^Fms, Gs^Fms, Hh^Fms, Hh^Fms, Hh, Hh, Gs, Rmo, Rmo, Rmo, Rmo, Gs, Gs, Gs^Fms, Gs^Fms, Gs^Fms, Gs^Fms, Gs^Fms, Re, Gs, Gs^Efm, Gs, Gs, Gs, Gs, Gs, Rmo, Rmo, Rmo, Rmo, Gs, Gs, Rmo^Vdm, Gs^Fms, Gs^Fms, Gs^Fms, Gs^Fms, Gll, Re^Vct, Gll, Gs^Fms, Gs^Fms, Gs^Fms, Gs^Fms
Gs^Fms, Gs^Fms, Gll, Hh, Hh^Fms, Hh^Fms, Hh^Fms, Gs^Fms, Gll, Gs^Fms, Gs^Fms, Hh^Fms, Hh^Fms, Hh, Gs, Rmo, Rmo, Rmo, Gs, Gs, Gs, Gs^Fms, Gs^Fms, Gll, Gs^Fms, Gs^Fms, Gs^Fms, Rmo^Vdm, Gs, Gs, Gs, Gs, Gs^Es, Gs, Gs, Gs, Gs, Rmo, Rmo, Rmo, Gs, Gs, Gs, Gs^Fms, Gs^Fms, Gs^Fms, Gs^Fms, Gll, Gs^Fms, Gs^Fms, Gs^Fms, Gll, Gs^Fms
Gll, Gll, Gs, Hh, Hh^Fms, Hh^Fms, Gs^Fms, Gs^Fms, Gs^Fms, Gs^Fms, Gs^Fms, Gs^Fms, Gll, Gs, Rmo, Rmo, Rmo, Gs, Gs, Gs, Gll, Gs^Fms, Gll, Gll, Gs^Fms, Gs^Fms, Gs^Fms, Gs^Fms, Gs, Gs, Gs^Efm, Gs, Gs, Gs, Gs, Gs, Gs, Gs, Rmo, Rmo, Rmo, Gs, Gs, Gs, Gs^Efm, Gs^Fms, Gs^Fms, Gs^Fms, Ce, Gs^Fms, Gs^Fms, Gs^Fms, Gs^Fms
Gs, Gs, Gs, Hh, Hh, Gs^Fms, Gs^Fms, Gll, Gs^Fms, Gll, Gs^Fms, Gs^Fms, Gs, Rmo, Rmo, Rmo, Gs, Gs^Es, Gs^Fms, Gs^Fms, Gll, Gs^Fms, Gll, Gs^Fms, Gll, Gll, Gs^Fms, Gs^Fms, Gs, Gs, Gs, Gs, Gs^Efm, Gs, Gs^Fms, Gs^Fms, Gs^Fms, Gs, Gs, Rmo, Rmo, Rmo, Rmo, Gs, Gs, Re^Vct, Gs, Ce, Ke, Ce, Gll, Gs^Fms, Gs^Fms
Gs, Gs, Gs, Gs, Gs, Gll, Gll, Gs^Fms, Gs^Fms, Gll, Gll, Gs, Rmo, Rmo, Rmo, Gs, Gs, Gs, Gs^Fms, Gll, Gs^Fms, Gs^Fms, Gs^Fms, Gs^Fms, Gll, Gs^Fms, Gll, Gs, Gs, Gs, Gs^Efm, Gs, Gll, Gs^Fms, Gs^Fms, Gs^Fms, Gs^Fms, Gll, Gs^Fms, Gs, Gs, Rmo, Rmo, Rmo, Rmo, Gs, Gs, 1 Ce, Ce, Ce, Gll, Gs^Fms, Gll
Gs, Gs, Gs, Gs^Es, Gs, Gs, Gll, Gs^Fms, Gs^Fms, Gs^Fms, Gs, Rmo, Rmo, Rmo, Gs, Gs, Gll, Gs^Fms, Gll, Gs^Fms, Gll, Gll, Gll, Hh^Fms, Hh^Fms, Hh^Fms, Gll, Gs^Efm, Gs, Gs, Gs, Gll, Gs^Fms, Gs^Fms, Gll, Gs^Fms, Gll, Gs^Fms, Gs^Fms, Gs^Fms, Gs^Fms, Gs, Gs, Rmo, Rmo, Rmo, Rmo, Gs, Gs, Gs, Re^Vct, Gll, Gs
Gll, Gs^Fms, Gll, Gs, Gs, Gs, Gs^Es, Gs^Vdm, Gs, Gs, Rmo, Rmo, Rmo, Gs, Gll, Gs, Gs^Fms, Gs^Fms, Gll, Gs^Fms, Gs^Fms, Gs^Fms, Hh^Fms, Hh^Fms, Hh^Fms, Hh^Fms, Hh^Fms, Gs, Gs, Gs, Hh^Fms, Hh^Fms, Hh^Fms, Gs^Fms, Gs^Fms, Gll, Gll, Gs^Fms, Gll, Gs^Fms, Gs^Fms, Gs^Fms, Gs^Fms, Gs, Gs^Efm, Rmo, Rmo, Rmo, Rmo, Gs, Gs, Gs, Gs
Gs, Gll, Gs^Fms, Gs^Fms, Gs, Gs, Gs, Gs, Rmo, Rmo, Rmo, Rmo, Gs, Gll, Gs^Fms, Gs^Fms, Hh^Fms, Gs^Fms, Gs^Fms, Gs^Fms, Gll, Gs^Fms, Hh^Fms, Hh^Fms, Hh^Fms, Hh^Fms, Hh^Fms, Gs, Gs, Hh^Fms, Hh^Fms, Hh^Fms, Hh^Fms, Hh^Fms, Gs^Fms, Gs^Fms, Gs^Fms, Gs^Fms, Gs^Fms, Gll, Gs^Fms, Gs^Fms, Gs^Fms, Gs^Fms, Gs^Efm, Gs^Efm, Gs, Rmo, Rmo, Rmo, Rmo, Gs, Gs
Gs, Gs, Gs^Fms, Gll, Gs, Gs, Rmo, Rmo, Rmo, Rmo, Gs, Gs, Gs^Fms, Gs^Fms, Gs^Fms, Hh^Fms, Hh^Fms, Hh^Fms, Gs^Fms, Gll, Gs^Fms, Gll, Hh^Fms, Hh^Fms, Hh^Fms, Hh^Fms, Hh^Fms, Gs, Gs, Hh^Fms, Hh^Fms, Hh^Fms, Hh^Fms, Hh^Fms, Hh^Fms, Gs^Fms, Gll, Gs^Fms, Gs^Fms, Gll, Gs^Fms, Gs^Fms, Gll, Gs^Fms, Gs^Fms, Gs^Fms, Gs^Fms, Gs, Gs, Rmo, Rmo, Rmo, Rmo
Gs, Gs, Gs, Gll, Rmo, Rmo, Rmo, Rmo, Gs, Gs, Gs, Gll, Gs^Fms, Gs^Fms, Hh^Fms, Hh^Fms, Hh^Fms, Hh^Fms, Hh^Fms, Gs^Fms, Gs^Fms, Gs^Fms, Hh^Fms, Hh^Fms, Hh^Fms, Hh^Fms, Hh^Fms, Gs, Gs, Hh^Fms, Hh^Fms, Hh^Fms, Hh^Fms, Hh^Fms, Hh^Fms, Gs^Fms, Gs^Fms, Gs^Fms, Gs^Fms, Gll, Gs^Fms, Gs^Fms, Gll, Gs^Fms, Gs^Fms, Gs^Fms, Gs^Fms, Gll, Gll, Gs, Gs, Rmo, Rmo
Gs, Gs, Gs, Rmo, Rmo, Rmo, Gs, Gs, Gs^Fms, Gs, Gs^Fms, Gll, Gs, Hh^Fms, Gs^Fms, Hh^Fms, Gs^Fms, Hh^Fms, Hh^Fms, Hh^Fms, Gs^Fms, Gs^Fms, Gs, Hh^Fms, Hh^Fms, Hh^Fms, Gs, Gs, Gs, Gs, Gs, Hh^Fms, Gs^Fms, Hh^Fms, Gs, Gs^Fms, Gs^Fms, Gs^Fms, Gs^Fms, Gs^Fms, Gs^Fms, Gs^Fms, Gs, Gs^Fms, Gs^Fms, Gs^Fms, Gs^Fms, Gs^Fms, Gll, Gs, Gs, Gs, Gs
