border_size=1
usage=map

Mm, Mm, Mm, Mm, Mm, Mm, Mm, Mm, Mm, Mm, Mm, Mm, Mm, Mm, Mm, Mm, Mm, Mm, Mm, Mm, Mm, Mm, Mm, Mm, Mm, Mm, Mm, Mm, Mm, Mm, Mm, Mm, Mm, Hh^Fms, Hh^Fms, Gs^Fms, Gs, Gg, Rp, Rp, Gg, Gg, Gs, Gs, Gs^Fms, Hh^Fms, Hh^Fms, Gg, Mm, Mm, Mm, Mm, Mm, Mm, Mm^Xm, Mm, Mm, Mm, Mm
Mm, Mm, Mm, Mm, Mm, Mm, Mm, Mm, Mm, Mm, Mm^Xm, Mm, Mm, Mm, Mm, Mm, Mm, Mm, Mm, Mm, Mm, Mm, Mm, Mm^Xm, Mm, Mm, Mm, Mm, Mm, Mm, Mm, Mm, Mm, Hh^Fms, Hh^Fms, Gs, Gs, Gg, Rp, Rp, Gg, Gs, Gs^Fms, Gs^Fms, Hh^Fms, Hh^Fms, Hh^Fms, Mm, Mm, Mm, Mm, Mm, Mm, Mm^Xm, Mm, Mm, Mm, Mm, Mm
Mm, Mm, Mm^Xm, Mm, Mm^Xm, Mm^Xm, Mm, Mm, Mm, Mm, Mm, Mm, Mm, Mm, Mm, Mm, Mm, Mm, Mm, Mm, Mm, Mm, Mm, Mm^Xm, Mm, Mm, Mm, Mm, Mm, Mm, Mm, Mm, Mm, Hh^Fms, Hh^Fms, Hh^Fms, Gs, Gg, Rp, Rp, Gs, Gs, Gs^Fms, Hh^Fms, Hh^Fms, Hh^Fms, Mm, Mm, Mm, Mm, Mm, Mm, Mm, Mm, Mm, Mm, Mm, Mm, Mm
Mm, Mm, Mm^Xm, Mm, Mm, Mm, Mm, Mm, Mm, Mm, Mm, Mm, Mm, Mm, Mm, Mm, Mm, Mm, Mm, Mm, Mm, Mm, Mm, Mm, Mm, Mm, Mm, Mm, Mm, Mm, Mm, Mm, Mm, Hh^Fms, Hh^Fms, Hh^Fms, Gs^Fms, Gs, Rp, Rp, Gs, Gs^Fms, Hh^Fms, Hh^Fms, Mm, Mm, Mm, Mm, Mm, Mm, Mm, Mm, Mm, Mm, Mm^Xm, Mm^Xm, Mm^Xm, Mm^Xm, Mm
Mm, Mm, Mm, Mm, Mm, Mm, Mm, Mm^Xm, Mm, Mm, Mm, Mm, Mm, Mm, Mm, Mm, Mm, Mm, Mm, Mm, Mm, Mm, Mm, Mm, Mm, Mm^Xm, Mm, Mm, Mm, Mm, Mm^Xm, Mm, Mm, Mm, Hh^Fms, Hh^Fms, Gs^Fms, Gs, Rp, Rp, Gs, Gs^Fms, Hh^Fms, Hh^Fms, Mm, Mm, Mm, Mm, Mm, Mm, Mm, Mm, Mm^Xm, Mm^Xm, Mm, Mm, Mm^Xm, Mm, Mm
Mm, Mm^Xm, Mm, Mm, Mm, Mm, Mm, Mm, Mm, Mm, Mm, Mm, Mm, Mm, Mm, Mm, Mm^Xm, Mm^Xm, Mm, Mm, Mm, Mm, Mm, Mm, Mm, Mm^Xm, Mm^Xm, Mm, Mm, Mm, Mm, Mm, Mm, Mm, Hh^Fms, Hh^Fms, Gs^Fms, Gs, Rp, Rp, Gs^Es, Gs^Fms, Gs^Fms, Hh^Fms, Mm, Mm, Mm, Mm, Mm, Mm, Mm^Xm, Mm^Xm, Mm, Mm, Mm, Mm, Mm, Mm, Mm
Mm, Mm^Xm, Mm, Mm^Xm, Mm, Mm, Mm, Mm, Mm, Mm, Mm^Xm, Mm, Mm, Mm, Mm^Xm, Mm^Xm, Mm, Mm, Mm, Mm, Mm, Mm, Mm, Mm, Mm, Mm, Mm^Xm, Mm, Mm^Xm, Mm^Xm, Mm, Mm, Mm, Mm, Hh^Fms, Hh^Fms, Gs^Fms, Gs, Rp, Rp, Gs, Re^Vct, Gs^Fms, Hh^Fms, Mm, Mm, Mm, Mm, Mm, Mm, Mm^Xm, Mm, Mm, Mm, Mm^Xm, Mm, Mm^Xm, Mm, Mm
Mm, Mm^Xm, Mm, Mm, Mm, Mm, Mm, Mm, Mm^Xm, Mm^Xm, Mm, Mm, Mm, Mm, Mm, Mm, Mm, Mm, Mm, Mm, Uu^Vud, Mm, Mm, Mm, Mm, Mm, Mm, Mm^Xm, Mm, Mm, Mm, Mm, Mm, Mm, Hh^Fms, Hh^Fms, Gs^Fms, Gs, Rp, Rp, Gs, Gs^Fms, Gs^Fms, Hh^Fms, Hh^Fms, Mm, Mm, Mm, Mm, Mm, Mm, Mm^Xm, Mm, Mm, Mm, Mm, Mm, Mm, Mm
Mm, Mm, Mm, Mm, Mm, Mm, Mm, Mm^Xm, Mm, Mm, Mm, Mm, Uu^Vud, Uu^Vud, Hh^Fms, Hh^Fms, Cud, Hh^Fms, Hh^Fms, Hh^Fms, Hh^Fms, Hh^Fms, Hh^Fms, Mm, Mm, Mm, Mm, Mm^Xm, Mm^Xm, Mm, Mm, Mm, Mm, Hh^Fms, Hh^Fms, Hh^Fms, Gs, Gs, Rp^Efm, Rp, Ce, Ce, Ce, Hh^Fms, Hh^Fms, Mm, Mm, Mm, Mm, Mm, Mm, Mm, Mm, Mm^Xm, Mm, Mm, Mm, Mm, Mm
Mm, Mm, Mm, Mm, Mm, Mm, Mm, Mm, Mm, Mm, Mm, Mm, Hh^Fms, Hh^Fms, Cud, Cud, Cud, Cud, Cud, Hh^Fms, Gs, Hh^Fms, Hh^Fms, Hh^Fms, Mm, Mm, Mm, Mm, Mm, Mm, Mm, Mm, Mm, Hh^Fms, Hh^Fms, Gs^Fms, Re^Vct, Gg^Efm, Rp, Rp^Efm, 1 Ce, Ke, Ce, Hh^Fms, Mm, Mm, Mm, Mm, Mm, Mm, Mm, Mm, Mm, Mm, Mm, Mm, Mm, Mm, Mm
Mm, Mm, Mm, Mm, Mm, Mm, Mm, Mm, Mm, Mm, Mm, Uu^Vud, Hh^Fms, Cud, Cud, Kud, Cud, Cud, Cud, Gs, Gs, Hh^Fms, Hh^Fms, Mm, Mm, Mm, Mm, Mm, Mm, Mm, Mm, Mm, Hh^Fms, Hh^Fms, Gs^Fms, Gs^Fms, Gs, Gg^Efm, Rp, Rp, Gs, Ce, Gs^Fms, Hh^Fms, Mm, Mm, Mm, Mm, Mm, Mm, Mm, Mm, Mm, Mm, Mm, Mm, Hh^Fms, Hh^Fms, Ww
Mm, Mm, Mm, Mm, Mm, Mm, Mm, Mm^Xm, Mm, Mm, Mm, Uu^Vud, Hh^Fms, Cud, Cud, Cud, Cud, Cud, Rp, Gg, Gs, Hh^Fms, Hh^Fms, Mm, Mm, Mm, Mm, Mm, Mm, Mm, Hh^Fms, Hh^Fms, Hh^Fms, Hh^Fms, Gs^Fms, Gs, Gg^Es, Rp, Rp, Rp, Re^Vct, Gs^Fms, Gs^Fms, Hh^Fms, Hh^Fms, Mm, Mm, Mm, Mm, Mm, Mm, Mm, Mm, Mm, Hh^Fms, Hh^Fms, Ww, Ww, Ww
Mm, Mm, Mm, Mm, Mm, Mm, Mm, Mm^Xm, Mm, Mm, Mm, Mm, Hh^Fms, Hh^Fms, Gg, Cud, Gg, Rp, Rp, Rp, Gs, Hh^Fms, Hh^Fms, Mm, Mm, Mm, Hh^Fms, Mm, Mm, Mm, Hh^Fms, Hh^Fms, Gg^Fet, Gs^Fms, Gs, Gs, Gg, Rp, Rp, Gs, Gs^Fms, Gs^Fms, Gs^Fms, Gs^Fms, Hh^Fms, Mm, Mm, Mm, Mm, Mm, Mm, Mm, Mm, Hh^Fms, Ww, Hh^Fms, Ww, Ww, Ww
Mm, Mm, Mm, Mm, Mm, Mm, Mm, Mm^Xm, Mm, Mm, Mm, Uu^Vud, Hh^Fms, Hh^Fms, Hh^Fms, Gs, Gs, Gs, Rp, Rp, Gs, Hh^Fms, Cud, Mm, Mm, Mm, Hh^Fms, Hh^Fms, Hh^Fms, Hh^Fms, Gs^Fms, Gs^Fms, Gs^Fms, Gs^Fms, Gs^Efm, Gg^Efm, Gg, Rp, Rp, Gs, Gs^Fms, Gs^Fms, Gg^Fet, Gs^Fms, Hh^Fms, Mm, Mm, Mm, Hh^Fms, Mm, Mm, Mm, Ww, Ww, Gs^Fms, Ww, Gs^Fms, Ww, Ww
Mm, Mm, Mm, Mm, Mm, Mm, Mm, Mm, Mm^Xm, Mm, Mm, Mm, Hh^Fms, Hh^Fms, Hh^Fms, Gs^Fms, Gs^Fms, Gs, Rp, Rp, Gs, Cud, Cud, Cud, Hh^Fms, Hh^Fms, Gs^Fms, Hh^Fms, Gs^Fms, Gs^Fms, Gs^Fms, Gs^Fms, Gg^Fet, Gs, Gs^Efm, Gg, Gg^Efm, Rp, Rp, Gs^Es, Gs^Fms, Gg^Fet, Gg^Fet, Gs^Fms, Hh^Fms, Mm, Mm, Mm, Ww, Ww, Ww, Ww, Ww, Gs^Fms, Gg^Fet, Gs^Fms, Ww, Ww, Mm
Mm, Mm, Mm, Mm, Mm, Mm, Mm, Mm, Mm^Xm, Mm, Mm, Mm, Mm, Mm, Mm, Hh^Fms, Cud, Cud, Rp, Rp, Gg, Cud, Gs^Fms, Hh^Fms, Gs^Fms, Gs^Fms, Gg^Fet, Gs^Fms, Gs^Fms, Gs^Fms, Gs^Fms, Gg^Fet, Gs^Fms, Gs, Gg, Gg^Efm, Rp^Efm, Rp, Rp, Gs, Gs^Fms, Gg^Fet, Gs^Fms, Gs^Fms, Gs^Fms, Hh^Fms, Ww, Ww, Ww, Ww, Ww, Ww, Ww, Ww, Ww, Ww, Hh^Fms, Mm, Mm
Mm, Mm, Mm, Mm, Mm, Mm, Mm, Mm^Xm, Mm, Mm, Mm, Mm, Mm, Mm, Mm, Mm, Cud, Cud, Rp, Rp, Gs, Cud, Gs, Gs^Fms, Gg^Ve, Gg^Fet, Gg^Fet, Gg^Fet, Gs, Gs^Fms, Gll, Gs^Fms, Gs, Gs, Rp, Rp^Efm, Rp, Rp, Ww^Bsb|, Ww, Ww, Gg^Fet, Gg^Fet, Gg^Fet, Ww, Ww, Ww, Ww, Mm, Mm, Mm, Ww, Hh^Fms, Ww, Hh^Fms, Hh^Fms, Mm, Mm, Mm
Mm, Mm, Mm, Mm, Mm, Mm, Mm^Xm, Mm^Xm, Mm, Mm, Mm, Mm, Mm, Mm, Mm, Mm, Hh^Fms, Cud, Rp, Rp, Rp, Gg, Gg, Gs, Rp, Rp, Rp, Gs, Rp, Rp, Rp, Gs, Rp, Rp, Rp, Rp, Ww, Ww^Bsb|, Ww^Bsb|, Ww, Ww^Ewf, Ww^Ewf, Wwf, Ww, Ww, Ww, Mm, Mm, Mm, Mm, Mm, Mm, Hh^Fms, Hh^Fms, Mm, Mm, Mm, Mm, Mm
Mm, Mm, Mm, Mm, Mm, Mm, Mm^Xm, Mm, Mm, Mm, Mm, Mm, Hh^Fms, Mm, Hh^Fms, Hh^Fms, Gs^Fms, Cud, Gs, Rp, Rp, Rp^Efm, Rp, Rp, Rp, Rp, Rp, Rp, Rp^Efm, Rp, Rp, Rp, Rp, Rp, Ww, Ww, Ww^Ewf, Ww^Bsb|, Rp, Gg, Gg, Ww, Wwf, Ww, Hh^Fms, Hh^Fms, Mm, Mm, Mm, Mm, Mm, Mm, Mm, Hh^Fms, Mm, Mm, Mm, Mm, Mm
Mm, Mm, Mm, Mm, Mm, Mm, Mm, Mm, Mm, Mm, Hh^Fms, Hh^Fms, Hh^Fms, Hh^Fms, Hh^Fms, Gs^Fms, Gs^Fms, Gs^Fms, Gg, Gg, Gg, Rp, Rp, Rp, Ww^Ewf, Ww^Ewf, Ww, Rp, Ww, Gg^Efm, Gg^Efm, Rp, Gg, Gg, Ww^Ewf, Ww^Ewf, Ww, Rp, Rp, Gs, Gg^Efm, Gs, Gs^Fms, Gs^Fms, Hh^Fms, Hh^Fms, Mm, Mm, Mm, Mm, Mm, Mm, Mm, Mm, Mm, Mm, Mm^Xm, Mm, Mm
Mm, Mm, Mm, Mm, Mm, Mm, Mm, Mm, Mm, Mm, Hh^Fms, Hh^Fms, Gs^Fms, Gs^Fms, Gs^Fms, Gg^Fet, Gs^Fms, Gll, Gs, Gg^Efm, Gg^Efm, Cud, Ww, Ww, Ww^Ewf, Ww, Ww^Ewf, Ww, Ww^Ewf, Ww, Ww, Gg^Efm, Ww, Ww, Ww^Ewf, Ww, Rp, Rp, Rp, Gg^Efm, Gs, Gs, Gs^Fms, Gs^Fms, Hh^Fms, Hh^Fms, Mm, Mm, Mm, Mm, Mm, Mm, Mm, Mm, Mm, Mm, Mm, Mm, Mm
Mm, Mm, Mm, Mm, Mm, Mm, Mm, Mm, Mm, Mm, Hh^Fms, Gs^Fms, Gs^Fms, Gs^Fms, Gs^Fms, Gs^Fms, Gg^Fet, Gs^Fms, Gs, Cud, Ww, Ww^Bsb\, Ww^Bsb\, Ww, Gg^Fet, Ww^Ewf, Gg^Fet, Ww^Ewf, Ww^Ewf, Ww, Ww^Ewf, Ww, Ww, Ww^Ewf, Ww, Ww, Rp, Rp, Gg^Es, Gg^Efm, Gll, Gs^Fms, Gs^Fms, Hh^Fms, Hh^Fms, Hh^Fms, Mm, Mm, Mm, Mm, Mm, Mm, Mm, Mm, Mm, Mm, Mm^Xm, Mm, Mm
Mm, Mm, Mm, Mm, Mm, Mm, Mm, Mm, Mm, Mm, Hh^Fms, Gs^Fms, Gg^Fet, Gs^Fms, Gs^Fms, Gg^Ve, Gs^Fms, Gs^Fms, Gs, Gg, Ww, Ww^Ewf, Gg^Ve, Gg^Fet, Gg^Efm, Gg^Fet, Cv, Gg^Fet, Gg^Ve, Ww^Ewf, Ww^Ewf, Ww, Ww^Ewf, Ww, Gg^Efm, Gg^Efm, Rp, Rp, Gs, Gs, Gs^Fms, Gs^Fms, Hh^Fms, Hh^Fms, Mm, Mm, Mm, Mm, Mm, Mm, Mm, Mm, Mm, Mm^Xm, Mm, Mm, Mm^Xm, Mm, Mm
Mm, Mm, Mm, Mm, Mm, Mm, Mm, Mm, Hh^Fms, Hh^Fms, Gs^Fms, Gs^Fms, Gs^Fms, Gs^Fms, Ww^Ewf, Gs^Fms, Ww^Ewf, Gs, Gg, Gg^Efm, Ww, Ww^Ewf, Ww^Ewf, Gg^Fet, Gg^Efm, Cv, Kv, Cv, Gg^Fet, Ww^Ewf, Ww, Ww^Ewf, Ww^Ewf, Ww, Gg^Efm, Gg, Rp, Rp, Gs, Gg^Ve, Gs^Fms, Gs^Fms, Hh^Fms, Hh^Fms, Mm, Mm, Mm, Mm, Mm, Mm, Mm, Mm, Mm, Mm, Mm, Mm, Mm, Mm, Mm
Hh^Fms, Mm, Hh^Fms, Mm, Mm, Mm, Hh^Fms, Hh^Fms, Hh^Fms, Hh^Fms, Gs^Fms, Gs^Fms, Ww, Ww, Ww, Ww^Ewf, Ww, Ww, Wwf, Gg, Ww, Ww^Ewf, Ww^Ewf, Gg^Fet, Gg^Fet, Cv, Cv, Cv, Gg^Efm, Gg^Fet, Ww, Ww^Ewf, Ww, Ww, Gg, Gg^Efm, Rp, Rp, Gs, Gs^Fms, Hh^Fms, Hh^Fms, Mm, Mm, Mm, Mm, Mm, Mm, Mm, Mm^Xm, Mm, Mm, Mm, Mm, Mm, Mm, Mm^Xm, Mm, Mm
Hh^Fms, Hh^Fms, Hh^Fms, Hh^Fms, Hh^Fms, Mm, Hh^Fms, Hh^Fms, Gs^Fms, Gs^Fms, Gs^Fms, Gs^Fms, Ww, Ww, Ww, Ww, Gg^Fet, Wwf, Wwf, Wwf, Ww^Ewf, Ww^Ewf, Ww^Ewf, Gg^Ve, Gg^Fet, Gg^Fet, Gg^Fet, Gg^Fet, Gg^Ve, Gg^Fet, Ww, Ww^Ewf, Ww^Ewf, Ww, Gg, Gs^Efm, Rp, Rp, Gs, Gs^Fms, Hh^Fms, Hh^Fms, Mm, Mm, Mm, Mm, Mm, Mm, Mm, Mm^Xm, Mm, Mm, Mm, Mm, Mm, Mm, Mm^Xm, Mm, Mm
Ww, Hh^Fms, Hh^Fms, Hh^Fms, Gs^Fms, Hh^Fms, Gs^Fms, Gs^Fms, Gs^Fms, Gs^Fms, Ww, Ww, Ww, Ww, Gs^Fms, Gg^Fet, Gs^Fms, Gll^Em, Gll, Ww, Ww, Ww^Ewf, Ww, Ww^Ewf, Ww^Ewf, Ww^Ewf, Ww^Ewf, Ww^Ewf, Ww^Ewf, Ww, Ww^Ewf, Ww^Ewf, Ww, Ww, Ww, Rp, Rp, Rp, Gs, Hh^Fms, Hh^Fms, Mm, Mm, Mm, Mm, Mm, Mm, Mm, Mm, Mm^Xm, Mm, Mm, Mm, Mm, Mm^Xm, Mm^Xm, Mm, Mm, Mm
Ww, Ww, Ww, Gs^Fms, Gs^Fms, Gs^Fms, Gs^Fms, Gs^Fms, Gs^Fms, Gg^Ve, Ww, Ww, Ww, Gs^Fms, Hh^Fms, Hh^Fms, Gg^Ve, Gs^Fms, Gg^Fet, Gll, Gs^Efm, Ww, Ww, Ww, Ww, Ww, Ww, Ww, Ww, Ww, Ww, Ww, Ww, Ww, Ww, Rp, Rp, Gs, Gg^Ve, Hh^Fms, Hh^Fms, Mm, Mm, Mm, Mm, Mm, Mm, Mm, Mm^Xm, Mm^Xm, Mm, Mm, Mm^Xm, Mm, Mm, Mm, Mm, Mm, Mm
Ww, Ww, Ww, Ww, Ww, Gll^Em, Ww, Ww, Wwf, Ww, Ww, Ww, Gs^Fms, Gs^Fms, Hh^Fms, Hh^Fms, Hh^Fms, Gs^Fms, Gs^Fms, Gs^Fms, Gs^Fms, Gs^Efm, Gs, Ww^Ewf, Ww^Ewf, Ww^Ewf, Gg, Gll^Em, Gg^Fet, Gg^Fet, Gg^Fet, Gs^Fms, Ww^Ewf, Ww, Ww, Rp, Rp, Gs, Hh^Fms, Hh^Fms, Mm, Mm, Mm, Mm, Mm, Mm, Mm, Mm, Mm, Mm, Mm, Mm^Xm, Mm, Mm, Mm, Mm, Mm, Mm, Mm
Ww, Ww, Ww, Ww, Ww, Ww, Ww, Ww, Wwf, Ww, Ww^Ewf, Ww^Ewf, Hh^Fms, Hh^Fms, Mm, Hh^Fms, Mm, Hh^Fms, Hh^Fms, Hh^Fms, Hh^Fms, Gs^Fms, Gs^Fms, Gs, Gs, Gs, Gs, Gg, Gs^Fms, Gs^Fms, Gs^Fms, Gs^Fms, Ww^Ewf, Ww, Gg^Efm, Rp, Rp, Gs, Hh^Fms, Hh^Fms, Mm, Mm, Mm, Mm^Xm, Mm, Mm, Mm, Mm, Mm^Xm, Mm, Mm, Mm, Mm, Mm, Mm^Xm, Mm, Mm, Mm, Mm
Gs^Fms, Ww, Ww, Ww, Ww, Ww, Ww, Ww, Gs^Fms, Gs^Fms, Gs^Fms, Hh^Fms, Mm, Mm, Mm, Mm, Mm, Mm, Mm, Hh^Fms, Hh^Fms, Hh^Fms, Hh^Fms, Gs^Fms, Gs^Fms, Gs, Gg^Efm, Gs^Es, Gs, Gg^Ve, Gs^Fms, Ww, Ww, Ww, Gg^Efm, Rp, Rp, Gs, Hh^Fms, Mm, Mm, Mm, Mm, Mm, Mm, Mm, Mm, Mm, Mm, Mm, Mm, Mm, Mm, Mm, Mm, Mm, Mm, Mm, Mm
Hh^Fms, Gs^Fms, Gll^Em, Ww, Ww, Ww, Gs^Fms, Gs^Fms, Gg^Fet, Gs^Fms, Hh^Fms, Hh^Fms, Mm, Mm, Mm, Mm, Mm, Mm, Mm, Mm, Mm, Hh^Fms, Hh^Fms, Gs^Fms, Hh^Fms, Gs^Fms, Hh^Fms, Gs, Gs^Efm, Gs^Efm, Gs, Ww, Ww^Ewf, Ww, Gg^Efm, Rp, Rp, Gs, Hh^Fms, Mm, Mm, Mm, Mm, Mm, Mm, Mm, Mm, Mm, Mm, Mm, Mm, Mm, Mm, Mm, Mm, Mm, Mm, Mm^Xm, Mm
Mm, Hh^Fms, Hh^Fms, Gs^Fms, Gs^Fms, Gll^Em, Gs^Fms, Gs^Fms, Gs^Fms, Gs^Fms, Hh^Fms, Mm, Mm, Mm, Mm, Mm, Mm, Mm, Mm, Mm, Mm, Mm, Mm, Hh^Fms, Mm, Hh^Fms, Hh^Fms, Gs^Fms, Gll^Efm, Gs^Efm, Gs^Es, Gs^Fms, Ww^Ewf, Ww^Ewf, Ww, Rp, Rp, Gs, Hh^Fms, Mm, Mm, Mm, Mm, Mm, Mm, Mm, Mm, Mm, Mm, Mm, Mm, Mm, Mm, Mm, Mm, Mm, Mm, Mm, Mm
Mm, Mm, Hh^Fms, Hh^Fms, Hh^Fms, Gs^Fms, Gs^Fms, Gs^Fms, Gs^Fms, Gs^Fms, Hh^Fms, Mm, Mm, Mm, Mm, Mm, Mm, Mm^Xm, Mm, Mm, Mm, Mm, Mm, Mm, Mm^Xm, Mm, Mm, Hh^Fms, Hh^Fms, Gll^Efm, Gll^Efm, Gs^Fms, Ww, Ww, Ww^Ewf, Rp, Rp, Gs^Es, Hh^Fms, Mm, Hh^Fms, Mm, Hh^Fms, Hh^Fms, Hh^Fms, Mm, Hh^Fms, Mm, Mm, Mm, Mm, Hh^Fms, Hh^Fms, Mm, Hh^Fms, Mm, Mm, Mm^Xm, Mm
Mm, Mm^Xm, Mm^Xm, Hh^Fms, Hh^Fms, Gs^Fms, Hh^Fms, Gs^Fms, Gs^Fms, Gs^Fms, Hh^Fms, Mm, Mm, Mm, Mm, Mm, Mm^Xm, Mm^Xm, Mm, Mm^Xm, Mm^Xm, Mm, Mm, Mm^Xm, Mm^Xm, Mm^Xm, Mm^Xm, Mm, Mm, Hh^Fms, Gll^Efm, Gg^Fet, Gs^Fms, Ww, Ww^Ewf, Rp, Rp, Gs^Efm, Gs^Efm, Hh^Fms, Hh^Fms, Hh^Fms, Hh^Fms, Hh^Fms, Hh^Fms, Hh^Fms, Hh^Fms, Hh^Fms, Hh^Fms, Mm, Hh^Fms, Hh^Fms, Hh^Fms, Hh^Fms, Hh^Fms, Hh^Fms, Mm, Mm, Mm
Mm, Mm, Mm, Mm, Mm, Hh^Fms, Mm, Hh^Fms, Hh^Fms, Hh^Fms, Mm, Mm, Mm, Mm, Mm, Mm, Mm, Mm, Mm, Mm, Mm, Mm, Mm, Mm, Mm, Mm, Mm, Mm^Xm, Mm, Hh^Fms, Gll^Efm, Gll^Efm, Gg^Ve, Ww^Ewf, Ww, Ww^Bsb|, Ww^Bsb|, Cud, Gs^Efm, Gs, Gs^Fms, Hh^Fms, Gs^Fms, Hh^Fms, Gs^Fms, Hh^Fms, Hh^Fms, Hh^Fms, Hh^Fms, Hh^Fms, Gs^Fms, Gs^Fms, Gs^Fms, Hh^Fms, Hh^Fms, Hh^Fms, Hh^Fms, Mm, Hh^Fms
Mm, Mm^Xm, Mm, Mm, Mm, Mm, Mm, Mm, Mm, Hh^Fms, Mm, Mm, Mm, Mm^Xm, Mm^Xm, Mm^Xm, Mm^Xm, Mm, Mm, Mm, Mm, Mm, Mm, Mm, Mm, Mm, Mm, Mm, Mm, Hh^Fms, Gs^Es, Gs^Es, Gs, Gs^Fms, Ww, Ww^Bsb|, Ww^Bsb|, Ww, Ww, Gs, Ww, Gs^Fms, Gll, Gs^Fms, Gs^Fms, Gs^Fms, Gs^Fms, Gs^Fms, Gs^Fms, Gs^Fms, Gs^Fms, Gs^Fms, Gll, Gs^Fms, Gs^Fms, Hh^Fms, Gs^Fms, Hh^Fms, Gs^Fms
Mm, Mm, Mm, Mm^Xm, Mm, Mm, Mm, Mm, Mm, Mm, Mm, Mm, Mm, Mm, Mm, Mm, Mm^Xm, Mm^Xm, Mm, Mm, Hh^Fms, Hh^Fms, Hh^Fms, Hh^Fms, Hh^Fms, Hh^Fms, Hh^Fms, Hh^Fms, Hh^Fms, Gs^Fms, Gs^Fms, Gg^Es, Gg^Es, Gs, Cud, Ww^Bsb|, Ww^Bsb|, Ww, Ww, Ww^Ewf, Ww^Ewf, Ww, Ww, Gll, Gll, Gs^Fms, Gs^Fms, Gs^Fms, Ww, Gll^Em, Gs^Fms, Gs^Fms, Gll, Gs^Fms, Gll^Em, Gs^Fms, Gs^Fms, Gs^Fms, Gs^Fms
Mm, Mm, Mm, Mm^Xm, Mm, Mm, Mm, Mm, Mm, Mm, Mm, Mm, Mm, Mm, Mm, Mm, Mm^Xm, Mm, Mm, Mm, Hh^Fms, Hh^Fms, Gg^Fet, Gs^Fms, Gs^Fms, Gs^Fms, Gs^Fms, Gs^Fms, Gs^Fms, Gs^Fms, Gs, Gg^Efm, Gg^Efm, Gg, Rp, Rp, Rp, Ww^Ewf, Ww, Ww, Ww, Ww^Ewf, Ww, Ww, Wwf, Ww, Ww^Ewf, Ww^Ewf, Ww^Ewf, Ww^Ewf, Ww, Ww, Ww, Gll, Gs^Es, Gll, Gll, Gs^Fms, Gs^Fms
Mm, Mm, Mm, Mm^Xm, Mm, Mm, Mm, Mm, Mm, Mm, Mm, Mm, Mm, Mm, Mm, Mm, Mm, Mm, Mm, Mm, Hh^Fms, Gs^Fms, Gs^Fms, Gll^Em, Gll, Gg^Fet, Gg^Fet, Gg^Fet, Gs, Gs, Gg, Gg, Rp^Efm, Rp, Rp, Rp, Gg^Es, Cud, Gg^Efm, Gg, Gg, Ww^Ewf, Ww^Ewf, Wwf, Ww, Ww, Ww, Ww, Ww, Ww^Ewf, Ww, Ww, Ww^Ewf, Ww, Wwf, Gs^Es, Gll, Gs^Fms, Gs^Fms
Mm^Xm, Mm, Mm, Mm, Mm, Mm, Mm, Mm, Mm, Mm, Mm, Mm, Hh^Fms, Mm, Mm, Mm, Mm, Mm, Mm, Mm, Mm, Hh^Fms, Hh^Fms, Gs^Fms, Gs^Fms, Gs, Gs, Gs, Gg^Efm, Gg^Efm, Rp^Efm, Rp^Efm, Rp^Efm, Rp, Gg^Es, Gg, Gg, Gg^Es, Gg, Gg, Gg^Efm, Gg, Gg, Gg, Gg, Ww^Ewf, Ww, Ww, Gs, Ww^Ewf, Ww, Ww^Ewf, Ww^Ewf, Ww, Wwf, Wwf, Ww, Gll, Gll
Mm, Mm, Mm, Mm, Mm, Mm, Hh^Fms, Mm, Mm, Mm, Mm, Hh^Fms, Hh^Fms, Hh^Fms, Mm, Mm, Mm, Mm, Mm, Mm, Mm, Hh^Fms, Hh^Fms, Gs^Fms, Gs^Fms, Gs, Gg, Gg^Efm, Rp, Rp^Efm, Rp, Rp, Gg, Gg, Gs^Fms, Gg^Fet, Gs^Fms, Gs^Fms, Gg, Gg^Efm, Gg^Efm, Gg, Gg, Gg, Gg^Efm, Gg, Gg, Gll, Gll, Gs, Gs, Ww, Ww, Wwf, Wwf, Wwf, Ww, Ww, Gll
Mm, Mm, Mm, Mm, Mm, Mm, Hh^Fms, Hh^Fms, Hh^Fms, Mm, Hh^Fms, Hh^Fms, Hh^Fms, Hh^Fms, Hh^Fms, Mm, Mm, Mm, Mm, Mm, Hh^Fms, Hh^Fms, Hh^Fms, Gg^Fet, Gg^Ve, Gs, Gg, Rp, Rp, Rp, Gg, Gg^Efm, Gg, Gg^Ve, Hh^Fms, Hh^Fms, Hh^Fms, Hh^Fms, Hh, Gg, Gg^Em, Gg, Hh^Fds, Gg, Gg^Efm, Gg, Gg, Gs^Fms, Gs^Fms, Gg, Gg^Efm, Gs, Gs, Gs^Fms, Ww, Ww, Ww, Ww, Ww
Mm, Mm, Hh^Fms, Hh^Fms, Hh^Fms, Hh^Fms, Gs^Fms, Hh^Fms, Hh^Fms, Hh^Fms, Hh^Fms, Hh^Fms, Gs^Fms, Hh^Fms, Hh^Fms, Hh^Fms, Hh^Fms, Hh^Fms, Hh^Fms, Hh^Fms, Hh^Fms, Hh^Fms, Gs^Fms, Gg^Fet, Gg^Fet, Gs, Rp, Rp, Rp, Gg^Es, Gg, Gg, Hh^Fms, Hh^Fms, Hh^Fms, Mm, Mm, Mm, Mm, Hh^Fds, Hh^Fds, Hh^Fds, Mm, Hh, Hh, Gg^Efm, Gg^Efm, Gs^Fms, Gg, Gg, Gg, Gs^Es, Gg, Gs^Fms, Gs, Ww, Ww, Ww^Ewf, Ww
Hh^Fms, Hh^Fms, Gg, Hh^Fms, Gg, Gll, Gs, Gs^Fms, Gs^Fms, Gs^Fms, Gs^Fms, Gs^Fms, Gs^Fms, Gs^Fms, Gs^Fms, Hh^Fms, Hh^Fms, Hh^Fms, Gs^Fms, Hh^Fms, Hh^Fms, Hh^Fms, Gs^Fms, Gs^Fms, Gs, Gs, Rp, Rp, Gg^Es, Gg^Es, Hh^Fms, Hh^Fms, Mm, Hh^Fms, Mm, Mm, Mm, Mm, Mm, Mm, Mm, Mm, Mm, Mm, Hh, Gg, Gg, Gg, Gg, Gg, Gs^Es, Gs^Efm, Gs, Gs, Gg, Gs, Ww, Ww^Ewf, Ww
Gg^Efm, Gg, Gg^Efm, Gg, Gg^Es, Gg, Gg, Gs, Gs, Gs^Fms, Gs, Gs^Fms, Gs, Gll, Gs, Gs^Fms, Gs^Fms, Gs^Fms, Gll, Gs^Fms, Gg^Fet, Gs^Fms, Gs, Gs, Gg, Gg, Rp, Rp, Gg, Gg, Hh^Fms, Mm, Mm, Mm, Mm, Mm, Mm, Mm, Mm, Mm, Mm, Mm, Mm, Mm, Hh^Fms, Gg, Gg^Es, Gg^Es, Gg, Gs, Gs^Fms, Gs^Fms, Gs^Fms, Gs^Es, Gs, Gg, Gs, Ww, Ww^Ewf
Gg, Gg, Gll, Gg, Gg, Gg^Efm, Gg, Gg, Gg, Gs, Gg, Gs, Gg, Gg, Gg, Gs, Gs, Gs, Gg, Gs, Gs, Gs, Gg, Gg^Efm, Gg^Efm, Gg, Rp, Rp, Gg, Gg^Efm, Hh^Fms, Mm, Mm, Mm, Mm, Mm, Mm, Mm, Mm, Mm, Mm, Mm, Mm, Hh^Fms, Gg, Gg, Gg^Es, Gg, Gs, Gs, Gs^Fms, Gs^Fms, Gs^Fms, Gs^Fms, Gs^Fms, Gll, Gs^Fms, Gs^Fms, Gs^Fms
Hh^Fms, Hh^Fms, Hh^Fms, Hh^Fms, Gg, Gg, Gg, Gg, Gg, Gg, Gg, Gg^Efm, Gg^Efm, Gg^Efm, Gg, Gg, Gg, Gg^Es, Gg, Gg, Gg, Gg, Gg, Gg, Rp, Rp, Rp^Efm, Rp, Gg, Gg, Hh^Fms, Hh^Fms, Mm, Mm, Mm, Mm, Mm, Mm, Mm, Mm, Mm, Mm, Hh^Fms, Hh^Fms, Hh, Gg, Gg, Gg^Efm, Gs, Gs^Fms, Gs^Fms, Gs^Fms, Gs^Fms, Gs^Fms, Gs^Fms, Gs^Fms, Hh^Fds, Hh^Fds, Hh^Fds
Mm, Mm, Mm, Hh, Hh, Gg, Gg, Gg^Efm, Gg, Gg^Efm, Gg^Efm, Gg, Gg, Gg, Gg, Gg^Efm, Gg^Efm, Gg, Gg, Gg, Gg^Efm, Gg^Efm, Rp, Rp, Rp, Rp, Gg, Gg, Gg, Gg, Hh^Fms, Hh^Fms, Mm, Mm, Mm, Mm, Mm, Mm, Mm, Mm, Mm, Mm, Mm, Mm, Mm, Hh, Gg, Gg, Gg, Gs, Gs^Fms, Gs^Fms, Gs^Fms, Gs^Fms, Hh^Fds, Hh^Fds, Mm, Mm, Mm
Mm, Mm^Xm, Mm^Xm, Mm, Hh^Fms, Gs, Gs, Gg, Gg, Gg^Es, Gg, Gg, Gs, Gg, Gg, Gg^Efm, Gg^Efm, Gg, Gg^Es, Gg^Es, Gs, Gg, Rp, Rp, Gs, Gg, Gg^Efm, Gg^Efm, Gg, Hh^Fms, Hh^Fms, Mm, Mm, Mm, Mm, Mm, Mm, Mm, Mm, Mm, Mm, Mm, Mm, Mm, Hh, Hh, Gg, Gg, Gg, Gll, Gs^Fms, Gs^Fms, Gs^Fms, Hh^Fds, Mm, Mm, Mm, Mm, Mm
Mm, Mm^Xm, Mm^Xm, Mm, Mm, Hh^Fms, Gs^Fms, Gs, Gs, Gg, Gs, Gs, Gs^Fms, Gs, Gg, Gg, Gg, Gg^Efm, Gg, Gg, Gs, Gg, Rp, Rp, Gs, Gg^Efm, Gg, Gg, Gg, Hh^Fms, Mm, Mm, Mm, Mm, Mm, Mm, Mm, Mm, Mm, Mm, Hh^Fms, Mm, Mm, Mm, Hh, Gg, Gg^Efm, Gg^Efm, Gs, Gll, Gs^Fms, Gs^Fms, Gs^Fms, Hh^Fds, Mm, Mm, Mm, Mm, Mm
Mm, Mm, Mm^Xm, Mm, Mm, Hh^Fms, Gs^Fms, Gs^Fms, Gs^Fms, Gs, Gs^Fms, Gs^Fms, Gs^Fms, Gll, Gll, Gs, Gs, Gg^Es, Gg, Gg, Gs, Gs, Rp, Rp, Gg, Gg^Efm, Gg^Efm, Gg, Gg^Efm, Hh^Fms, Mm, Mm, Mm, Mm, Mm, Mm, Hh^Fds, Hh, Hh, Hh^Fms, Gg, Hh^Fms, Hh, Hh, Gg, Gg^Efm, Gg, Gg, Gll, Gs^Fms, Gs^Fms, Gs^Fms, Gs^Fms, Hh^Fds, Hh^Fds, Mm, Mm, Mm, Mm
Mm, Mm, Mm^Xm, Mm, Mm, Hh^Fms, Hh^Fms, Gs^Fms, Gs^Fms, Gs^Fms, Gs^Fms, Gs^Fms, Gs^Fms, Gs^Fms, Gs^Fms, Gs^Fms, Gs^Es, Gg, Gg, Gg^Efm, Gg, Re^Vct, Rp, Rp, Rp, Gg^Efm, Gg, Gg, Gg, Hh^Fms, Hh^Fms, Mm, Hh^Fms, Hh^Fms, Hh^Fms, Hh^Fds, Rp, Hh, Gg, Gg, Gg, Gg, Gg, Gg, Gg^Es, Gg^Es, Gg^Es, Gs, Gs^Fms, Gs^Fms, Gs^Fms, Gs^Fms, Gs^Fms, Gs^Fms, Hh^Fds, Mm, Mm^Xm, Mm, Mm
Mm, Mm, Mm, Mm, Hh, Hh^Fms, Gs^Fms, Gs^Fms, Gg^Fet, Gs^Fms, Gs^Fms, Gs^Fms, Gg^Ve, Gs^Fms, Gs^Fms, Gs^Fms, Gs, Gg^Es, Gg, Gg, Ce, Gg, Ce, Rp, Rp^Efm, Rp, Rp, Re^Vct, Gg^Es, Gg, Gg^Es, Hh^Fds, Gs, Gs^Fms, Rp, Rp, Rp, Rp, Rp, Gg^Es, Gg, Gg, Rp, Gg^Es, Gg^Efm, Gg^Efm, Gg^Efm, Gs, Gs^Fms, Gs^Fms, Gs^Fms, Gs^Fms, Gg^Fet, Hh^Fds, Mm, Mm, Mm, Mm, Mm
Mm, Mm, Mm, Mm, Hh, Hh^Fms, Gs^Fms, Gs^Fms, Gs^Fms, Gs^Fms, Gg^Fet, Gs^Fms, Gs^Fms, Gs^Fms, Gs, Gs, Re^Vct, Gg, Gg^Efm, Ce, Ce, Ce, Ce, Ce, Gg, Rp, Rp, Rp, Rp, Gg^Es, Gg, Gg, Rp, Rp, Rp, Rp, Gg, Rp, Rp, Rp, Rp, Rp, Rp, Rp, Rp, Gg, Gg, Gg, Gll, Gs^Fms, Gs^Fms, Gs^Fms, Gs^Fms, Hh^Fds, Hh^Fds, Mm, Mm, Mm, Mm
Mm^Xm, Mm, Mm, Hh, Hh, Hh^Fms, Hh^Fms, Gs^Fms, Gs^Fms, Gs^Fms, Gs^Fms, Gs^Fms, Gs, Gs, Gg, Gg, Gg^Efm, Gg^Es, Gs, Gg^Efm, Ce, 2 Ke, Ce, Gg^Efm, Gs^Efm, Gg, Gg, Rp, Rp, Rp, Rp, Rp, Rp, Rp, Hh^Fms, Gg, Gg, Gg, Gg, Rp, Rp, Rp^Efm, Gg, Rp, Rp, Rp, Rp, Gg, Gll, Gs^Fms, Gs^Fms, Gs^Fms, Gs^Fms, Gs^Fms, Hh^Fds, Hh^Fds, Hh^Fds, Mm, Mm
Mm, Mm, Mm, Mm, Hh^Fms, Hh^Fms, Gs^Fms, Gs^Fms, Gs^Fms, Gs^Fms, Gg^Ve, Gll, Gg, Gg, Gg, Gg^Efm, Gs, Gg, Gg, Gg^Efm, Gg, Ce, Gg, Gg, Re^Vct, Gg^Efm, Gg, Gg, Gs, Rp, Rp, Rp, Hh^Fds, Hh^Fms, Mm, Hh^Fms, Hh, Hh, Hh, Gs, Gs, Gs, Gs^Efm, Gg^Es, Gg, Rp^Efm, Rp, Gs, Gs^Fms, Gs^Fms, Gs^Fms, Gs^Fms, Gs^Fms, Gs^Fms, Hh^Fds, Hh^Fds, Hh^Fds, Hh^Fds, Hh^Fds
Mm, Mm, Mm, Mm, Hh, Hh^Fms, Gs^Fms, Gs^Fms, Gg^Fet, Gs^Fms, Gs^Fms, Gll, Gs, Gg, Gg^Efm, Gg^Es, Gg^Es, Gs^Es, Gg, Gg, Gg, Gg, Gg, Gg, Gg, Gg, Gg, Gs, Cud, Rp^Efm, Rp, Cud, Hh^Fds, Mm, Mm, Mm, Mm, Hh, Mm, Hh^Fds, Hh^Fds, Gs^Fms, Gs^Fms, Gs, Gg^Es, Rp, Rp, Gs, Gs^Fms, Gs^Fms, Gg^Fet, Gs^Fms, Hh^Fds, Hh^Fds, Hh^Fds, Hh^Fds, Hh^Fds, Hh^Fds, Hh^Fds
Mm, Mm, Mm^Xm, Mm, Mm, Hh^Fms, Hh^Fms, Gs^Fms, Gs^Fms, Gs^Fms, Gs^Fms, Gs^Fms, Gs, Gg^Efm, Gg, Gs, Gg^Efm, Gg, Gg, Re^Vct, Hh, Hh, Hh, Gg, Hh, Hh, Hh, Kud, Cud, Rp, Rp, Hh, Mm, Mm^Xm, Mm^Xm, Mm, Mm, Mm, Mm, Mm, Hh^Fds, Gg^Fet, Gs^Fms, Gs, Gg^Es, Rp, Rp, Gs, Gs, Gs^Fms, Gs^Fms, Gs^Fms, Hh^Fds, Mm, Mm, Mm, Mm, Mm, Mm
Mm, Mm, Mm, Mm^Xm, Mm, Hh^Fms, Hh, Hh^Fms, Hh^Fms, Gll, Gll, Gs, Gg, Gs, Gg^Es, Gg, Gg, Gg, Hh, Hh, Mm, Mm, Mm^Xm, Hh, Mm, Mm, Mm, Hh, Hh, Rp, Rp, Hh, Mm, Mm, Mm, Mm^Xm, Mm, Mm, Mm, Mm, Hh^Fds, Hh^Fds, Gll, Cud, Rp, Rp, Rp, Gg, Gs, Gs^Fms, Hh^Fds, Hh^Fds, Mm, Mm, Mm, Mm^Xm, Mm^Xm, Mm, Mm
Mm, Mm, Mm, Mm^Xm, Mm^Xm, Mm, Mm, Mm, Mm, Hh^Fms, Hh, Gg, Gg^Efm, Gg, Gg, Gg, Hh^Fms, Hh^Fms, Mm, Mm, Mm^Xm, Mm, Mm, Mm^Xm, Mm^Xm, Mm, Mm, Mm, Hh, Rp, Rp, Hh, Hh, Mm, Mm, Mm, Mm, Mm, Mm, Mm, Hh^Fds, Hh^Fds, Cud, Cud, Rp, Rp, Cud, Kud, Gs^Fms, Gs^Fms, Hh^Fds, Hh^Fds, Mm, Mm, Mm, Mm, Mm, Mm^Xm, Mm
Mm, Mm, Mm, Mm, Mm^Xm, Mm, Mm^Xm, Mm, Mm, Mm, Mm, Hh, Gg, Gg, Gg, Hh^Fms, Hh^Fms, Mm, Mm, Mm, Mm, Mm^Xm, Mm, Mm, Mm, Mm, Mm, Mm, Hh, Rp, Rp, Rp, Rp, Hh, Hh, Mm, Mm, Mm, Mm, Mm, Hh, Gg, Gg, Gg, Rp, Rp, Gs, Cud, Gs^Fms, Gs^Fms, Hh^Fds, Mm, Mm, Mm, Mm, Mm, Mm, Mm, Mm
Mm, Mm, Mm, Mm, Mm, Mm^Xm, Mm^Xm, Mm, Mm, Mm, Mm, Hh, Gg, Gg, Hh, Hh^Fms, Mm, Mm, Mm, Mm, Mm, Mm, Mm, Mm, Mm, Mm^Xm, Mm, Mm, Mm, Hh, Hh, Rp, Rp, Rp, Rp, Hh, Hh, Mm, Hh, Hh, Gg, Gg^Efm, Gg, Gg^Efm, Rp^Efm, Rp, Gs, Gs^Fms, Hh^Fds, Hh^Fds, Mm, Mm, Mm, Mm, Mm, Mm, Mm, Mm, Mm
Mm, Mm, Mm, Mm, Mm, Mm, Mm, Mm^Xm, Mm, Mm, Mm, Hh, Gg, Gg, Hh, Mm, Mm, Mm, Mm, Mm, Mm, Mm, Gg, Mm, Gg, Mm, Mm, Mm, Mm, Mm, Gg, Hh, Gg, Rp, Gg, Rp, Gg, Hh, Gg, Gg, Gg, Gg, Gg, Gg, Rp, Rp, Gg, Gs^Fms, Hh^Fds, Mm, Mm, Mm, Mm, Mm, Mm, Mm, Mm, Mm, Gg
