border_size=1
usage=map

Hd, Hd, Hd, Hd, Hd, Hd, Hd, Hd, Dd, Dd, Dd, Hd, Hd, Dd, Hd, Hd, Hd, Hd, Hd, Dd, Dd, Dd, Dd, Dd, Dd, Dd, Dd, Dd, Dd, Dd, Dd, Dd, Dd, Dd, Dd, Dd, Dd, Dd, Dd, Dd, Dd, Dd, Dd, Dd, Dd^Edpp, Dd, Dd
Hd, Hd, Hd, Hd, Hd, Hd, Hd, Hd, Dd^Edp, Dd, Dd, Hd, Dd, Hd, Hd, Hd, Hd, Hd, Hd, Hd, Dd, Dd, Dd, Dd, Dd, Dd, Dd, Dd, Dd, Dd, Dd, Dd^Edpp, Dd^Edpp, Dd, Dd^Do, Dd, Dd, Dd^Edpp, Dd, Dd^Edpp, Dd, Dd^Do, Dd, Dd, Dd, Dd, Dd
Hd, Hd, Hd, Hd, Hd, Hd, Dd^Edp, Dd^Edp, Dd^Dc, Dd^Edp, Dd^Do, Dd, Dd, Dd, Dd, Hd, Hd, Hd, Hd, Hd, Dd, Dd, Dd, Dd, Dd, Dd, Dd, Dd, Dd, Dd, Dd^Edpp, Dd^Edpp, Dd, Dd, Dd^Vdt, Dd, Dd, Dd, Dd, Dd^Edpp, Dd^Edpp, Dd, Dd, Dd, Dd, Dd^Edpp, Dd
Hd, Hd, Hd, Hd, Hd, Dd^Do, Dd^Edp, Dd^Dc, Dd^Cov, Dd^Dc, Dd^Edp, Dd^Edp, Dd^Edp, Dd, Dd, Hd, Hd, Hd, Hd, Hd, Dd, Dd, Dd, Dd^Edpp, Dd, Dd, Dd, Dd, Dd, Dd, Dd, Dd^Edpp, Dd^Edpp, Dd, Dd, Dd, Ce, Ce, Ce, Dd, Dd, Dd, Dd^Vdt, Dd, Dd, Dd^Edpp, Dd
Hd, Hd, Hd, Hd, Dd, Dd^Edp, Dd^Dc, Dd^Cov, 3 Dd^Kov, Dd^Cov, Dd^Dc, Dd, Dd, Dd, Dd, Dd, Hd, Hd, Hd, Hd, Dd, Dd, Dd, Dd, Dd, Dd, Dd, Dd, Dd, Dd, Dd, Dd, Dd, Dd, Dd, Dd, Ce, Ke, Ce, Dd, Dd, Dd, Dd, Dd^Do, Dd, Dd, Dd
Hd, Hd, Dd, Dd, Dd, Dd^Dc, Dd^Dc, Dd^Cov, Dd^Cov, Dd^Cov, Dd^Dc, Dd^Edp, Dd, Dd, Dd, Hd, Hd, Hd, Hd, Hd, Dd, Dd, Dd, Dd, Dd, Dd, Dd^Edpp, Dd, Dd, Dd, Dd, Dd^Edpp, Hd, Dd, Dd, Dd, Dd, 1 Ce, Dd, Dd, Dd, Dd, Dd, Dd, Dd^Edpp, Dd^Edpp, Dd
Hd, Hd, Dd, Dd, Dd^Edp, Dd^Edp, Dd^Edp, Dd^Do, Dd, Dd^Dc, Dd, Dd^Edp, Dd, Dd, Hd, Hd, Hd, Hd, Hd, Dd, Dd, Dd, Dd, Dd, Dd, Dd^Edpp, Dd, Dd, Dd, Dd, Dd^Edpp, Dd, Hd, Hd, Dd, Dd, Dd, Dd, Dd, Dd, Dd^Vdt, Dd^Edpp, Dd^Edpp, Dd^Edpp, Dd, Dd, Dd
Dd, Dd, Dd, Dd, Dd, Dd^Edp, Dd, Dd, Dd, Dd, Dd, Dd, Dd, Dd, Dd, Hd, Hd, Hd, Hd, Dd, Dd, Dd, Dd, Dd, Dd, Hd, Hd, Hd, Hd, Dd, Dd, Dd, Dd, Hd, Dd, Dd, Dd^Vdt, Dd, Dd, Dd, Dd, Dd, Dd, Dd, Dd, Dd, Dd
Dd, Dd, Dd, Dd, Dd, Dd, Hd, Hd, Hd, Dd, Dd, Dd, Dd, Dd, Dd, Dd, Hd, Hd, Dd, Dd, Dd, Dd, Dd, Dd, Dd, Hd, Hd, Hd, Hd, Dd, Dd, Dd, Dd, Dd^Edpp, Dd^Edpp, Dd, Dd, Dd, Hd, Hd, Hd, Dd, Dd, Dd^Edpp, Dd, Dd, Hd
Dd, Dd, Dd, Dd, Hd, Hd, Hd, Hd, Hd, Hd, Hd, Dd, Dd, Dd, Dd, Dd, Dd, Dd, Dd, Dd, Dd, Dd^Edp, Dd, Dd, Dd, Dd, Dd^Edpp, Dd, Dd, Dd, Dd, Dd, Dd, Dd, Dd, Dd, Dd^Edpp, Dd, Dd, Hd, Hd, Hd, Dd, Dd, Dd, Dd, Hd
Dd, Dd, Hd, Hd, Hd, Hd, Hd, Hd, Hd, Hd, Hd, Dd, Dd, Dd^Edp, Dd, Dd, Dd^Edp, Dd, Dd, Dd, Dd, Dd, Dd, Dd, Dd, Dd, Dd, Dd, Dd, Dd, Hd, Hd, Hd, Dd, Dd, Dd, Dd, Dd^Edpp, Dd, Hd, Hd, Hd, Dd, Dd, Dd, Hd, Hd
Dd, Dd, Hd, Hd, Hd, Hd, Hd, Hd, Hd, Hd, Dd, Dd, Dd, Dd, Dd, Dd, Dd, Dd, Dd, Dd, Dd, Dd, Dd, Dd, Dd, Dd, Dd, Dd, Dd, Hd, Hd, Hd, Hd, Hd, Dd, Dd, Dd^Edpp, Dd^Edpp, Dd, Dd, Dd, Dd, Dd, Dd, Dd, Hd, Hd
Dd, Dd, Hd, Hd, Hd, Hd, Hd, Hd, Hd, Hd, Dd, Dd, Dd, Dd, Dd, Dd, Dd, Dd, Dd, Dd, Dd, Dd, Hd, Dd, Dd, Dd, Dd, Dd^Edp, Dd, Dd, Dd, Hd, Hd, Hd, Hd, Dd, Dd, Dd, Dd, Dd, Dd, Dd, Hd, Dd, Dd, Dd, Dd
Dd, Hd, Hd, Hd, Hd, Hd, Hd, Hd, Dd, Dd, Dd, Dd, Dd, Dd, Dd^Edp, Dd^Edp, Dd, Dd, Dd, Dd, Hd, Hd, Hd, Dd, Dd, Dd, Dd, Dd, Dd^Edp, Dd^Edp, Dd, Dd, Dd, Hd, Hd, Dd, Dd, Dd, Dd, Dd, Hd, Dd, Hd, Dd, Dd, Dd, Dd
Dd, Hd, Hd, Hd, Hd, Hd, Hd, Dd, Dd, Dd, Dd, Dd, Dd, Dd^Edp, Dd, Dd, Dd, Dd, Hd, Hd, Hd, Hd, Hd, Hd, Hd, Dd, Dd, Dd, Dd, Dd, Dd, Dd, Dd, Hd, Hd, Dd, Hd, Dd, Hd, Hd, Hd, Hd, Hd, Dd, Dd, Dd, Dd
Dd, Hd, Hd, Hd, Hd, Hd, Dd, Dd, Dd, Dd, Dd, Dd, Dd, Dd, Dd, Dd^Edp, Dd, Dd, Dd, Dd, Dd, Hd, Hd, Hd, Hd, Hd, Hd, Dd, Hd, Dd, Dd, Dd, Dd, Hd, Hd, Hd, Hd, Hd, Hd, Hd, Hd, Hd, Hd, Dd, Dd, Dd, Dd
Dd, Dd, Dd, Hd, Dd, Dd, Dd, Dd, Dd, Dd, Dd, Dd, Dd, Dd, Dd, Dd, Dd, Dd, Dd, Dd, Dd, Dd, Dd, Dd, Dd, Hd, Hd, Hd, Hd, Dd, Dd, Dd, Dd, Dd, Dd, Hd, Dd, Hd, Hd, Hd, Hd, Hd, Hd, Dd, Dd, Dd, Dd
Dd, Dd, Dd, Dd, Dd, Dd, Dd, Dd, Dd, Hd, Hd, Dd, Dd, Dd, Dd, Dd, Dd, Dd, Dd^Edp, Dd, Dd, Dd, Dd, Dd, Dd, Hd, Hd, Hd, Dd, Dd, Dd, Dd, Dd, Dd, Dd, Dd, Dd, Dd, Dd, Dd, Dd, Dd, Dd, Dd, Dd, Dd, Dd
Dd, Dd, Dd, Dd, Dd, Dd, Dd, Dd, Dd, Hd, Hd, Hd, Dd, Dd, Dd, Dd, Dd, Dd, Dd, Dd, Dd, Dd, Dd, Dd, Dd, Hd, Hd, Hd, Dd, Dd, Dd, Dd, Dd, Dd, Dd, Dd, Dd, Dd, Dd^Edp, Dd, Dd, Dd, Dd^Edp, Dd, Dd, Dd, Dd
Dd, Dd, Dd, Dd, Dd, Dd, Dd, Dd, Hd, Hd, Hd, Hd, Dd, Dd, Dd, Dd, Dd, Dd, Dd, Dd, Dd, Dd^Edp, Dd, Dd, Dd, Dd, Dd, Dd, Dd, Dd, Dd, Dd, Hd, Dd, Dd, Dd, Dd, Dd, Dd^Edp, Dd^Edp, Dd, Dd, Dd, Dd, Dd, Dd, Dd
Dd, Dd, Dd, Dd, Hd, Dd, Hd, Hd, Hd, Hd, Hd, Dd, Dd, Dd, Dd^Vdt, Dd, Dd, Dd, Dd, Dd, Dd, Dd, Dd, Dd, Dd, Dd, Dd, Dd, Dd, Dd, Hd, Hd, Hd, Hd, Dd, Dd, Dd, Dd, Dd^Edp, Dd, Dd, Dd, Dd, Dd, Dd, Dd, Dd
Dd, Dd, Dd, Hd, Hd, Hd, Hd, Hd, Hd, Hd, Dd, Dd, Dd^Edp, Dd, Dd, Dd, Ce, Ce, Ce, Dd, Dd, Dd, Dd, Dd, Dd, Dd, Dd, Hd, Hd, Hd, Hd, Hd, Hd, Hd, Hd, Dd, Dd, Dd, Dd, Dd, Dd, Dd, Dd, Dd^Edp, Dd, Dd, Dd
Dd, Dd, Dd, Dd, Dd, Hd, Dd, Dd, Dd, Dd, Dd, Dd, Dd, Dd, Dd, Dd, Ce, 2 Ke, Ce, Dd, Dd, Dd, Dd, Dd^Edp, Dd, Dd, Dd, Hd, Hd, Hd, Dd, Dd, Dd, Hd, Hd, Dd, Dd, Dd, Dd, Dd, Dd, Dd, Dd, Dd, Dd, Dd, Hd
Dd, Dd, Dd, Dd, Dd, Dd, Dd, Dd, Dd, Dd, Dd^Edp, Dd, Dd, Dd, Dd, Dd, Dd, Ce, Dd, Dd, Dd, Dd, Dd, Dd, Dd, Dd, Hd, Hd, Hd, Hd, Dd^Edp, Dd, Dd, Hd, Hd, Hd, Dd, Dd, Dd, Dd^Edp, Dd, Dd, Dd, Dd, Hd, Hd, Hd
Dd^Edp, Dd^Edp, Dd, Dd, Dd, Dd, Dd, Dd, Dd, Dd, Dd, Dd^Edp, Dd, Dd, Dd^Vdt, Dd, Dd, Dd, Dd, Dd, Dd, Dd^Vdt, Dd, Dd, Dd, Dd, Hd, Hd, Hd, Hd, Dd, Dd, Dd, Dd, Hd, Hd, Dd, Dd, Dd, Dd, Dd, Dd, Hd, Hd, Md, Hd, Md
Dd, Dd, Dd, Dd, Dd, Dd, Dd, Dd, Dd^Edp, Dd, Dd^Edp, Dd^Edp, Dd, Dd, Dd, Dd, Dd, Dd, Dd, Dd, Dd, Dd, Dd, Dd, Dd, Dd, Hd, Hd, Hd, Dd, Dd, Dd^Edp, Dd, Dd, Hd, Dd, Dd, Dd, Dd, Dd, Dd, Dd, Hd, Hd, Md, Md, Md
Dd, Dd, Dd, Dd, Dd, Dd^Edp, Dd, Dd^Edp, Dd, Dd^Edp, Dd^Edp, Dd, Dd^Edp, Dd, Dd, Dd^Edp, Dd, Dd^Vdt, Dd, Dd, Dd, Dd, Dd, Dd, Dd, Dd, Hd, Hd, Dd, Dd, Dd, Dd, Dd, Dd, Dd, Dd, Dd, Dd, Dd, Dd, Dd, Dd, Hd, Hd, Md, Md, Md
Dd, Dd, Dd, Dd, Dd, Dd, Dd, Dd, Dd, Dd, Dd, Dd, Dd, Dd^Edp, Dd, Dd, Dd, Dd, Dd, Dd, Dd, Dd, Dd, Dd, Dd, Dd, Dd, Dd, Dd, Dd, Dd, Dd, Dd^Edp, Dd, Dd, Dd, Dd, Dd, Dd, Dd, Dd, Hd, Hd, Hd, Md, Md, Md
Hd, Dd, Dd, Dd, Dd, Dd, Dd, Dd, Dd, Dd, Dd, Dd, Hd, Hd, Hd, Hd, Hd, Dd, Hd, Hd, Hd, Dd, Dd, Dd, Dd, Dd, Dd, Dd, Dd^Edp, Dd, Dd, Dd, Dd, Dd^Edp, Dd^Edp, Dd^Edp, Dd^Edp, Dd, Dd, Dd, Hd, Hd, Hd, Md, Md^Xm, Md, Md
Hd, Hd, Hd, Dd, Hd, Dd, Dd, Dd, Dd, Dd, Hd, Hd, Hd, Hd, Hd, Hd, Hd, Hd, Md, Hd, Hd, Dd, Dd, Dd, Dd, Dd, Dd, Dd, Dd, Dd, Dd, Dd, Dd, Dd, Dd, Dd, Dd, Dd, Dd, Dd, Hd, Hd, Md^Xm, Md^Xm, Md, Md, Md
Md, Hd, Hd, Hd, Hd, Hd, Hd, Dd, Hd, Hd, Hd, Hd, Dd, Dd, Dd, Dd, Hd, Md, Md, Md, Hd, Hd, Hd, Hd, Hd, Dd, Dd, Dd, Dd, Dd, Dd, Dd, Dd, Dd, Dd, Dd, Dd, Dd, Dd, Hd, Hd, Md, Md, Md, Md, Md^Xm, Md
Md, Md, Md, Hd, Md, Hd, Md, Hd, Md, Hd, Hd, Dd, Dd, Dd, Dd, Dd^Ftd, Cdr, Hd, Md, Md^Xm, Md, Hd, Hd, Hd, Hd, Hd, Hd, Hd, Hd, Dd, Dd, Dd, Hd, Dd, Dd, Dd, Dd, Dd, Dd, Hd, Hd, Md, Md^Xm, Md, Md, Md, Md^Xm
Md^Xm, Md, Md, Md, Md^Xm, Md, Md, Md, Md, Md, Md, Hd, Dd^Edp, Dd^Edp, Hd, Dd^Ftd, Dd^Edp, Dd^Edp, Dd^Ftd, Md, Md, Md^Xm, Md^Xm, Hd, Hd, Hd, Hd, Hd, Hd, Hd, Hd, Hd, Hd, Hd, Hd, Hd, Hd, Hd, Hd, Hd, Hd, Md, Md, Md^Xm, Md^Xm, Md^Xm, Md
Md, Md^Xm, Md^Xm, Md^Xm, Md, Md^Xm, Md^Xm, Md^Xm, Md^Xm, Md^Xm, Md, Hd, Dd^Do, Dd^Edp, Hd, Hd, Dd^Edp, Kdr, Dd^Ftd, Md, Md, Md, Md, Md^Xm, Md, Hd, Md^Xm, Hd, Hd, Hd, Hd, Hd, Hd, Hd, Hd, Hd, Hd, Hd, Hd, Hd, Md^Xm, Md, Md, Md, Md^Xm, Md, Md
Md, Md, Md, Md, Md^Xm, Md, Md, Md^Xm, Md^Xm, Md, Md^Xm, Md, Hd, Dd^Edp, Dd^Edp, Cdr, Dd^Ftd, Dd^Ftd, Md, Md, Md, Md, Md, Md^Xm, Md^Xm, Md^Xm, Md, Md, Md^Xm, Hd, Md, Md, Md^Xm, Md^Xm, Md, Md, Md, Md, Md, Md, Md^Xm, Md^Xm, Md^Xm, Md^Xm, Md, Md, Hd
Md, Md^Xm, Md^Xm, Md, Md, Md, Md, Md, Md^Xm, Md^Xm, Md, Md, Hd, Hd, Hd, Dd^Ftd, Hd, Hd, Md, Md, Md, Md, Md, Md, Md, Md^Xm, Md^Xm, Md^Xm, Md, Md^Xm, Md^Xm, Md^Xm, Md^Xm, Md, Md^Xm, Md^Xm, Md^Xm, Md^Xm, Md^Xm, Md^Xm, Md, Md, Md, Md, Hd, Hd, Hd
Hd, Md, Md, Md^Xm, Md, Md, Md, Md, Md, Md, Hd, Hd, Dd, Hd, Dd, Hd, Hd, Md, Md, Md, Hd, Hd, Hd, Md, Hd, Md, Md, Md, Md, Md, Md, Md, Md, Md^Xm, Md, Md, Md, Md, Md, Md, Hd, Hd, Hd, Hd, Hd, Hd, Dd
Hd, Md, Hd, Md, Hd, Hd, Hd, Hd, Hd, Hd, Dd, Dd, Dd, Dd, Dd, Hd, Hd, Md, Hd, Hd, Dd, Hd, Hd, Hd, Hd, Hd, Hd, Hd, Hd, Md, Hd, Hd, Hd, Md, Hd, Hd, Hd, Hd, Hd, Hd, Hd, Hd, Hd, Hd, Dd, Dd, Dd
Hd, Hd, Hd, Hd, Hd, Hd, Hd, Hd, Dd, Dd, Dd, Dd, Dd, Dd, Dd, Dd, Dd, Hd, Dd, Dd, Dd, Dd, Hd, Hd, Dd, Hd, Hd, Hd, Hd, Hd, Hd, Hd, Hd, Hd, Hd, Hd, Dd, Hd, Dd, Hd, Dd, Dd, Dd, Dd, Dd, Dd, Dd
Dd, Hd, Dd, Hd, Dd, Hd, Hd, Hd, Dd, Dd, Md, Md, Md, Dd, Md, Dd, Dd, Dd, Dd, Dd^Ftd, Md, Md, Hd, Hd, Dd, Dd, Dd, Dd, Dd, Dd, Dd, Dd, Dd, Hd, Dd, Dd, Dd, Dd, Dd, Dd, Dd^Edpp, Dd, Dd, Dd, Dd^Edpp, Dd^Edpp, Dd
Dd, Dd, Dd, Dd, Dd, Dd, Hd, Hd, Hd, Md, Md^Xm, Md, Md, Md, Md, Dd^Ftd, Dd, Dd, Dd, Dd^Ftd, Md, Md, Md, Hd, Hd, Dd, Dd, Dd, Dd, Dd, Dd, Dd, Dd, Dd, Dd^Edpp, Dd, Dd^Edpp, Dd^Edpp, Dd, Dd, Dd, Dd, Dd^Ftd, Dd, Dd^Edpp, Dd, Dd
Dd, Dd^Edp, Dd, Dd, Dd, Dd^Edp, Hd, Hd, Hd, Md, Md, Md, Md, Md^Xm, Md, Md, Hd, Dd, Dd, Md, Md, Md, Hd, Hd, Hd, Dd, Dd, Dd, Dd, Dd, Dd, Dd^Edpp, Dd, Dd, Dd^Edpp, Dd^Edpp, Dd, Dd, Dd, Dd^Ftd, Dd^Ftd, Dd^Do, Dd, Dd, Dd, Dd, Dd^Ftd
Dd, Dd, Dd, Dd, Dd, Dd, Dd, Hd, Hd, Hd, Hd, Md, Md, Md, Md, Md, Hd, Dd, Dd, Dd, Hd, Hd, Hd, Hd, Hd, Hd, Hd, Hd, Hd, Dd, Dd, Dd, Dd, Dd^Edpp, Dd, Dd^Ftd, Dd, Dd^Edpp, Dd^Ftd, Dd^Ftd, Dd, Dd, Dd^Ftd, Dd, Dd^Ftd, Dd^Ftd, Dd^Ftd
Dd, Dd, Dd, Dd, Dd, Dd, Dd, Dd, Dd, Hd, Dd, Hd, Hd, Hd, Hd, Hd, Hd, Hd, Hd, Hd, Dd, Hd, Hd, Hd, Hd, Hd, Hd, Hd, Hd, Dd, Dd^Edpp, Dd^Edpp, Dd, Dd^Edpp, Dd, Dd, Dd, Dd^Edpp, Dd^Edpp, Dd^Do, Dd^Ftd, Dd^Ftd, Dd^Ftd, Dd^Ftd, Dd^Do, Dd^Ftd, Dd^Ftd
Dd, Dd, Dd, Dd, Dd, Dd, Dd, Dd^Edp, Dd^Esd, Dd, Dd, Dd, Dd, Dd, Dd, Dd, Hd, Hd, Hd, Dd, Dd, Dd, Hd, Hd, Hd, Hd, Dd, Dd, Dd, Hd, Dd^Edpp, Dd, Dd^Ftd, Dd, Dd, Dd^Ftd, Dd^Do, Dd^Edpp, Dd, Dd, Dd^Ftd, Dd^Ftd, Dd^Ftd, Dd^Ftd, Dd^Ftd, Dd^Ftd, Dd^Ftd
Dd, Dd, Dd, Dd, Hd, Dd, Dd, Dd, Dd, Dd, Dd, Dd, Dd, Dd, Dd, Dd, Dd, Dd, Dd, Dd, Dd, Hd, Hd, Hd, Dd, Dd, Dd, Dd, Dd^Edpp, Dd, Dd, Dd^Ftd, Dd^Do, Dd, Dd, Dd, Dd^Ftd, Dd^Ftd, Dd^Ftd, Dd^Ftd, Dd^Ftd, Dd^Ftd, Ds, Ds, Ds, Dd^Ftd, Ds
Hd, Hd, Hd, Hd, Hd, Hd, Hd, Dd, Dd, Dd, Dd, Dd, Dd, Dd, Dd, Dd, Dd, Dd, Dd^Esd, Dd, Dd, Hd, Hd, Hd, Dd, Dd, Dd^Edpp, Dd, Dd, Dd, Dd, Dd^Ftd, Dd, Dd, Dd^Ftd, Dd^Ftd, Hd^Ftd, Dd^Ftd, Hd^Ftd, Dd^Ftd, Dd^Ftd, Dd, Ds, Wwt, Wwt, Ds, Wwt
Hd, Hd, Hd, Hd, Ce, Hd, Hd, Dd, Dd, Dd, Dd, Dd, Dd, Dd, Dd^Esd, Dd, Dd, Dd, Dd, Dd, Dd, Hd, Hd, Dd, Dd, Dd, Dd^Edpp, Dd, Dd^Ftd, Dd, Dd, Dd, Dd, Dd^Ftd, Dd^Ftd, Hd^Ftd, Hd^Ftd, Hd^Ftd, Hd^Ftd, Hd^Ftd, Hd^Ftd, Ds, Wwt, Wwt, Wwt, Wwt, Wwrt
Hd, Hd, Dd, Ce, Ke, Ce, Hd, Hd, Dd, Dd, Dd, Dd, Dd, Dd, Dd, Dd, Dd, Dd, Dd, Dd, Dd, Dd, Dd, Dd, Dd, Dd^Edpp, Dd, Dd, Dd, Dd, Dd, Dd, Dd^Ftd, Dd^Ftd, Hd^Ftd, Hd^Ftd, Hd^Ftd, Hd^Ftd, Hd^Ftd, Hd^Ftd, Ds, Ds, Wwt, Wwt, Wwt, Wwt, Wwt
Dd, Dd, Dd, Ce, Ce, Ce, Hd, Hd, Dd, Dd, Dd, Dd, Dd, Dd, Dd, Dd^Esd, Dd^Esd, Dd, Dd, Dd, Dd, Dd, Dd, Dd^Edpp, Dd, Dd^Edpp, Hd, Dd, Hd, Dd, Dd^Ftd, Dd^Ftd, Hd^Ftd, Hd^Ftd, Hd^Ftd, Dd^Ftd, Dd, Ds, Ds, Ds, Ds, Wwt, Wwt, Wwt, Wwrt, Wwrt, Wot
Dd, Dd^Vdt, Dd, Dd, Dd, Dd, Dd, Dd, Dd, Dd, Dd, Dd, Dd, Dd, Dd, Dd, Dd, Dd^Esd, Dd, Dd, Dd, Dd, Dd, Dd, Dd, Hd, Hd, Hd, Hd, Dd^Ftd, Dd^Ftd, Hd^Ftd, Dd^Ftd, Dd^Ftd, Dd^Ftd, Dd^Ftd, Ds, Ds, Wwt, Wwt, Wwt, Wwt, Wwt, Wwt, Wwrt, Wwt, Wot
Dd, Dd, Dd, Dd, Dd, Dd, Dd^Esd, Dd, Dd^Esd, Dd, Dd^Esd, Dd, Dd, Dd, Dd, Dd, Dd, Dd, Dd, Dd, Dd, Dd, Dd, Dd, Dd^Edpp, Hd, Hd, Hd, Hd, Dd^Ftd, Dd^Do, Hd^Ftd, Dd^Ftd, Dd^Ftd, Dd^Ftd, Ds, Ds, Wwt, Wwt, Wwt, Wwt, Wwt, Wwrt, Wwrt, Wot, Wot, Wot
Dd, Dd^Esd, Dd, Dd, Dd, Dd^Esd, Dd, Dd^Vdt, Dd, Dd^Esd, Dd, Dd^Esd, Dd^Esd, Dd, Dd, Dd, Dd, Dd, Dd, Dd, Dd, Dd, Dd, Dd^Edpp, Dd, Dd^Ftd, Dd^Ftd, Dd^Ftd, Dd^Ftd, Dd^Ftd, Dd^Ftd, Dd^Ftd, Dd^Ftd, Dd^Ftd, Dd^Ftd, Dd, Ds, Wwt, Wwt, Wwt, Wwt, Wwt, Wot, Wot, Wot, Wot, Wot
Dd, Dd, Dd, Dd^Vdt, Dd, Dd, Dd, Dd, Dd, Dd, Dd, Dd, Dd, Dd^Esd, Rd, Dd^Esd, Dd, Dd, Dd, Dd, Dd, Dd, Dd^Edpp, Dd^Edpp, Hd^Ftd, Hd^Ftd, Hd^Ftd, Dd^Ftd, Dd^Ftd, Dd^Ftd, Dd^Ftd, Dd^Ftd, Ds, Dd^Ftd, Ds, Ds, Wwt, Wwt, Wwt, Wwt, Wwt, Wwt, Wot, Wot, Wot, Wot, Wot
Dd, Dd, Dd, Dd, Dd, Dd, Dd, Dd, Dd, Dd, Dd, Dd, Dd, Dd, Rd, Dd, Dd, Dd, Dd, Dd, Hd, Dd^Edpp, Dd, Dd^Ftd, Hd^Ftd, Hd^Ftd, Hd^Ftd, Dd^Ftd, Dd^Ftd, Dd^Do, Dd, Ds, Ds, Ds, Ds, Ds, Wwt, Wwt, Wwt, Wot, Wot, Wwrt, Wot, Wot, Wot, Wot, Wot
Dd, Dd, Dd, Dd, Dd, Dd, Dd, Dd, Dd, Dd, Dd, Dd, Dd, Rd, Dd, Dd, Dd, Dd, Dd, Dd, Hd, Hd, Dd, Dd^Ftd, Dd^Ftd, Dd^Ftd, Dd^Ftd, Dd, Dd, Dd, Ds, Dd, Wwt, Wwt, Wwt, Wwt, Wwt, Wwt, Wot, Wot, Wot, Wot, Wot, Wot, Wot, Wot, Wot
Dd, Dd, Dd, Dd^Esd, Dd, Dd, Dd, Dd, Dd, Dd, Rd, Rd, Dd, Dd, Dd, Dd, Dd, Dd, Hd, Hd, Hd, Hd, Dd, Hd, Dd, Dd, Dd, Dd, Ds, Ds, Wwt, Wwt, Wwt, Wwt, Wwt, Wwt, Wwt, Wwt, Wwrt, Wot, Wot, Wot, Wot, Wot, Wot, Wot, Wot
Dd, Dd, Dd^Esd, Dd^Esd, Dd, Dd, Dd, Dd, Dd^Esd, Dd^Esd, Rd, Dd^Esd, Dd^Esd, Dd, Dd, Dd, Dd, Dd, Hd, Hd, Dd^Edpp, Dd^Edpp, Dd^Edpp, Dd, Dd^Ftd, Dd, Ds, Ds, Wwt, Wwt, Wwt, Wwt, Wwt, Wwt, Wwrt, Wwrt, Wot, Wot, Wot, Wot, Wot, Wot, Wot, Wot, Wot, Wot, Wot
Dd, Dd, Dd, Dd^Esd, Dd^Esd, Dd, Dd, Dd, Dd, Dd, Rd, Dd, Dd^Esd, Dd, Dd, Dd, Dd, Dd, Dd, Dd, Dd^Edpp, Dd^Edpp, Dd^Ftd, Dd^Ftd, Dd, Dd, Ds, Ds, Wwt, Wwt, Wwt, Wwt, Wot, Wwrt, Wot, Wot, Wot, Wot, Wot, Wot, Wot, Wot, Wot, Wot, Wot, Wot, Wot
Dd, Dd, Dd, Dd, Dd, Dd^Esd, Dd^Esd, Dd, Dd, Dd, Dd, Dd, Dd, Dd, Dd^Esd, Dd, Dd, Dd, Dd, Dd, Dd^Ftd, Dd^Ftd, Dd^Ftd, Dd^Ftd, Ds, Ds, Wwt, Wwt, Wwt, Wot, Wot, Wot, Wwrt, Wwrt, Wot, Wot, Wot, Wot, Wot, Wot, Wot, Wot, Wot, Wot, Wot, Wot, Wot
Dd, Dd, Dd, Dd, Dd, Dd, Dd, Dd, Dd, Dd, Rd, Dd, Dd, Dd, Dd^Esd, Dd, Dd^Edpp, Dd^Edpp, Dd^Ftd, Dd, Dd^Ftd, Dd^Ftd, Dd^Ftd, Dd^Ftd, Ds, Wwt, Wwt, Wwt, Wot, Wot, Wot, Wot, Wot, Wot, Wot, Wot, Wot, Wot, Wot, Wot, Wot, Wot, Wot, Wot, Wot, Wot, Wot
Dd, Dd, Dd, Dd, Dd, Dd, Dd, Dd, Dd^Esd, Dd^Esd, Rd, Dd, Dd, Dd^Esd, Dd, Dd, Dd, Dd, Dd^Ftd, Dd^Ftd, Dd^Ftd, Dd^Do, Dd^Ftd, Ds, Wwt, Wwt, Wwt, Wot, Wot, Wot, Wot, Wot, Wwrt, Wot, Wot, Wot, Wot, Wot, Wot, Wot, Wot, Wot, Wot, Wot, Wot, Wot, Wot
Dd, Dd, Dd, Dd, Dd, Dd, Dd, Dd, Dd, Dd, Dd, Dd, Dd, Dd, Dd, Dd, Dd, Dd, Dd, Dd^Ftd, Dd^Ftd, Dd^Ftd, Dd^Ftd, Ds, Ds, Wwt, Wwt, Wot, Wot, Wot, Wwrt, Wot, Wot, Wot, Wot, Wot, Wot, Wot, Wot, Wot, Wot, Wot, Wot, Wot, Wot, Wot, Wot
Dd, Dd, Dd, Dd, Dd, Dd, Dd, Dd, Dd, Dd, Rd, Dd, Dd, Dd, Dd, Dd, Dd, Dd^Edpp, Dd^Edpp, Dd^Do, Dd^Ftd, Dd^Ftd, Dd^Ftd, Ds, Ds, Wwt, Wwt, Wwt, Wot, Wot, Wwrt, Wot, Wot, Wwrt, Wot, Wot, Wot, Wot, Wot, Wot, Wot, Wot, Wot, Wot, Wot, Wot, Wot
Dd, Dd, Dd, Dd, Dd, Dd, Dd, Dd, Dd, Dd, Rd, Dd, Dd, Dd, Hd, Hd, Hd, Dd, Dd, Dd, Dd^Ftd, Dd^Ftd, Dd^Ftd, Ds, Ds, Ds, Wwt^Bsb/, Wwt, Wwt, Wot, Wot, Wot, Wot, Wot, Wwrt, Wot, Wwrt, Wwt, Wwrt, Wot, Wot, Wot, Wot, Wot, Wot, Wot, Wot
Dd, Dd, Hd, Hd, Hd, Dd, Dd, Dd, Dd, Rd, Kdr, Rd, Dd, Hd, Hd, Hd, Hd, Dd, Dd, Dd^Edpp, Dd, Dd^Ftd, Dd, Dd, Ds, Cdr, Kdr, Wwt^Bsb/, Wwt, Wot, Wwt, Wot, Wot, Wot, Wwt, Wwrt, Wwt, Wwrt, Wot, Wot, Wwt, Wot, Wot, Wot, Wot, Wot, Wot
Dd, Hd, Hd, Hd, Cdr, Cdr, Cdr, Cdr, Kdr, Rd, Rmo, Rd, Kdr, Cdr, Cdr, Cdr, Cdr, Dd, Dd, Dd^Esd, Dd, Dd, Dd, Dd, Rd, Cdr, Cdr, Wwt^Bsb/, Wwt, Wot, Wot, Wot, Wwt, Wwt, Wwt, Wwt, Wwt, Wwt, Wwt, Wwrt, Wot, Wot, Wot, Wot, Wot, Wot, Wot
Dd, Hd, Cdr, Cdr, Rmo, Rmo^Dr, Rmo, Rmo, Rmo, Dd^Dc, Rmo, Rmo, Dd^Dc, Rmo, Rmo, Dd^Dc, Rmo, Cdr, Cdr, Dd^Ftd, Dd^Ftd, Dd, Rd, Rd, Dd, Dd, Dd, Ds, Wwt, Wwt, Wwt, Wwt, Wwt, Wwt, Wwt, Wwt, Ds, Wwt, Wwt, Wwt, Wot, Wot, Wot, Wot, Wot, Wot, Wot
Dd, Dd, Cdr, Dd^Dc, Rmo, Rmo, Cdr, Dd^Dc, Rmo^Dr, Rmo, Kdr, Rmo, Rmo, Dd^Vdt, Cdr, Rmo, Dd^Dc, Rmo^Dr, Cdr, Dd^Ftd, Dd^Ftd, Rd, Dd^Ftd, Dd^Ftd, Dd^Ftd, Dd^Ftd, Dd^Ftd, Ds, Ds, Wwt, Wwt, Wwt, Wwt, Wwt, Ds, Ds, Ds, Ds, Wwt, Wwt, Wot, Wot, Wot, Wot, Wot, Wot, Wot
Dd, Dd, Kdr, Rmo, Rmo, Kdr, Dd^Vdt, Rmo, Cdr, Cdr, Re^Vct, Cdr, Cdr, Rmo, Rmo, Kdr, Rmo, Rmo, Kdr, Dd^Ftd, Rd, Rd, Dd^Ftd, Dd^Ftd, Dd^Ftd, Dd^Ftd, Dd^Ftd, Dd^Ftd, Dd^Ftd, Ds, Ds, Ds, Ds, Ds, Dd^Ftd, Dd^Ftd, Dd^Ftd, Ds, Wwt, Wwt, Wwt, Wot, Wot, Wot, Wot, Wot, Wot
Dd, Dd, Dd, Rmo, Dd^Dc, Cdr, Rmo, Rmo, Cdr, Rmo^Dr, Re^Vct, Dd^Dc, Cdr, Rmo, Rmo, Cdr, Rmo, Rmo, Rmo, Rd, Rd, Rd, Cdr, Cdr, Cdr, Dd^Ftd, Dd^Ftd, Dd^Ftd, Dd^Ftd, Dd, Dd, Ds, Dd, Dd^Ftd, Dd^Ftd, Dd^Do, Dd^Ftd, Ds, Wwt, Wwt, Wwt, Wot, Wot, Wot, Wot, Wot, Wot
Dd, Dd, Dd, Rmo, Rmo, Rmo^Dr, Rmo, Cdr, Rmo^Dr, Cdr, Kdr, Cdr, Re^Vct, Cdr, Rmo, Dd^Dc, Dd^Vdt, Dd^Dc, Rmo, Rmo, Rmo, Kdr, Rmo, Rmo, Rmo^Dr, Cdr, Cdr, Dd^Ftd, Dd^Ftd, Dd^Ftd, Dd, Dd, Dd^Ftd, Dd^Ftd, Dd^Ftd, Dd^Ftd, Dd^Ftd, Ds, Ds, Wwt, Wwt, Wot, Wot, Wot, Wot, Wot, Wot
Dd, Dd, Dd, Rmo, Rmo, Rmo, Rmo, Cdr, Cdr, Cdr, Cdr, Cdr, Cdr, Cdr, Rmo, Rmo, Rmo, Rmo^Dr, Dd^Dc, Rmo, Dd^Dc, Rmo, Cdr, Rmo, Rmo, Rmo, Cdr, Dd^Ftd, Dd^Ftd, Dd^Ftd, Dd, Dd, Dd, Dd, Dd, Dd, Dd, Dd, Ds, Wwt, Wwt, Wwt, Wot, Wot, Wot, Wot, Wot
Dd, Dd, Rmo, Dd^Dc, Rmo, Cdr, Rmo, Dd^Dc, Cdr, Dd^Dc, Cdr, Rmo^Dr, Cdr, Rmo, Dd^Dc, Cdr, Dd^Vdt, Rmo, Rmo, Rmo, Rmo, Rmo, Cdr, Kdr, Cdr, Rmo^Dr, Cdr, Dd, Dd, Dd, Dd^Esd, Dd^Esd, Dd, Dd, Dd, Dd^Ftd, Dd, Dd, Ds, Wwt, Wwt, Wwt, Wwt, Wot, Wot, Wot, Wot
Cdr, Cdr, Cdr, Rmo, Rmo, Kdr, Cdr, Rmo, Dd^Dc, Cdr, Rmo, Cdr, Dd^Dc, Rmo, Cdr, Kdr, Rmo^Dr, Rmo, Cdr, Cdr, Cdr, Rmo, Rmo, Cdr, Rmo, Rmo, Cdr, Dd, Dd, Dd, Dd^Ftd, Dd^Ftd, Dd, Dd^Esd, Dd, Dd^Ftd, Dd^Ftd, Dd^Ftd, Ds, Ds, Ds, Wwt, Wwt, Wwt, Wwt, Wwt, Wot
Cdr, Kdr, Cdr, Dd^Vdt, Rmo^Dr, Rmo, Rmo, Rmo, Rmo, Rmo, Rmo, Rmo, Rmo, Rmo, Rmo, Rmo, Dd^Dc, Rmo, Cdr, Kdr, Cdr, Rmo, Dd^Dc, Rmo^Dr, Dd^Dc, Rmo, Cdr, Dd, Dd, Dd^Ftd, Dd^Ftd, Dd^Ftd, Dd^Ftd, Dd^Esd, Dd, Dd^Ftd, Dd^Ftd, Dd^Ftd, Dd^Ftd, Dd, Dd^Ftd, Ds, Ds, Wwt, Wwt, Wwt, Wot
Rmo, Cdr, Rmo, Rmo, Rmo, Rmo, Rmo, Dd^Dc, Rmo, Cdr, Rmo, Cdr, Rmo, Dd^Dc, Rmo, Rmo, Rmo, Rmo, Rmo, Cdr, Rmo, Rmo, Rmo, Rmo, Rmo, Cdr, Dd, Dd, Dd, Dd, Dd^Ftd, Dd^Ftd, Dd, Dd, Dd, Dd^Ftd, Dd, Dd^Do, Dd, Dd^Ftd, Dd^Ftd, Dd, Ds, Wwt, Wwt, Wwt, Wot
