border_size=1
usage=map

Gll^Fp, Gll, Gll^Fp, Gll^Fp, Gll^Fp, Gll, Wo, Wo, Gll, Gll^Fp, Gll^Fp, Gll^Fp, Gll, Gll^Fp, Gll^Fp, Gll^Fp, Gll^Fp, Gll^Fp, Gll^Fp, Gll^Fp, Gll, Gll^Fp, Gll^Fp, Gll, Rp, Rp, Rp, Gll, Gll^Fp, Gll^Fp, Gll^Fp, Gll^Fp, Gll^Fp, Gll^Fp, Gll^Fp, Gll^Fp, Gll^Fp, Gll^Fp, Gll, Gll^Fp, Gll, Gll^Fp, Gll^Fp
Gll^Fp, Gll^Fp, Gll^Fp, Gll^Fp, Gll, Gll, Wo, Wo, Gll, Gll^Fp, Gll^Fp, Gll^Fp, Gll, Gll^Fp, Gll^Es, Gll, Gll, Gll^Fp, Gll^Fp, Gll, Gll^Fp, Gll^Fp, Gll^Fp, Gll, Rp, Rp, Rp, Gll^Es, Gll^Fp, Gll^Fp, Gll^Fp, Gll, Gll^Fp, Gll^Fp, Gll, Gll, Gll^Fp, Gll, Gll^Fp, Gll, Gll^Es, Gll^Fp, Gll^Fp
Gll^Fp, Gll, Gll^Fp, Gll^Fp, Wo, Wo, Wo, Wo, Hh^Fp, Hh^Fp, Hh^Fp, Gll^Fp, Gll^Fp, Gll^Fp, Gll, Gll^Fp, Gll^Fp, Gll, Gll^Fp, Gll^Es, Gll, Gll^Fp, Gll^Fp, Gll, Rp, Rp, Rp, Gll, Gll^Em, Gll^Fp, Gll^Fp, Gll^Fp, Gll, Gll^Fp, Gll^Fp, Gll^Fp, Gll^Fp, Gll^Fp, Gll^Fp, Gll^Fp, Gll, Gll, Gll
Gll^Fp, Gll, Gll^Fp, Gll^Fp, Wo, Wo, Hh^Fp, Hh^Fp, Hh^Fp, Hh^Fp, Hh^Fp, Hh^Fp, Hh^Fp, Gll^Fp, Gll^Fp, Gll, Gll^Es, Gll, Gll^Fp, Gll^Fp, Gll^Em, Gll^Fp, Gll^Fp, Gll, Rp, Rp, Rp, Gll, Gll^Fp, Gll^Fp, Gll^Fp, Gll, Gll^Fp, Gll^Fp, Gll^Fp, Gll, Gll^Fp, Gll, Gll, Gll, Gll^Es, Gll^Fp, Gll^Fp
Gll, Gll^Fp, Gll^Fp, Gll, Wo, Wo, Hh^Fp, Hh^Fp, Mm, Mm, Mm, Hh^Fp, Hh^Fp, Gll^Fp, Gll^Fp, Gll^Fp, Gll^Fp, Gll^Fp, Gs^Vl, Gll, Gll^Fp, Gll^Fp, Gll^Fp, Gll^Es, Rp, Rp, Rp, Gll, Gll^Fp, Gll^Fp, Hh^Fp, Gll^Fp, Gll^Fp, Gll, Gll^Fp, Gll, Gll^Fp, Gll^Fp, Gll^Fp, Gll^Es, Gll, Gll^Fp, Gll^Fp
Gll^Fp, Gll, Gll^Fp, Gll, Wo, Wo, Wo, Hh^Fp, Mm, Mm, Mm, Mm, Hh^Fp, Hh^Fp, Hh^Fp, Gll^Fp, Hh^Fp, Gll^Fp, Gll^Fp, Gll^Fp, Hh^Fp, Hh^Fp, Hh^Fp, Cud, Rp, Rp, Rp, Cud, Hh^Fp, Hh^Fp, Hh^Fp, Hh^Fp, Hh^Fp, Gll^Fp, Gll^Fp, Gll^Fp, Gll, Gll^Fp, Gll, Gll^Fp, Gll^Fp, Gll, Gll
Gll^Fp, Gll, Gll^Fp, Gll^Fp, Wo, Wo, Wo, Mm, Mm, Mm, Hh^Fp, Mm, Hh^Fp, Hh^Fp, Hh^Fp, Hh^Fp, Mm, Hh^Fp, Hh^Fp, Hh^Fp, Mm, Hh^Fp, Mm, Hh^Fp, Qxu^Bsb|, Rp, Qxu^Bsb|, Hh^Fp, Mm, Mm, Mm, Mm, Mm, Hh^Fp, Gll^Fp, Gll^Fp, Gll^Fp, Gll^Es, Gll^Es, Gll^Fp, Gll^Fp, Gll, Gll^Fp
Hh^Fp, Gll^Fp, Gll^Fp, Gll^Fp, Hh^Fp, Wo, Wo, Wo, Wo, Hh^Fp, Gll^Fp, Hh^Fp, Gll^Fp, Hh^Fp, Mm, Mm, Mm, Mm, Mm, Mm, Mm, Mm, Mm, Qxu, Qxu^Bsb|, Qxu^Bsb|, Qxu^Bsb|, Qxu, Qxu, Mm, Mm, Mm, Mm, Hh^Fp, Hh^Fp, Gll^Fp, Gll, Gll^Fp, Gll, Gll, Gll^Fp, Gll^Fp, Gll^Fp
Mm, Hh^Fp, Hh^Fp, Hh^Fp, Hh^Fp, Hh^Fp, Hh^Fp, Wo, Wo, Wo, Wo, Gll^Fp, Gll^Fp, Hh^Fp, Mm, Mm, Mm, Mm, Mm, Mm, Mm, Mm, Qxu, Qxu, Qxu^Bsb|, Qxu^Bsb|, Qxu^Bsb|, Qxu, Qxu, Mm, Mm, Mm, Mm, Mm, Mm, Hh^Fp, Gll^Fp, Gll, Gll^Fp, Gll^Fp, Gll, Gll, Gll^Fp
Mm, Mm, Mm, Mm, Mm, Mm, Mm, Hh^Fp, Hh^Fp, Wo, Wo, Wo, Wo, Hh^Fp, Mm, Mm, Mm, Mm, Mm, Mm, Mm, Mm, Mm, Qxu, Qxu^Bsb|, Qxu^Bsb|, Qxu^Bsb|, Qxu, Mm, Mm, Mm, Mm, Mm, Mm, Hh^Fp, Hh^Fp, Gll^Fp, Gll^Fp, Hh^Fp, Gll^Fp, Gll, Gll^Fp, Gll^Fp
Mm, Mm, Mm, Mm, Mm, Mm, Mm, Mm, Mm, Hh^Fp, Wo, Wo, Wo, Hh^Fp, Hh^Fp, Mm, Hh^Fp, Hh^Fp, Hh^Fp, Mm, Mm, Mm, Mm, Qxu, Qxu^Bsb|, Qxu^Bsb|, Qxu^Bsb|, Qxu, Hh^Fp, Mm, Mm, Mm, Hh^Fp, Hh^Fp, Gll^Fp, Gll^Fp, Gll^Fp, Hh^Fp, Mm, Hh^Fp, Hh^Fp, Gll^Fp, Gll^Fp
Mm, Mm, Mm, Mm, Hh^Fp, Mm, Mm, Mm, Mm, Mm, Wo, Wo, Wo, Gll^Fp, Gll^Fp, Hh^Fp, Gll^Fp, Gll^Fp, Gll^Fp, Hh^Fp, Hh^Fp, Mm, Hh^Fp, Mm, Rp, Rp, Rp, Hh^Fp, Hh^Fp, Mm, Mm, Hh^Fp, Gll^Fp, Gll^Fp, Gll^Fp, Gll^Es, Hh^Fp, Hh^Fp, Mm, Mm, Mm, Hh^Fp, Gll^Fp
Hh^Fp, Mm, Wo, Hh^Fp, Hh^Fp, Mm, Mm, Mm, Hh^Fp, Hh^Fp, Wo, Wo, Hh^Fp, Gll^Fp, Gll^Fp, Gll^Fp, Gll^Fp, Gll, Ce, Gll^Fp, Ce, Hh^Fp, Gg, Hh^Fp, Rp, Rp, Rp, Gg, Gll^Fp, Hh^Fp, Hh^Fp, Hh^Fp, Gll^Fp, Gll, Gll^Fp, Hh^Fp, Mm, Mm, Mm, Mm, Mm, Hh^Fp, Hh^Fp
Wo, Wo, Wo, Wo, Wo, Wo, Wo, Hh^Fp, Wo, Wo, Hh^Fp, Hh^Fp, Mm, Hh^Fp, Gll^Fp, Gll^Fp, Gll^Fp, Ce, Re^Vct, Ce, Re^Vct, Ce, Gll, Gg, Rp, Rp, Rp, Gll, Gll^Es, Gll^Fp, Gll^Fp, Gll^Fp, Gll^Es, Gll, Gll^Fp, Hh^Fp, Mm, Mm, Mm, Mm, Mm, Mm, Hh^Fp
Wo, Wo, Hh^Fp, Wo, Wo, Wo, Wo, Wo, Wo, Hh^Fp, Mm, Mm, Mm, Hh^Fp, Gll^Fp, Gll, Ce, Ce, Ce, Ce, Ce, Ce, Ce, Gll, Rp, Rp, Rp, Gg, Gll^Fp, Gll^Fp, Gll^Em, Gll^Fp, Gs^Vl, Gll, Hh^Fp, Hh^Fp, Hh^Fp, Hh^Fp, Hh^Fp, Mm, Mm, Mm, Hh^Fp
Hh^Fp, Hh^Fp, Mm, Mm, Mm, Mm, Mm, Wo, Wo, Wo, Mm, Mm, Mm, Hh^Fp, Gll^Fp, Gll, Ce, Re^Vct, Ce, Ke, Ce, Re^Vct, Ce, Rp, Rp, Rp, Rp, Gll, Gll^Fp, Gll^Fp, Gll^Fp, Hh^Fp, Hh^Fp, Hh^Fp, Mm, Hh^Fp, Hh^Fp, Hh^Fp, Hh^Fp, Hh^Fp, Hh^Fp, Hh^Fp, Hh^Fp
Mm, Mm, Mm, Mm, Mm, Mm, Mm, Mm, Wo, Wo, Hh^Fp, Mm, Mm, Hh^Fp, Hh^Fp, Gll^Fp, Gll^Es, Ce, Re^Vct, Ce, Re^Vct, Ce, Gll, Rp, Rp, Rp, Gg^Es, Gll, Gll^Fp, Gll^Fp, Hh^Fp, Hh^Fp, Mm, Mm, Mm, Mm, Mm, Hh^Fp, Hh^Fp, Hh^Fp, Hh^Fp, Hh^Fp, Hh^Fp
Mm, Mm, Mm, Mm, Mm, Mm, Mm, Mm, Wo, Wo, Mm, Mm, Mm, Mm, Hh^Fp, Gll^Fp, Gll, Ce, Ce, Ce, Ce, Ce, Gll, Rp, Rp, Rp, Gg^Es, Gll, Gll^Fp, Gll^Fp, Hh^Fp, Mm, Mm, Mm, Mm, Mm, Mm, Hh^Fp, Hh^Fp, Hh^Fp, Hh^Fp, Hh^Fp, Hh^Fp
Mm, Mm, Hh^Fp, Hh^Fp, Wo, Wo, Wo, Wo, Wo, Wo, Mm, Mm, Mm, Mm, Hh^Fp, Gll^Fp, Gll^Fp, Gll^Es, Gll, Gll^Fp, Gll^Fp, Gll^Es, Gg^Es, Rp, Rp, Rp, Gll, Gg, Gll^Fp, Gll^Fp, Hh^Fp, Hh^Fp, Mm, Mm, Mm, Mm, Mm, Mm, Hh^Fp, Hh^Fp, Hh^Fp, Hh^Fp, Hh^Fp
Mm, Mm, Wo, Wo, Wo, Mm, Wo, Wo, Mm, Mm, Mm, Mm, Mm, Mm, Hh^Fp, Gll^Fp, Gll^Fp, Gll, Gll^Es, Gg, Gg, Gll^Es, Gll, Rp, Rp, Rp, Gll^Es, Gll, Gll, Gll^Fp, Gll^Fp, Hh^Fp, Mm, Mm, Mm, Mm, Mm, Mm, Mm, Mm, Mm, Mm, Mm
Wo, Wo, Wo, Wo, Mm, Wo, Mm, Mm, Mm, Mm, Mm, Mm, Mm, Hh^Fp, Gll^Fp, Gll^Fp, Gll^Fp, Gll^Fp, Gll, Gll, Gll, Gll^Fp, Gll, Rp, Rp, Rp, Gg^Es, Gll, Gll, Gll^Fp, Gll^Fp, Hh^Fp, Mm, Mm, Mm, Mm, Mm, Mm, Mm, Mm, Mm, Mm, Mm
Wo, Wo, Mm, Mm, Mm, Mm, Mm, Mm, Mm, Mm, Hh^Fp, Mm, Hh^Fp, Hh^Fp, Gll^Fp, Gs^Vl, Gll^Fp, Gll^Fp, Gll, Gll, Gll^Fp, Gll^Fp, Gll, Rp, Rp, Rp, Gll, Gll, Gll, Gll^Fp, Gll^Fp, Hh^Fp, Hh^Fp, Mm, Mm, Mm, Mm, Mm, Mm, Mm, Mm, Mm, Mm
Hh^Fp, Wo, Mm, Mm, Mm, Mm, Mm, Mm, Mm, Mm, Hh^Fp, Hh^Fp, Hh^Fp, Hh^Fp, Gll^Fp, Gll^Fp, Gll^Fp, Gll^Fp, Gll^Fp, Gll^Es, Gll, Gll^Fp, Gll, Rp, Rp, Rp, Gg^Es, Gll, Gll, Gll^Fp, Gll^Fp, Gll^Fp, Gll^Fp, Hh^Fp, Hh^Fp, Mm, Mm, Mm, Mm, Mm, Mm, Mm, Mm
Mm, Wo, Wo, Mm, Mm, Mm, Mm, Mm, Mm, Mm, Hh^Fp, Hh^Fp, Hh^Fp, Hh^Fp, Hh^Fp, Hh^Fp, Hh^Fp, Hh^Fp, Chr, Gll^Fp, Chr, Gll, Kh, Rp, Chr, Rp, Kh, Gg, Chr, Gll, Chr, Gll^Fp, Gll^Fp, Gll^Fp, Gll^Fp, Hh^Fp, Hh^Fp, Hh^Fp, Hh^Fp, Mm, Mm, Mm, Mm
Mm, Mm, Wo, Mm, Mm, Mm, Mm, Mm, Mm, Mm, Mm, Mm^Xm, Mm^Xm, Mm, Mm, Hh^Fp, Mm, Chr, Mm^Xm, Kh, Rp^Vhcr, Chr, Rp^Vhcr, Chr, Kud, Chr, Rp^Vhcr, Chr, Rr^Vhc, Kh, Rp^Vhcr, Chr, Gll^Fp, Gs^Vl, Gll^Fp, Gll^Fp, Gll^Fp, Gll^Fp, Hh^Fp, Hh^Fp, Mm, Mm, Hh^Fp
Mm, Wo, Mm, Wo, Wo, Wo, Mm, Mm, Mm, Mm, Mm, Mm, Mm, Mm^Xm, Mm, Mm, Mm, Chr, Chr, Chr, Chr, Chr, Kh, Chr, Chr, Chr, Kh, Chr, Chr, Chr, Chr, Chr, Hh^Fp, Hh^Fp, Hh^Fp, Gll^Fp, Gll, Gll^Fp, Gll^Fp, Hh^Fp, Hh^Fp, Hh^Fp, Gll^Fp
Mm, Mm, Mm^Xm, Mm, Mm, Wo, Mm, Hh^Vhh, Mm, Mm, Mm^Xm, Mm, Mm, Mm, Mm^Xm, Mm, Mm, Kh, Chr, Kud, Chr, Kh, Gll^Fp, Rp, Rp, Rp, Gll^Fp, Kh, Chr, Kud, Chr, Kh, Mm, Hh^Fp, Mm, Hh^Fp, Hh^Fp, Hh^Fp, Hh^Fp, Gll^Fp, Gll^Fp, Gll^Fp, Gll
Mm, Mm, Mm^Xm, Mm^Xm, Mm^Xm, Mm, Mm, Mm, Mm, Mm, Mm, Mm^Xm, Mm^Xm, Mm, Mm, Mm, Mm, Chr, Mm^Xm, Chr, Mm^Xm, Chr, Gll^Fp, Rp, Rp, Rp, Gll^Fp, Chr, Mm^Xm, Chr, Mm^Xm, Chr, Mm, Mm, Mm, Mm^Xm, Mm, Mm, Mm, Hh^Fp, Hh^Fp, Gll, Gll
Mm, Mm^Xm, Mm, Mm, Mm, Mm, Mm^Xm, Mm, Mm, Mm, Mm, Mm, Mm, Mm, Mm, Mm, Hh^Fp, Chr, Chr, Kh, Chr, Chr, Gll^Fp, Rp, Rp, Rp, Gll^Fp, Chr, Chr, Kh, Chr, Chr, Mm, Mm, Mm, Mm, Mm, Mm, Mm, Hh^Fp, Hh^Fp, Gll^Fp, Gll^Fp
Mm, Mm, Mm, Mm, Mm, Mm, Mm, Mm^Xm, Mm^Xm, Mm, Mm, Mm, Mm, Mm, Hh^Fp, Hh^Fp, Gll^Fp, Gll^Fp, Gll^Fp, Gll^Fp, Gll^Fp, Gll^Fp, Gll, Rp, Rp, Rp, Rp, Gll^Fp, Hh^Fp, Mm^Xm, Mm^Xm, Mm^Xm, Mm^Xm, Mm, Mm, Mm^Xm, Mm, Mm, Mm^Xm, Mm, Mm, Hh^Fp, Hh^Fp
Mm, Mm, Mm, Mm, Mm^Xm, Mm^Xm, Mm^Xm, Mm, Mm, Mm, Mm^Xm, Mm, Mm, Mm, Hh^Fp, Gll^Fp, Gll^Fp, Gll^Fp, Gll^Fp, Gll^Fp, Gll^Fp, Gll^Fp, Ww, Rp, Rp, Rp, Rp, Rp, Rp, Hh^Fp, Hh^Fp, Mm, Mm, Mm^Xm, Mm^Xm, Mm, Mm, Mm, Mm, Mm^Xm, Mm^Xm, Mm, Mm
Ww, Mm, Hh^Fp, Mm, Mm, Mm, Mm, Mm, Mm^Xm, Mm, Mm, Mm^Xm, Mm^Xm, Mm, Hh^Fp, Gll^Fp, Gll^Fp, Gs^Vl, Gll, Gll, Ww, Ww, Wo, Ww, Ww, Rp, Rp, Rp, Rp, Gll^Fp, Hh^Vhh, Hh^Fp, Hh^Fp, Mm, Mm, Mm, Mm^Xm, Mm, Mm, Mm, Mm, Mm, Mm
Hh^Fp, Ww, Ww, Hh^Fp, Ww, Mm, Mm, Mm, Mm, Mm, Mm, Mm, Mm, Mm, Mm, Hh^Fp, Ww, Ww, Ww, Ww, Ww, Wo, Ww, Wo, Wo, Ww, Rp, Rp, Rp, Gll^Fp, Gll^Fp, Gll^Fp, Hh^Fp, Mm, Mm^Xm, Mm^Xm, Mm, Mm, Mm, Mm, Mm, Mm, Mm
Hh^Fp, Hh^Fp, Hh^Fp, Wo, Wo, Hh^Fp, Hh^Fp, Mm, Mm, Mm, Mm, Mm, Mm, Mm, Mm, Hh^Vhh, Ww, Ww, Wo, Ww, Gll, Ww^Ewl, Gll^Fp, Ww^Ewl, Ww, Ww, Rp, Rp, Rp, Gs, Gll, Gll^Fp, Hh^Fp, Mm, Mm, Mm, Mm, Mm, Wo, Wo, Wo, Mm, Mm
Mm, Mm, Mm, Wo, Ww, Ww, Ww, Mm, Mm, Mm, Mm, Mm, Mm, Mm, Hh^Fp, Ww, Ww^Ewl, Wo, Gll^Fp, Gll^Fp, Gll^Fp, Gll^Fp, Gll, Gll^Fp, Gll^Fp, Ww, Rp, Rp, Rp, Gs, Gs, Gll^Fp, Gll^Fp, Hh^Fp, Hh^Fp, Mm, Wo, Wo, Hh^Fp, Hh^Fp, Mm, Wo, Wo
Mm, Mm, Mm, Ww, Mm, Mm, Mm, Ww, Hh^Fp, Hh^Fp, Hh^Fp, Mm, Mm, Mm, Ww, Ww, Ww^Ewl, Gll, Gll^Fp, Gs^Vl, Gll^Fp, Gll^Fp, Gll^Es, Gll^Fp, Gll^Es, Ww, Ww^Bsb|, Rp, Gg^Bsb|, Gg^Es, Gg^Es, Gll, Ww, Ww, Ww, Wo, Wo, Hh^Fp, Mm, Mm, Mm, Mm, Mm
Mm, Mm, Hh^Fp, Ww, Ww, Mm, Ww, Ww, Wo, Hh^Fp, Ww, Hh^Fp, Hh^Fp, Hh^Fp, Ww, Wo, Ww^Ewl, Gll^Fp, Gll^Fp, Gll^Fp, Gll^Em, Gll^Fp, Gs^Vl, Gll^Fp, Ww, Ww, Wo^Bsb|, Ww^Bsb|, Ww^Bsb|, Gg^Es, Wo, Wo, Ww, Ww, Hh^Vhh, Wo, Mm, Mm, Mm, Mm^Xm, Mm^Xm, Mm, Mm
Mm^Xm, Mm, Mm, Hh^Fp, Hh^Fp, Ww, Hh^Fp, Wo, Wo, Wo, Ww, Ww, Wo, Wo, Wo, Wo, Wo, Ww^Ewl, Ww, Gll^Fp, Ww^Ewl, Ww^Ewl, Ww, Ww, Wo, Wo, Ww^Bsb|, Ww^Bsb|, Ww^Bsb|, Ww, Wo, Wo, Gll, Gll^Fp, Hh^Fp, Mm, Mm, Mm, Mm, Mm, Mm, Mm^Xm, Mm
Mm^Xm, Mm, Mm, Hh^Fp, Mm^Xm, Mm, Mm, Hh^Fp, Hh^Fp, Wo, Hh^Vhh, Ww, Wo, Wo, Wo, Wo, Wo, Wo, Wo, Ww, Ww, Ww, Ww, Wo, Ww, Ww, Rp, Ww^Bsb|, Rp, Ww, Ww, Wo, Gll^Fp, Gll^Fp, Hh^Fp, Mm, Mm^Xm, Mm, Mm, Mm, Mm, Mm, Mm
Mm, Mm^Xm, Mm^Xm, Mm, Mm, Mm, Mm, Mm, Mm, Hh^Fp, Hh^Fp, Hh^Fp, Gll^Fp, Ww, Ww, Wo, Wo, Wo, Ww, Ww, Gll, Gg, Gg, Ww, Rp, Rp, Rp, Rp, Rp, Ww, Ww, Gll^Fp, Hh^Fp, Hh^Fp, Mm, Mm, Mm, Mm, Mm, Mm, Mm, Mm, Mm
Mm, Mm, Mm, Mm, Mm, Mm, Mm, Mm^Xm, Mm^Xm, Mm, Mm, Hh^Fp, Hh^Fp, Gll^Fp, Ww, Ww, Ww, Ww, Gll^Fp, Gll^Fp, Gll, Gg^Es, Gg, Rp, Rp, Rp, Rp, Rp, Gll^Fp, Ww, Ww, Gll^Fp, Hh^Fp, Mm, Mm, Mm, Mm, Mm, Hh^Fp, Mm, Ww, Mm, Ww
Mm, Mm, Mm, Mm, Mm, Mm^Xm, Mm^Xm, Mm, Mm, Mm^Xm, Mm, Mm, Hh^Fp, Gll^Fp, Gll^Fp, Gll, Gll, Ww, Gll^Fp, Gll^Fp, Gll, Gg, Gg^Es, Rp, Rp, Rp, Gg, Gll^Fp, Gll^Fp, Ww, Ww, Gll^Fp, Hh^Vhh, Mm, Mm, Mm, Mm, Hh^Fp, Wo, Wo, Wo, Ww, Ww
Mm, Mm, Mm, Mm, Mm, Mm, Mm, Mm^Xm, Mm, Mm, Mm, Mm, Hh^Fp, Gll^Fp, Gg^Es, Gg^Es, Gll, Gll^Fp, Gll^Fp, Gs^Vl, Gll, Gll, Gg, Rp, Rp, Rp, Gg, Gs^Vl, Gll^Fp, Ww, Ww, Gll^Fp, Gll^Fp, Hh^Fp, Hh^Fp, Mm, Ww, Ww, Wo, Wo, Mm, Mm, Mm
Mm, Mm, Mm, Mm, Mm, Mm, Mm^Xm, Mm, Mm, Mm, Mm, Hh^Fp, Gll^Fp, Gll^Fp, Gll, Gll, Gll^Fp, Gll, Gll, Gll, Gll, Gg, Gg, Rp, Rp, Rp, Gg, Gll^Fp, Gll^Fp, Ww, Ww, Ww, Ww, Ww, Ww, Ww, Ww, Ww, Mm, Mm, Mm, Mm, Mm
Mm, Mm, Mm, Mm, Mm, Mm, Mm, Mm, Mm, Mm, Hh^Fp, Hh^Fp, Gll^Fp, Gll, Gll^Fp, Gll^Fp, Gs^Vl, Gll^Fp, Gll, Gg, Gll, Gll, Gll, Rp, Rp, Rp, Gg, Gg, Gll^Fp, Gll, Gll, Ww, Gll^Fp, Ww, Wo, Ww, Hh^Fp, Mm, Hh^Vhh, Mm, Mm, Mm, Mm
Mm, Mm, Mm, Mm, Mm, Mm, Mm, Mm, Hh^Vhh, Hh^Fp, Gll^Fp, Gll^Fp, Gll, Gll, Gll, Gll^Fp, Gll^Fp, Gll^Fp, Gll, Gg, Gll, Gll^Fp, Gll^Fp, Rp, Rp, Rp, Gg, Gg^Es, Gg^Es, Gll, Gll^Fp, Gll^Fp, Gll^Fp, Gll^Fp, Wo, Wo, Hh^Fp, Mm, Mm, Mm, Wo, Mm, Wo
Mm, Mm, Mm, Mm, Mm, Mm, Mm, Mm, Hh^Fp, Gll^Fp, Gll^Fp, Gs^Vl, Gg, Gll, Gg, Gll, Gll, Gll, Gg, Gg^Es, Gll, Gll^Fp, Gll, Rp, Rp, Rp, Gg, Gg, Gg^Es, Gll, Gll, Gs^Vl, Gll^Fp, Gll^Fp, Wo, Wo, Ww, Hh^Fp, Ww, Wo, Wo, Wo, Wo
Mm, Mm^Xm, Mm, Mm, Mm, Mm, Hh^Fp, Hh^Fp, Hh^Fp, Gll^Fp, Gll, Gll, Ce, Ce, Ce, Gg, Ce, Ce, Ce, Gg, Gg, Gll, Gg, Rp, Rp, Rp, Gg^Es, Gg, Gg^Es, Gg, Gll, Gll^Fp, Gll^Fp, Gll^Fp, Hh^Fp, Wo, Ww, Ww, Ww, Wo, Mm, Wo, Wo
Mm, Mm, Mm, Mm, Cud, Mm, Cud, Hh^Fp, Gll^Fp, Gll^Fp, Gll, Gg^Es, Ce, Ke, Ce, Ce, Ce, Ke, Ce, Gg^Es, Gg, Gg, Gg, Rp, Rp, Rp, Gg, Gg^Es, Gll^Em, Gg^Es, Gll^Fp, Gll^Fp, Hh^Fp, Hh^Fp, Mm^Xm, Cud, Cud, Cud, Cud, Cud, Mm, Mm, Mm
Mm, Mm, Mm, Cud, Cud, Cud, Cud, Cud, Gll^Em, Gll, Gll, Gg^Es, Gg^Es, Ce, Gg, Gg, Gg, Ce, Gg, Gg^Es, Gg, Gg, Rp, Rp, Rp, Rp, Gg, Gg, Gll^Fp, Gll, Gll^Fp, Gll^Fp, Hh^Fp, Mm, Mm, Mm^Xm, Cud, Kud, Cud, Mm, Mm, Mm, Mm
Mm, Mm, Mm, Mm, Cud, Kud, Cud, Gll^Fp, Gll^Fp, Gll^Em, Gll^Fp, Gll, Gll, Gg, Gg, Gg, Gll^Em, Gll, Gll, Gg^Es, Gg, Rp, Rp, Rp, Rp, Rp, Gll, Gll^Fp, Hh^Fp, Gll^Fp, Hh^Fp, Hh^Fp, Hh^Fp, Mm, Mm^Xm, Mm^Xm, Mm, Cud, Mm, Mm, Mm^Xm, Mm^Xm, Mm
Mm, Mm, Mm, Cud, Cud, Cud, Cud, Cud, Hh^Fp, Gll^Fp, Hh^Fp, Gs^Vl, Gll^Fp, Gll, Gll^Fp, Gll, Gll^Fp, Gll^Fp, Gs^Vl, Gll, Gll, Rp, Rp, Rp, Gll, Gll, Gll^Fp, Hh^Fp, Hh^Fp, Hh^Fp, Mm, Hh^Vhh, Mm, Mm, Mm, Mm, Mm, Mm, Mm, Mm^Xm, Mm, Mm^Xm, Mm
Mm, Mm^Xm, Mm, Mm, Mm, Mm, Mm, Hh^Fp, Mm, Hh^Fp, Hh^Fp, Hh^Fp, Gll^Fp, Gll^Fp, Hh^Fp, Gll^Fp, Hh^Fp, Hh^Fp, Hh^Fp, Gll^Fp, Gll^Fp, Rp, Rp, Rp, Gll, Gll^Fp, Hh^Vhh, Hh^Fp, Mm, Mm, Mm, Mm, Mm, Mm, Mm, Hh^Vhh, Mm, Mm^Xm, Mm, Mm, Mm, Mm, Mm
Mm, Mm, Mm, Mm, Mm, Mm, Mm, Mm, Mm, Mm, Mm, Hh^Fp, Hh^Fp, Gll^Fp, Hh^Fp, Hh^Fp, Mm, Mm^Xm, Mm, Hh^Fp, Gll^Fp, Rp, Rp, Rp, Gll, Gll^Fp, Hh^Fp, Mm, Mm, Mm, Mm, Mm, Mm, Mm, Mm^Xm, Mm, Mm, Mm, Mm, Mm^Xm, Mm, Mm, Mm
Mm, Mm, Mm^Xm, Mm, Mm, Mm, Mm, Mm, Mm, Mm, Mm, Mm, Hh^Fp, Hh^Fp, Mm^Xm, Mm, Mm, Mm, Mm, Hh^Fp, Gll^Fp, Rp, Rp, Rp, Gll^Fp, Gll^Fp, Hh^Fp, Mm, Mm^Xm, Mm, Mm, Mm, Mm, Mm, Mm, Mm, Mm, Mm^Xm, Mm, Mm, Mm, Mm, Mm
Mm, Mm, Mm^Xm, Mm^Xm, Mm, Mm, Mm, Mm, Mm, Mm^Xm, Mm, Mm, Mm, Mm, Mm, Mm^Xm, Mm^Xm, Mm, Mm, Hh^Fp, Hh^Fp, Rp, Rp, Rp, Gll^Fp, Gll^Fp, Hh^Fp, Mm, Mm, Mm, Mm, Mm, Mm^Xm, Mm, Mm, Mm, Mm^Xm, Mm, Mm, Mm, Mm, Mm, Mm
Mm, Mm, Mm, Mm, Mm, Mm, Mm, Mm^Xm, Mm, Mm, Mm, Mm^Xm, Mm, Mm, Mm^Xm, Mm, Mm, Mm, Mm, Mm, Cud, Rp, Rp, Rp, Cud, Hh^Fp, Hh^Fp, Mm, Mm, Mm^Xm, Mm^Xm, Mm, Mm, Mm, Mm, Mm, Mm, Mm^Xm, Mm, Mm, Mm, Mm, Mm
Mm, Mm^Xm, Mm, Mm, Mm, Mm, Mm, Mm, Mm, Mm, Mm, Mm, Mm, Mm, Mm, Mm, Mm, Mm, Mm, Cud, Cud, Rp, Rp, Rp, Cud, Cud, Mm, Mm, Mm, Mm, Mm, Mm, Mm, Mm, Mm, Mm, Mm^Xm, Mm^Xm, Mm, Mm, Mm, Mm, Mm
Mm, Mm, Mm, Mm, Mm, Mm, Mm, Mm, Mm, Mm, Mm, Mm, Mm, Mm, Mm, Mm, Mm, Mm, Mm, Cud, Cud, Rp, Uu, Rp, Cud, Cud, Mm, Mm, Mm, Mm, Mm, Mm, Mm, Mm, Mm, Mm^Xm, Mm, Mm, Mm, Mm, Mm, Mm, Mm
Mm, Mm, Mm, Mm, Mm, Mm, Mm, Mm, Mm, Mm, Mm, Mm, Mm, Mm, Mm, Mm, Mm, Mm, Mm, Mm, Mm, Cud, Kud, Cud, Mm, Mm, Mm, Mm, Mm, Mm, Mm, Mm, Mm, Mm, Mm, Mm, Mm, Mm, Mm, Mm, Mm, Mm, Mm
Mm, Mm, Mm, Mm, Mm, Mm, Mm, Mm, Mm, Mm, Mm, Mm, Mm, Mm, Mm, Mm, Mm, Mm, Mm, Mm, Gg, Mm, Mm, Mm, Gg, Mm, Mm, Mm, Mm, Mm, Mm, Mm, Mm, Mm, Mm, Mm, Gg, Mm, Mm, Mm, Mm, Mm, Mm
