border_size=1
usage=map

Gs, Gs, Gs, Gs, Gs, Gs, Gs, Gs, Gs, Gs, Gs, Gs, Gs, Gs, Gs, Gs, Gs, Gs, Gs, Gs, Gs, Gs, Gs, Gs, Gs, Gs, Gs, Gs, Gs, Gs, Gs, Gs, Gs, Gs, Gs, Gs, Gs, Gs, Gs, Gs, Gs, Gs, Gs, Gs, Gs, Gs, Gs, Gs, Gs, Gs, Gs, Gs, Gs, Gs, Gs, Gs, Ww, Wo, Ww, Gs, Gs, Gs, Gll, Gll, Gll^Fmf, Gll^Fmf, Gll^Fmf, Gll^Fmf, Gll^Fmf, Gll, Gll^Fmf, Gll
Gs, Gs, Gd, Gs^Es, Gd, Gs, Gd, Gs, Gs, Gs, Gs, Gs, Gs, Gs, Gs, Gs, Gs, Gs, Gd, Gs, Gd, Gs, Gs, Gs, Gs, Gs, Gs, Gs, Gs, Gs, Gs, Gs, Gs^Efm, Gs, Gs, Gs, Gs, Gs, Gs, Gs, Gs, Gs, Gs, Gs, Gs, Gs, Gs, Gs, Gs, Gs, Gs^Es, Gs, Gs, Gs, Gs, Gs, Ww, Wo, Wo, Ww, Ww, Gs, Gll, Gll^Fmf, Gll, Gll, Gll^Fmf, Gll, Gll^Fmf, Gll^Fmf, Gll^Fmf, Gll^Fmf
Gs, Gs, Gs, Gd, Gs, Gs, Gs, Gs, Ce, Ce, Ce, Ce, Ce, Gs, Gs, Gs, Gs, Gd, Gs, Gd, Gs, Gs, Gs, Gd, Gs, Gs, Gs, Gs, Gd^Es, Gs, Gs, Gs, Gs, Gs, Gd, Gd^Es, Gd, Gs, Gs, Gs, Gs, Gs^Efm, Gs, Gs, Gs, Gd, Gd, Gs^Efm, Gs, Gd, Gd, Gs, Gs, Gs^Es, Gs, Gs, Gs, Ww, Ww, Wo, Ww, Gs, Gll, Gll, Gll, Gll, Gll, Gll^Fmf, Gll, Gll^Fmf, Gll^Fmf, Gll
Gs, Gs, Gd, Gs, Gs^Es, Gs, Gs, Gs, Ce, Re^Vct, Ce, Re^Vct, Ce, Gs, Gs, Gs, Gs, Gs, Gs, Gs, Gs, Gs, Gs, Gs, Gs^Es, Gs, Gd^Gvs, Gs^Gvs, Gs^Gvs, Gs, Gs, Gs, Gs, Gs^Efm, Gs, Gs^Efm, Gs, Gs^Es, Gd, Gs, Gs^Efm, Gs, Gs^Efm, Gs, Gs^Es, Gd, Gs^Efm, Gs, Gs, Gs, Gs, Gs, Gs, Gs^Es, Gs, Gs, Gs, Ds, Ds, Ww, Wo, Ww, Gs, Gll^Fmf, Gll, Gll^Fmf, Gll^Fmf, Gll^Em, Gll, Gll^Fmf, Gll^Fmf, Gll
Gs, Gd, Gs, Gs, Gs, Gs, Gs, Ce, Re^Vct, Ce, 3 Ke, Ce, Re^Vct, Ce, Gs, Gs, Gs, Gs, Gs, Gs, Gs, Gs, Gd^Fetd, Gs, Gs, Gs^Gvs, Gd^Gvs, Gs^Gvs, Gs^Gvs, Gs^Gvs, Gs, Gs, Gs, Gd, Gs, Gs, Gs^Efm, Gs, Gs, Gd, Gs^Efm, Gs^Efm, Gs, Gs^Es, Gs^Es, Gs, Gs, Gs^Efm, Gs, Gs, Gs, Gd, Gs, Gs, Gs, Gs^Es, Gs, Gs, Ds, Ww, Wo, Ww, Gs, Gll, Gll, Gll^Fmf, Gll, Gll^Fmf, Gll^Fmf, Gll, Gll^Fmf, Gll^Fmf
Gd, Gs, Gs, Gs, Gs, Gs, Gs, Ce, Ce, Ce, Ce, Ce, Ce, Ce, Gs, Gs, Gs, Gs, Gd, Gd, Gd, Gd, Gs, Gs^Es, Gs, Gs, Gs, Gd^Gvs, Gs, Gs, Gs, Gs, Gs, Gs, Gd, Gs^Efm, Gs, Gs, Gs, Gd, Gs, Gd, Gs, Gs, Gs^Es, Gs, Gs, Gd^Efm, Gs, Gd, Gll, Gll, Gll^Fmf, Gs, Gs, Gs, Gs, Gs, Gs, Ww, Wo, Ww, Gs, Gs, Gs, Gll, Gll^Fmf, Gll, Gll^Fmf, Gll, Gll^Fmf, Gll
Gs, Gd, Gs, Gs, Gs, Gs, Gs, Gs, Ce, Re^Vct, Ce, Re^Vct, Ce, Gs, Gs, Gs, Gd, Gs, Gd, Gs, Gs, Gd, Gs, Gd, Gs, Gs, Gs, Gs, Gs, Gs, Gd, Gd^Vo, Gs, Gs, Gs, Gs, Gd^Es, Gs, Gs, Gs^Es, Gs, Gs^Es, Gs, Gd, Gd^Es, Gs, Gs, Gd, Gs, Gll, Gll^Fmf, Gll, Gll^Fmf, Gll^Fmf, Gll^Fmf, Gs, Gs, Gs, Gs, Ww, Wo, Ww, Ww, Gs, Gs^Es, Gs, Gll, Gll^Fmf, Gll^Fmf, Gll^Fmf, Gll^Em, Gll
Gs, Gs, Gs, Gd, Gs, Gs, Gs, Gs, Gs, Ce, Gs, Ce, Gs, Gs, Gs, Gs, Gd, Gd, Gs, Gs, Gs, Gs, Gs, Gs^Es, Gs, Gs, Gs, Gs, Gs, Gs, Gs, Gs, Gs^Gvs, Gd^Gvs, Gs^Gvs, Gs, Gs, Gs, Gs^Es, Gs^Es, Gs, Gs, Gs, Gs, Gs, Gs, Gs, Gs, Gll^Fmf, Gll^Fmf, Gll, Gll^Fmf, Gll, Gll^Fmf, Gll^Fmf, Gs, Gs, Gs, Gs, Ww, Ww, Wo, Ww, Gs, Gs, Gs, Gll, Gll, Gll^Fmf, Gll^Fmf, Gll^Fmf, Gll
Gs, Gs, Gd, Gs, Gs, Gs, Gs, Gs, Gs, Gs, Gs, Gs, Gs, Gs, Gs, Gs, Gd, Gs, Gll^Fmf, Gll^Fmf, Gd, Gs, Gs, Gs, Gs, Gd^Es, Gd, Gs, Gd, Gs, Gs, Gs^Gvs, Gs^Gvs, Gd^Gvs, Gs^Gvs, Gd^Gvs, Gs^Es, Gd^Es, Gs, Gs, Gs, Gs, Gd, Gs^Es, Gs, Gs, Gs, Gs, Gll^Fmf, Gll^Fmf, Gll^Fmf, Gll, Gll^Fmf, Gll^Fmf, Gll, Gll^Fmf, Gll^Fmf, Gs, Gs, Gs, Ww, Wo, Ww, Ww, Gs, Gs, Gll^Fmf, Gll^Fmf, Gll^Fmf, Gll^Fmf, Gll^Fmf, Gll
Gs, Gs, Gd, Gs^Es, Gs, Gs, Gs, Gs, Gs^Es, Gs, Gs, Gs, Gs, Gs, Gs, Gs, Gd, Gs, Gll^Fmf, Gd^Vo, Gd, Gs, Gs, Gd, Gs, Gs, Gs, Gs^Es, Gs^Gvs, Gs^Gvs, Gs^Gvs, Gs, Gs, Gs^Gvs, Gd, Gd^Es, Gs, Gs, Gs, Gs, Gs, Gs, Gs, Gs, Gs, Gs, Gs, Gs, Gd, Gll^Fmf, Gll, Gll^Fmf, Gll^Fmf, Gll^Fmf, Gll^Fmf, Gll, Gs, Gs^Es, Gs, Gs, Ww, Wo, Wo, Ww, Gs, Gs, Gll, Gll, Gll, Gll^Fmf, Gll, Gll
Gs, Gs, Gs, Gs, Gd, Gs, Gd, Gs, Gd, Gd, Gd, Gd, Gs, Gs, Gs^Es, Gs, Gs, Gs, Gd, Gs, Gd, Gs, Gll^Fmf, Gs, Gd, Gs, Gs, Gs^Gvs, Gs^Gvs, Gs^Gvs, Gs^Gvs, Gs^Gvs, Gs, Gd, Gs, Gs, Gs, Gs, Gs, Gs, Gs, Gs, Gs, Gs, Gs, Gs, Gs^Es, Gs, Gs, Gs, Gd, Gll, Gll, Gll^Fmf, Gll^Fmf, Gll^Fmf, Gs, Gs, Gs^Es, Gs, Ww, Ww, Wo, Ww, Gs, Gs, Gs, Gll^Fmf, Gll, Gll, Gll^Fmf, Gll^Fmf
Gs, Gs, Gs, Gs, Gd, Gs, Gd, Gs, Gs, Gs^Es, Gs, Gs, Gs, Gd, Gs, Gs, Gs, Gs, Gd, Gs, Gs, Gll^Fmf, Gs, Gs, Gll^Fmf, Gs, Gd, Gs, Gs, Gs^Gvs, Gs, Gs, Gs, Gs, Gs, Gs, Gll, Gs, Gll, Gll, Gll, Gll, Gll, Gll, Gs, Gs, Gs, Gs, Gs, Gs, Gs, Gll^Fmf, Gll, Gll^Fmf, Gs, Gll^Fmf, Gs, Gs, Gs, Gs, Ww, Wo, Wo, Ww, Gs, Gs, Gs^Es, Gll, Gll^Fmf, Gll, Gll^Fmf, Gll^Fmf
Gs, Gs, Gs, Gs, Gs, Gd^Vo, Gs, Gs, Gs, Gs, Gs, Gs^Es, Gs, Gs, Gs, Gs, Gs, Gd, Gs, Gs, Gs, Gs, Gs, Gs^Es, Gll^Fmf, Gs, Gs, Gs, Gs, Gs, Gs, Gs, Gll, Gs, Gll, Gll, Gll^Fmf, Gll^Fmf, Gll^Fmf, Gll^Fmf, Gll^Fmf, Gll^Fmf, Gll^Fmf, Gll^Fmf, Gll^Fmf, Gs, Gs, Gs, Gs, Gs, Gs, Gs, Gs, Gs, Gs, Gs, Ds, Gs, Ds, Ds, Ww, Wo, Wo, Ww, Gs, Gs, Gs, Gs, Gd, Gll^Fmf, Gd, Gll
Gs, Gs, Gs, Gs, Gs, Gs, Gs, Gs, Gs, Gs, Gs, Gs, Gs, Gs, Gs, Gs, Gs, Gs, Gs, Gs, Gd^Es, Gs, Gd, Gs, Gd, Gs, Gs, Gs, Gs, Gs, Gll^Fmf, Gll, Gll^Fmf, Gll^Fmf, Gll^Fmf, Gll^Fmf, Gll, Gll^Fmf, Gll^Fmf, Gll^Fmf, Gll^Fmf, Gll, Gll^Fmf, Gll, Gll^Fmf, Gll, Gll, Gll, Gs, Gd^Vo, Gs, Gs, Gs, Gs, Ww, Ds, Ww, Ds, Ww, Ds, Ww, Wo, Ww, Ww, Gs, Gs, Gs, Gd, Gs, Gd, Gs, Gd
Gs, Gs, Gs, Gs, Gs, Gs, Gs, Gs, Gs, Gs, Gs, Gs, Gs, Gs, Gs, Gd^Fetd, Gs, Gs, Gs, Gd, Gs, Gs^Es, Gs, Gd, Gs, Gd, Gs, Gd, Gs, Gs, Gll^Fmf, Gll^Fmf, Gll^Fmf, Gll^Fmf, Gll^Fmf, Gll^Fmf, Gll^Fmf, Gll^Fmf, Gll^Fmf, Gll, Gll^Fmf, Gll^Fmf, Gll, Gll^Fmf, Gll^Fmf, Gll^Fmf, Gll^Fmf, Gll^Fmf, Gll^Fmf, Gs, Gs, Gs, Ww, Ww, Wo, Ww, Wo, Ww, Wo, Ww, Wo, Wo, Ww, Gs, Gs, Gs, Gd^Es, Gs, Gs, Gs, Gd, Gs
Gs, Gs, Gs, Gs, Gs, Gs, Gs, Gs, Hhd, Gs, Hhd, Gs, Hhd, Gs, Gs, Gs, Gs, Gs, Gd, Gs, Gs, Gs, Gd, Gs, Gs, Gs, Gs, Gs, Gs, Gll^Fmf, Gll^Fmf, Gll^Fmf, Hhd^Fmf, Gll^Fmf, Gll, Gll^Fmf, Gll^Fmf, Gll, Gll^Fmf, Gll^Fmf, Gll^Fmf, Gll^Fmf, Gll, Gll^Fmf, Gll, Gll, Gll^Fmf, Gll^Fmf, Gll^Fmf, Gs, Gs, Gs, Ww, Wo, Ww, Wo, Ww, Wo, Ww, Wo, Ww, Ww, Gs, Gs, Gs, Gs, Gd, Gs, Gs, Gd, Gs, Gs^Es
Gs, Gs, Gs, Gs, Hhd^Fmf, Hhd^Fmf, Hhd^Fmf, Hhd^Fmf, Md, Hhd, Md, Hhd^Fmf, Hhd^Fmf, Hhd, Hhd, Gs, Gs, Gs, Gs, Gs, Gs, Gd^Fetd, Gs, Gs, Gs, Gs, Gs, Gs, Gs, Gll^Fmf, Hhd^Fmf, Hhd^Fmf, Md, Hhd^Fmf, Hhd^Fmf, Gll^Fmf, Gll^Fmf, Gll^Fmf, Gll^Fmf, Gll^Fmf, Gll^Fmf, Gll^Fmf, Gll^Fmf, Gll^Fmf, Gll^Fmf, Gll^Fmf, Gll^Fmf, Gll^Fmf, Ds, Ds, Ww, Ww, Ww, Ww, Ds, Ww, Ds, Ww, Ds, Ww, Gs, Gs, Gs, Gs, Gd, Gs, Gd, Gd, Gd, Gs^Es, Gd, Gs
Gs, Gs, Hhd^Fmf, Hhd^Fmf, Md, Md, Md, Md, Hhd^Fmf, Md, Md, Hhd^Fmf, Hhd^Fmf, Hhd^Fmf, Md, Gs, Gs, Gs, Gs, Gs, Gs, Gd, Gd, Gs, Gs, Gs, Gll, Gs, Gll^Fmf, Gll^Fmf, Hhd^Fmf, Md, Md, Md, Ko, Gll^Fmf, Ko, Ko, Ko, Ko, Ko, Ko, Ko, Gll^Fmf, Gll^Fmf, Gll^Fmf, Gll^Fmf, Ds, Ww, Ww, Wo, Wo, Ww, Ds, Gs, Gs, Gd, Ds, Gd, Gs, Gs, Gs, Gd, Gs, Gd, Gs, Gs, Gs^Es, Gs, Gs, Gd, Gs
Gs, Hhd^Fmf, Md, Md, Md, Md, Hhd^Fmf, Hhd^Fmf, Gll^Fmf, Hhd, Hhd, Hhd^Fmf, Hhd^Fmf, Md, Md, Hhd^Fmf, Hhd, Gs, Gs, Gd, Gd, Gd, Gd^Vo, Gs, Gll, Gll^Fmf, Gll, Gll^Fmf, Hhd^Fmf, Hhd^Fmf, Md, Md, Ko, Ko, Urb, Ko, Urb, Urb, Wwg, Ko, Wwg, Urb, Urb, Ko, Ko, Gll^Fmf, Gll^Fmf, Ds, Ww, Wo, Ww, Ww, Gs, Gs, Gd, Gd, Gd, Gd, Gs, Gd, Gd, Gs, Gs, Gd, Gs, Gs, Gd, Gs, Gd, Gs, Gs, Gs
Hhd^Fmf, Hhd^Fmf, Md, Md, Hhd^Fmf, Hhd^Fmf, Gll^Fmf, Gll^Fmf, Gll^Fmf, Gll^Fmf, Gll^Fmf, Gll^Fmf, Gll^Fmf, Hhd^Fmf, Hhd^Fmf, Hhd^Fmf, Hhd, Gs, Gs, Gd, Gd, Gll^Fmf, Gll^Fmf, Gll^Fmf, Gs, Gll^Fmf, Gll^Fmf, Gll^Fmf, Hhd^Fmf, Md, Md, Md, Ko, Urb, Urb, Urb, Wwg, Wwg, Co, Ww^Bsb|, Co, Wwg, Wwg, Urb, Urb, Ko, Ko, Ds, Ww, Wo, Ww, Ds, Gs, Gs, Gd, Gd^Es, Gd, Gs, Gs, Gs^Es, Gs^Es, Gs, Gs, Gs, Gd, Gs, Gs, Gs, Gs, Gs, Gs, Gs
Hhd^Fmf, Md, Md, Hhd^Fmf, Gll, Gll^Fmf, Gll, Gll^Fmf, Re^Vct, Gll^Fmf, Ce, Gll, Gll^Fmf, Gll^Fmf, Gll^Fmf, Gll^Fmf, Gs, Gd, Gs, Gs, Gs, Gs, Gs, Gs, Gs, Gs, Gs, Gll^Fmf, Gll^Fmf, Gll^Fmf, Gll^Fmf, Md, Ko, Urb, Urb, Gd^Vo, Wwg, Co, Wwg, Ko, Wwg, Co, Wwg, Gd^Vo, Urb, Urb, Wwg, Wwg, Ds, Wo, Wo, Ww, Ww, Gs, Gs, Gs, Gs, Gs, Gs, Gs, Gs, Gd, Gs, Gs, Gs, Gs, Gs, Gs, Gs, Gs, Hhd, Gs
Hhd^Fmf, Md, Md, Hhd^Fmf, Gll^Fmf, Gll^Fmf, Gll, Gll, Gll^Es, Gll, Gll^Fmf, Gll^Fmf, Gll, Gll^Es, Gll, Re^Vct, Gs, Gs, Gs, Gs, Gs, Gs, Gs, Gs, Gs, Gs, Hhd, Hhd, Hhd^Fmf, Hhd^Fmf, Hhd^Fmf, Md, Md, Md, Urb, Wwg, Co, Ko, Co, Co, Co, Ko, Co, Wwg, Wwg, Wwg, Urb, Ko, Gll^Fmf, Ds, Ww, Wo, Wo, Ww, Ds, Gs, Gs, Gd, Gs, Gd, Gs, Gd, Hhd, Gs, Gs, Gs, Hhd, Gs, Hhd, Hhd, Hhd, Hhd
Md, Md, Md, Hhd, Gll^Fmf, Gll, Gll, Ce, Gll^Fmf, Gll, Ce, Gll^Fmf, Gll, Ce, Gll^Fmf, Gs, Gs, Gs, Gs, Gs, Gs, Gs, Gs, Gs, Gs, Hhd, Hhd, Hhd, Hhd^Fmf, Md, Md, Md, Md, Hhd, Hhd, Wwg, Co, Wwg, Co, Ko, Co, Wwg, Co, Wwg, Urb, Urb, Urb, Ko, Gll^Fmf, Gll^Fmf, Ds, Ww, Ww, Ww, Ww, Ds, Gs, Gs, Gs, Gs, Gs, Hhd, Hhd, Hhd, Hhd, Hhd, Hhd, Hhd, Hhd, Hhd, Hhd, Hhd
Md, Md, Hhd^Fmf, Gll^Fmf, Gll, Gll^Fmf, Gll, Gll^Fmf, Gll, Ce, 2 Ke, Ce, Gll^Fmf, Gll, Gll^Fmf, Gd, Gs, Gd, Gs, Gs, Gs, Gs, Gs, Gs, Hhd, Hhd, Hhd, Hhd^Fmf, Hhd^Fmf, Md, Md, Md, Md, Md, Hhd, Wwg, Wwg, Ko, Wwg, Co, Wwg, Ko, Wwg, Wwg, Urb, Urb, Urb, Ko, Gll^Fmf, Gll^Fmf, Gll^Fmf, Ds, Ww, Wo, Ww, Ds, Gs, Gs^Es, Gs, Gs, Hhd, Hhd, Hhd, Hhd, Hhd^Fmf, Hhd^Fmf, Hhd^Fmf, Hhd, Hhd^Fmf, Hhd, Hhd^Fmf, Hhd^Fmf
Md, Md, Md, Gll^Fmf, Gll^Fmf, Gll^Fmf, Gll^Fmf, Gll^Fmf, Gll, Ce, Ce, Ce, Gll, Gll, Gs, Gd, Gs, Gs, Gd, Gs, Gd^Vo, Gs, Gs, Gs, Hhd, Hhd, Hhd, Hhd^Fmf, Hhd^Fmf, Md, Md, Md, Hhd, Hhd, Urb, Urb, Wwg, Co, Co, Ko, Co, Co, Wwg, Urb, Gd^Vo, Urb, Ko, Ko, Gll^Fmf, Gll^Fmf, Gll^Fmf, Ds, Ww, Wo, Ww, Ds, Gs, Gs, Gs, Hhd, Hhd, Hhd, Hhd, Hhd, Hhd^Fmf, Hhd^Fmf, Hhd^Fmf, Hhd^Fmf, Hhd^Fmf, Hhd^Fmf, Hhd^Fmf, Hhd^Fmf
Hhd, Md, Md, Hhd, Gll^Fmf, Gll, Gll, Ce, Gll^Es, Gll, Gll, Gll^Fmf, Gll^Fmf, Ce, Gs, Gd, Gs, Gs, Gs, Gll^Fmf, Gs, Gs, Gs, Hhd, Hhd, Hhd, Hhd, Hhd, Hhd^Fmf, Hhd^Fmf, Md, Md, Hhd, Hhd, Urb, Urb, Urb, Wwg, Wwg, Ww^Bsb|, Wwg, Wwg, Urb, Urb, Urb, Urb, Ko, Gll^Fmf, Gll^Fmf, Gll^Fmf, Gll^Fmf, Gll^Fmf, Ww, Wo, Wo, Ww, Gs, Gs, Gs, Gs, Hhd, Hhd, Hhd, Hhd, Hhd^Fmf, Hhd^Fmf, Hhd^Fmf, Hhd^Fmf, Hhd^Fmf, Hhd^Fmf, Hhd^Fmf, Hhd^Fmf
Hhd^Fmf, Md, Md, Hhd, Gll^Fmf, Gll, Re^Vct, Gll^Fmf, Gll^Fmf, Gll^Fmf, Ce, Gll^Fmf, Gll^Fmf, Gs, Gs, Gs, Gs, Gs, Gs, Gs, Gs, Gs, Gs, Hhd, Hhd, Hhd, Gs, Hhd, Gll^Fmf, Md, Md, Md, Hhd, Urb, Urb, Urb, Urb, Urb, Urb, Urb, Urb, Urb, Ko, Urb, Urb, Ko, Gll, Gll^Fmf, Gll, Gll^Fmf, Gll^Fmf, Gll^Fmf, Ww, Wo, Wo, Ww, Gs, Gs, Gs, Gs, Gs, Hhd, Hhd, Hhd, Hhd, Hhd^Fmf, Hhd^Fmf, Hhd^Fmf, Hhd^Fmf, Hhd^Fmf, Hhd^Fmf, Hhd^Fmf
Hhd^Fmf, Md, Md, Hhd^Fmf, Gll^Fmf, Gll^Fmf, Gll, Gll^Fmf, Gll, Gll, Gs, Gll^Es, Gs, Re^Vct, Gs, Gs, Hhd, Gd, Gd, Gs, Gs, Gs, Gs, Hhd, Hhd, Hhd, Gs, Gs, Gll^Fmf, Gll^Fmf, Ko, Hhd, Urb, Urb, Urb, Urb, Urb, Gd^Vo, Urb, Urb, Urb, Urb, Urb, Ko, Ko, Ko, Rb, Rb, Rb, Gll, Gll, Gll, Gd, Ww, Wo, Ww, Ww, Gs, Gs, Gs^Es, Gs, Gs, Gs, Hhd, Hhd, Hhd, Hhd^Fmf, Hhd^Fmf, Hhd^Fmf, Hhd^Fmf, Hhd^Fmf, Hhd
Hhd, Hhd^Fmf, Md, Hhd^Fmf, Hhd^Fmf, Gll^Fmf, Hhd, Gs, Gs, Gs, Gs, Gll, Gll, Gs, Hhd, Hhd, Hhd, Gd, Gs, Gs, Gs, Gs, Gs, Gs, Gs, Gs, Gs, Gs, Gll^Fmf, Gll^Fmf, Ko, Urb, Urb, Urb, Gd^Vo, Urb, Urb, Urb, Urb, Urb, Urb, Urb, Rb, Rb, Rb, Rb, Rb, Rb, Rb, Rb, Rb, Gs, Gd, Ww, Ww, Wo, Ww, Gs, Gs, Gd, Gll^Fmf, Gs, Gs, Hhd, Hhd, Hhd, Hhd, Hhd^Fmf, Hhd, Hhd^Fmf, Hhd, Hhd
Gll^Fmf, Hhd^Fmf, Hhd^Fmf, Md, Md, Hhd^Fmf, Hhd^Fmf, Hhd, Gll^Fmf, Gll, Gll, Gll, Gll^Fmf, Gll^Fmf, Hhd^Fmf, Hhd^Fmf, Hhd^Fmf, Gs, Gs, Gs, Gs^Es, Gs, Gs, Gs, Gs, Gs, Gs, Gs, Gll, Gll^Fmf, Gll^Fmf, Ko, Urb, Urb, Urb, Urb, Urb, Urb, Urb, Ko, Ko, Rb, Rb, Rb, Rb, Rb, Rb, Rb, Rb, Rb^Es, Rb, Rb, Rb, Gs, Ww, Wo, Ww, Gs, Gs^Es, Gs, Gll^Fmf, Gll^Fmf, Gll^Fmf, Gs, Hhd, Hhd, Hhd, Hhd, Hhd, Hhd, Hhd, Hhd
Gs, Gll^Fmf, Hhd^Fmf, Md, Md, Md, Md, Hhd, Hhd^Fmf, Gll^Fmf, Gll^Fmf, Gll^Fmf, Hhd^Fmf, Hhd^Fmf, Md, Md, Hhd^Fmf, Gd, Gd, Gs, Gs, Gs, Gs, Gs, Gs, Gs, Gs, Gs, Gll^Fmf, Gll^Fmf, Gll^Fmf, Ko, Urb, Urb, Urb, Urb, Gd^Vo, Urb, Urb, Urb, Ko, Ko, Gll, Rb, Rb, Rb, Gs, Gs, Gs, Rb, Rb, Rb, Rb, Rb, Ww^Bw\, Wo, Ww, Gs, Gs, Gd, Gs, Gll^Fmf, Gd, Gs, Gs, Hhd, Gs, Hhd, Gs, Gs, Gs, Hhd
Gs, Gll^Fmf, Gll^Fmf, Hhd^Fmf, Md, Hhd^Fmf, Md, Md, Md, Hhd^Fmf, Md, Hhd^Fmf, Md, Md, Md, Hhd^Fmf, Hhd, Gs, Gs, Gs, Gd, Gll^Fmf, Gll^Fmf, Gs, Gs, Gs, Gs, Gs, Gll, Gll^Fmf, Gll^Fmf, Ko, Ko, Urb, Urb, Urb, Urb, Urb, Ko, Ko, Gll^Fmf, Gll^Fmf, Gll^Fmf, Gll, Gs, Gs, Gs, Gs^Es, Gs, Gs, Gs, Rb, Ww^Bw\, Ww^Bw\, Wo^Bw\, Wo^Bw\, Ww^Bw\, Gs, Gs, Gs, Gs, Gs, Gs, Gs, Gs^Es, Gs, Gs, Gs, Gs, Gs, Gs, Gs
Gs, Gs, Gll^Fmf, Hhd, Hhd^Fmf, Md, Hhd^Fmf, Md, Hhd^Fmf, Md, Md, Md, Md, Md, Hhd, Hhd^Fmf, Gs, Gs, Gs, Gs, Gs, Gd^Vo, Gd, Gs, Gd^Gvs, Gs, Gs, Gs, Gll^Fmf, Gll^Fmf, Gll^Fmf, Gll^Fmf, Gll^Fmf, Ko, Ko, Urb, Urb, Urb, Ko, Gll^Fmf, Gll^Fmf, Gll^Fmf, Gll^Fmf, Gs, Gs, Gs, Gd, Gd, Gs, Gs, Gs, Gs, Ww, Wo^Bw\, Ww^Bw\, Ww^Bw\, Rb, Rb, Rb, Rb, Rb, Rb, Rb, Rb, Rb, Rb, Rb, Rb, Rb, Rb, Rb, Rb
Gs, Gs, Gs, Gll^Fmf, Gll^Fmf, Hhd, Gd^Vo, Hhd, Gll^Fmf, Hhd^Fmf, Hhd^Fmf, Md, Hhd, Hhd, Gs, Gd, Gs, Gd, Gs, Gs, Gs, Gs, Gd^Gvs, Gs^Gvs, Gd^Gvs, Gs^Gvs, Gs^Gvs, Gs, Gs, Gll^Fmf, Gll^Fmf, Gll^Fmf, Gll^Fmf, Gll^Fmf, Gll^Fmf, Ko, Ko, Ko, Gll^Fmf, Gll^Fmf, Gll^Fmf, Gll^Fmf, Gll, Gs, Gs, Gd, Gs, Gs, Gs, Gd, Gs, Gs, Ww, Wo, Ww, Rb, Rb, Rb, Rb, Rb, Rb, Rb, Rb, Rb, Rb, Rb, Rb, Rb, Rb, Rb, Rb, Rb
Gd, Gs, Gs^Es, Gs, Gs, Gs, Gs, Gs, Gd, Gll^Fmf, Gs, Hhd, Gs, Gs, Gs, Gs, Gd, Gs, Gs, Gs, Gs, Gs, Gs, Gs^Gvs, Gs^Gvs, Gs^Gvs, Gs, Gs, Gs, Gll, Gll, Gll^Fmf, Gll^Fmf, Gll^Fmf, Gll^Fmf, Gll^Fmf, Gll^Fmf, Gll^Fmf, Gll^Fmf, Gll^Fmf, Gll^Fmf, Gll, Gs, Gs, Gd, Gs, Gs, Gs^Es, Gs, Gs, Gs, Gd, Ww, Wo, Ww, Gs, Gs, Gs, Gs, Gs, Gs, Gs, Ce, Gs, Gd, Gs, Gs, Gs, Gs, Gs, Gs, Gs
Gs, Gs, Gs, Gs, Gs, Gs, Gs, Gs, Gd, Gs, Gs, Gs, Gd, Gs, Gs, Gs, Gs, Gs^Es, Gs, Gs, Gs, Gs, Gd, Gd, Gs, Gs, Gs, Gs, Gd, Gs, Gs, Gll^Fmf, Gll^Fmf, Gll^Fmf, Gll^Fmf, Gll^Fmf, Gll, Gll^Fmf, Gs, Gll, Gs, Gs, Gs, Gs, Gs, Gd, Gs, Gd, Gd, Gs, Ds, Ds, Ww, Wo, Ww, Gs, Gs, Gs, Gd, Re^Vct, Gs, 1 Ce, Ke, Ce, Gs, Re^Vct, Gs, Gs, Hhd, Hhd, Hhd, Hhd
Gs, Gs, Gs, Gd, Gd, Gs^Es, Gd, Gs, Gs, Gs, Gs, Gs, Gd, Gs, Gs, Gd, Gs, Gs, Gs, Gd^Fetd, Gd, Gd, Gs, Gs, Gs, Gd^Es, Gs, Gd, Gs, Gs, Gs, Gs, Gs, Gs, Gs, Gs, Gs, Gs, Gs, Gs, Gs, Gs, Gd, Gs, Gs, Gd^Vo, Gs, Gs, Gd, Gs, Ds, Ww, Wo, Wo, Ww, Gs, Gs, Gd, Gll^Fmf, Gd, Gll^Fmf, Ce, Ce, Ce, Gs, Gs, Hhd, Hhd, Hhd, Hhd, Hhd, Hhd
Gs, Gs, Gs, Gs, Gs, Gd, Gs, Gs, Gs, Gs, Gs, Re^Vct, Gs, Gs, Gs, Gs, Gs, Gd, Gs, Gs, Gd, Gs, Gd, Gs, Gs, Gs, Gs^Es, Gd, Gs, Gs, Gs, Gs, Gs, Gs, Gs^Es, Gs, Gs, Gs, Gd, Gs^Es, Gs, Gs, Gd^Gvs, Gs^Gvs, Gs^Gvs, Gd, Gs^Efm, Gd^Efm, Gs^Efm, Gs, Gs, Ww, Wo, Wo, Ww, Gs, Gs^Es, Gs, Gd, Gll^Fmf, Gll^Fmf, Gs, Gs, Gs, Hhd, Hhd, Hhd, Hhd, Hhd^Fmf, Hhd^Fmf, Hhd^Fmf, Hhd^Fmf
Ds, Ds, Ds, Gs, Gs, Gd, Gd, Re^Vct, Gs, Gs, Gs, Gs, Gd, Gs, Gs, Re^Vct, Gd, Gs, Gd, Gs, Gs, Gs, Gd^Fetd, Gs, Gs, Gs, Gs, Gs, Gs, Gs^Es, Gs, Gs, Gs, Gs^Es, Gs, Gs, Gs, Gs, Gs, Gs, Gs, Gs^Gvs, Gs^Gvs, Gs^Gvs, Gs^Gvs, Gs^Gvs, Gs, Gs, Gs, Gs, Gs, Ww, Wo, Wo, Ww, Ds, Gs, Gs, Gs, Gll^Fmf, Gs, Re^Vct, Gs, Hhd, Hhd, Hhd, Hhd^Fmf, Hhd^Fmf, Hhd^Fmf, Hhd^Fmf, Hhd^Fmf, Hhd^Fmf
Ww, Ww, Ww, Ds, Gs, Gs, Gs, Gs, Gs, Gs, Gs, Ce, Gs, Gs, Gd, Gs, Gd, Gs, Gs, Gd, Gs, Gs, Gs, Gs, Gs, Gs, Gs, Gs, Gs, Gs, Gs, Gs, Ss, Gs, Ss, Gs, Gs, Gs, Gs, Gs, Gs, Gs, Gs, Gd^Gvs, Gs^Es, Gs, Gs^Es, Gd, Gs, Gs, Gs, Ww, Wo, Ww, Ds, Ds, Gs, Gd, Gs, Gll^Fmf, Gs, Gs, Hhd, Hhd, Hhd^Fmf, Hhd^Fmf, Hhd^Fmf, Hhd^Fmf, Hhd, Hhd^Fmf, Hhd^Fmf, Hhd^Fmf
Ww, Ww, Ww, Ds, Ds, Gs, Gs, Gs, Gs, Ce, Ce, Ce, Ce, Ce, Gs, Gs, Gs, Gs, Gs, Gs, Gs, Gs, Ds, Gs, Ds, Gs, Gs, Gs, Gs, Gs, Gs, Ss, Ss, Ss, Ss, Ss, Ss, Gs, Ww, Gs, Gs, Gs, Gs, Gs, Gs, Gs, Gs, Gs, Ds, Ds, Ww, Ww, Wo, Ww, Ds, Gs, Gs, Gd, Gll^Fmf, Gs, Gs, Gs, Hhd, Hhd, Hhd^Fmf, Hhd^Fmf, Hhd^Fmf, Hhd^Fmf, Hhd^Fmf, Hhd^Fmf, Hhd, Hhd^Fmf
Wo, Ww, Ww, Ww, Ds, Gs, Gs, Gs, Gs, Gs, Ce, 4 Ke, Ce, Gs, Gs, Gs, Re^Vct, Gs, Gs, Gs, Ds, Ds, Ww, Ds, Ww, Ds, Ds, Gd^Vo, Ds, Gs, Ss, Ss, Ss, Ss, Ww, Ww, Ww, Ww, Wo, Ww, Ww, Gs, Gs, Gs, Gs, Gs, Ss, Ds, Ss, Ww, Wo, Wo, Ww, Ww, Gs, Gs, Gs, Gs, Gll^Fmf, Gll^Fmf, Gs, Gs, Gs, Hhd, Hhd, Hhd^Fmf, Hhd^Fmf, Hhd^Fmf, Hhd^Fmf, Hhd^Fmf, Hhd^Fmf, Hhd^Fmf
Wo, Ww, Ww, Ww, Ww, Ds, Gs, Re^Vct, Gs, Ce, Gs, Ce, Gs, Ce, Gs, Gs, Gs, Gs, Ds, Ds, Ww, Ww, Ww, Ww, Ww, Ww, Ww, Ds, Ww, Ds, Ss, Ss, Ww, Ww, Wo, Wo, Wo, Wo, Ww, Wo, Wo, Ww, Ww, Ww, Ww, Ss, Ww, Ss, Ww, Ww, Wo, Ww, Ds, Ds, Gs, Gs^Es, Gs, Gd, Gs, Gll^Fmf, Gd, Gs, Gs, Gs, Hhd, Hhd^Fmf, Hhd^Fmf, Hhd, Hhd, Hhd^Fmf, Hhd^Fmf, Hhd^Fmf
Wo, Ww, Ww, Ww, Ww, Ds, Ds, Gs, Gs, Gs, Gs, Ce, Gs, Gs, Ds, Gs, Ds, Gs, Ds, Ww, Ww, Ww, Ww, Ww, Ww, Ww, Ww, Ww, Ww, Ww, Ww, Ss, Ww, Ww, Wo, Wo, Ww, Ww, Ss, Ww, Ww, Wo, Wo, Wo, Wo, Ww, Wo, Ww, Wo, Wo, Ww, Ww, Ds, Gs, Gs, Gs, Gs, Gs, Gd, Gd, Gs, Gd, Gs, Gs, Hhd, Hhd, Hhd^Fmf, Hhd, Hhd^Fmf, Hhd^Fmf, Hhd^Fmf, Hhd^Fmf
Wo, Wo, Ww, Ww, Ww, Ww, Ww, Ds, Ds, Ds, Ds, Ds, Ds, Ds, Ww, Ds, Ww, Ds, Ww, Ww, Ww, Ww, Wo, Ww, Wo, Ww, Ww, Ww, Wo, Wo, Wo, Ww, Wo, Wo, Ww, Ww, Ss, Ss, Ss, Ss, Ss, Ww, Ww, Ww, Ww, Wo, Ww, Wo, Ww, Ww, Ds, Ds, Gs, Gs, Gs^Es, Gs, Gd, Gs, Gs, Gd, Gs^Es, Gd, Gs, Gs, Hhd, Hhd, Hhd^Fmf, Hhd^Fmf, Hhd^Fmf, Hhd^Fmf, Hhd^Fmf, Hhd^Fmf
Wo, Wo, Wo, Ww, Ww, Ww, Ww, Ww, Ww, Ww, Ww, Ww, Ww, Ww, Ww, Ww, Ww, Ww, Wo, Wo, Wo, Wo, Wo, Wo, Wo, Wo, Wo, Wo, Wo, Wo, Wo, Wo, Wo, Ww, Ww, Ww, Ss, Ss, Ss, Ss, Ss, Gs, Gs, Ss, Ss, Ww, Ss, Ww, Ss, Ss, Gs, Gs, Gs, Gs, Gs, Gs, Gll^Fmf, Gs, Gs, Gs, Gs, Gd, Gs, Hhd, Hhd^Fmf, Hhd^Fmf, Hhd^Fmf, Hhd^Fmf, Hhd^Fmf, Hhd^Fmf, Hhd^Fmf, Hhd^Fmf
Wo, Wo, Wo, Wo, Wo, Ww, Ww, Ww, Ww, Ww, Ww, Ww, Ww, Ww, Ww, Ww, Ww, Ww, Wo, Wo, Wo, Wo, Wo, Wo, Wo, Wo, Wo, Wo, Wo, Wo, Wo, Wo, Wo, Wo, Ww, Ss, Ss, Ss, Gs, Gs, Gs, Gs, Gs^Es, Gs, Gs, Ss, Ss, Ss, Gs, Gs, Gs^Es, Gs^Es, Gs, Gs, Gd, Gll^Fmf, Gll^Fmf, Gll^Fmf, Gs, Gd, Gs, Gs, Gs, Hhd, Hhd, Hhd^Fmf, Hhd^Fmf, Hhd^Fmf, Hhd, Hhd^Fmf, Hhd^Fmf, Hhd^Fmf
Wo, Wo, Wo, Wo, Wo, Wo, Wo, Ww, Ww, Ww, Ww, Ww, Ww, Ww, Wo, Ww, Wo, Wo, Wo, Wo, Wo, Wo, Wo, Wo, Wo, Wo, Wo, Wo, Wo, Wo, Wo, Wo, Ww, Ww, Ss, Ss, Ss, Gs, Gs, Gs, Gd, Gd^Es, Gd, Gs, Gs, Gs, Gs, Gs, Gs, Gs, Gs, Gs, Gll^Fmf, Gs, Gll^Fmf, Gll^Fmf, Gd, Gs, Gs, Gs, Gs, Gs^Es, Gs, Gs, Gs, Hhd, Hhd, Hhd, Hhd, Hhd^Fmf, Hhd^Fmf, Hhd^Fmf
Wo, Wo, Wo, Wo, Wo, Wo, Wo, Wo, Wo, Wo, Wo, Wo, Wo, Wo, Wo, Wo, Wo, Wo, Wo, Wo, Wo, Wo, Wo, Wo, Wo, Wo, Wo, Wo, Wo, Wo, Ww, Ww, Ww, Ww, Ss, Ss, Gs, Gs, Gd, Gs, Gs, Gs, Gs, Gs, Gs, Gs, Gll^Fmf, Gs, Gs, Gs, Gd, Gd, Gll^Fmf, Gs, Gll^Fmf, Gs, Gd, Gll^Fmf, Gs, Gd, Gs, Gs, Gs, Gs, Gs, Gs, Gs, Gs, Hhd, Hhd, Hhd, Hhd
Wo, Wo, Wo, Wo, Wo, Wo, Wo, Wo, Wo, Wo, Wo, Wo, Wo, Wo, Wo, Wo, Wo, Wo, Wo, Wo, Wo, Wo, Wo, Wo, Wo, Wo, Wo, Wo, Ww, Ww, Ww, Ww, Ds, Ss, Gs, Gs, Gs, Gs, Gs^Es, Gs, Gs, Gs, Gll^Fmf, Gll^Fmf, Gs, Gll^Fmf, Gs, Gll^Fmf, Gd, Gll^Fmf, Gd, Gs, Gll^Fmf, Gs, Gll^Fmf, Gll^Fmf, Gll^Fmf, Gs, Gll^Fmf, Gs, Gd, Gs^Es, Gd, Gs^Es, Gs, Gs, Gs, Gs, Gs, Gs, Gs, Hhd
Wo, Wo, Wo, Wo, Wo, Wo, Wo, Wo, Wo, Wo, Wo, Wo, Wo, Wo, Wo, Wo, Wo, Wo, Wo, Wo, Wo, Wo, Wo, Wo, Wo, Wo, Wo, Wo, Ww, Ww, Ww, Ds, Gs, Gs, Gs, Gs, Gs, Gd, Gd, Gs, Gd, Gs, Gs, Gd, Gs, Gll^Fmf, Gs, Gll^Fmf, Gs, Gll^Fmf, Gll^Fmf, Gll^Fmf, Gs, Gd, Gs, Gll^Fmf, Gs, Gll^Fmf, Gll^Fmf, Gd, Gll^Fmf, Gs, Gs, Gs, Gd, Gs, Gs, Gs^Es, Gs^Es, Gs, Gs, Gs
Wo, Wo, Wo, Wo, Wo, Wo, Wo, Wo, Wo, Wo, Wo, Wo, Wo, Wo, Wo, Wo, Wo, Wo, Wo, Wo, Wo, Wo, Wo, Wo, Wo, Wo, Ww, Ww, Ww, Ww, Ds, Ds, Gs, Gs, Gs, Gs^Es, Gs, Gd, Gs, Gll^Fmf, Gs, Gs, Gll^Fmf, Gs, Gll^Fmf, Gd, Gll^Fmf, Gd, Gll^Fmf, Gd, Gll^Fmf, Gll^Fmf, Gll^Fmf, Gll^Fmf, Gll^Fmf, Gll^Fmf, Gs, Gs, Gll^Fmf, Gll^Fmf, Gll^Fmf, Gs, Gs, Gs, Gs, Gs, Gd, Gs, Gs, Gs, Gs^Es, Gs
Wo, Wo, Wo, Wo, Wo, Wo, Wo, Wo, Wo, Wo, Wo, Wo, Wo, Wo, Wo, Wo, Wo, Wo, Wo, Wo, Wo, Wo, Wo, Wo, Wo, Ww, Ww, Ww, Ww, Ds, Gs, Gs, Gs, Gs, Gs, Gs, Gd, Gs, Gll^Fmf, Gd, Gs, Gd, Gll^Fmf, Gs, Gll^Fmf, Gll^Fmf, Gll^Fmf, Gs, Gll^Fmf, Gll^Fmf, Gll^Fmf, Gs, Gs, Gll^Fmf, Gll^Fmf, Gll^Fmf, Gll^Fmf, Gs, Gs, Gll^Fmf, Gs, Gs, Gll^Fmf, Gs, Gs, Gs, Gll^Fmf, Gd, Gs, Gs, Gs, Gs
Wo, Wo, Wo, Wo, Wo, Wo, Wo, Wo, Wo, Wo, Wo, Wo, Wo, Wo, Wo, Wo, Wo, Wo, Wo, Wo, Wo, Wo, Wo, Wo, Wo, Ww, Ww, Ww, Ds, Ds, Gs, Gs, Gs, Gs, Gs, Gs, Gll^Fmf, Gll^Fmf, Gll^Fmf, Gs, Gll^Fmf, Gs, Gll^Fmf, Gll^Fmf, Hhd^Fmf, Hhd^Fmf, Hhd^Fmf, Gd, Gll^Fmf, Gll^Fmf, Gll^Fmf, Gll^Fmf, Gll^Fmf, Gll^Fmf, Gs, Gll^Fmf, Gs, Gll^Fmf, Gll^Fmf, Gll^Fmf, Gll^Fmf, Gll^Fmf, Gs, Gll^Fmf, Gs, Gll^Fmf, Gs, Gll^Fmf, Gll^Fmf, Gs, Gs, Gs
Wo, Wo, Wo, Wo, Wo, Wo, Wo, Wo, Wo, Wo, Wo, Wo, Wo, Wo, Wo, Wo, Wo, Wo, Wo, Wo, Wo, Wo, Wo, Wo, Wo, Ww, Ww, Ww, Ww, Ds, Ds, Gs, Gs, Gs^Es, Gs, Gll^Fmf, Gs, Gs, Gll^Fmf, Gll^Fmf, Gll^Fmf, Gd, Gs, Gll^Fmf, Hhd^Fmf, Hhd^Fmf, Hhd^Fmf, Gll^Fmf, Gll^Fmf, Gll^Fmf, Gs, Gll^Fmf, Gll^Fmf, Gs, Gll^Fmf, Gs, Gll^Fmf, Gll^Fmf, Gll^Fmf, Gs, Gll^Fmf, Gs, Gll^Fmf, Gll^Fmf, Gll^Fmf, Gll^Fmf, Gll^Fmf, Gll^Fmf, Gll^Fmf, Gll^Fmf, Gll^Fmf, Gs
Wo, Wo, Wo, Wo, Wo, Wo, Wo, Wo, Wo, Wo, Wo, Wo, Wo, Wo, Wo, Wo, Wo, Wo, Wo, Wo, Wo, Wo, Wo, Wo, Wo, Ww, Ww, Ww, Ww, Ww, Ds, Gs, Gs, Gs^Es, Gs, Gs, Gd, Gs, Gll^Fmf, Gs, Gll^Fmf, Gll^Fmf, Gs, Gs, Hhd^Fmf, Hhd^Fmf, Hhd^Fmf, Gll^Fmf, Gll^Fmf, Gll^Fmf, Gs, Gll^Fmf, Gll^Fmf, Gll^Fmf, Gll^Fmf, Gd, Gll^Fmf, Gll^Fmf, Gs, Gll^Fmf, Gs, Gll^Fmf, Gll^Fmf, Gll^Fmf, Gll^Fmf, Gll^Fmf, Gll^Fmf, Gs, Gs, Gll^Fmf, Gll^Fmf, Gll^Fmf
Wo, Wo, Wo, Wo, Wo, Wo, Wo, Wo, Wo, Wo, Wo, Wo, Wo, Wo, Wo, Wo, Wo, Wo, Wo, Wo, Wo, Wo, Wo, Wo, Wo, Wo, Wo, Ww, Ww, Ww, Ww, Ds, Gs, Gs^Es, Gs, Gs, Gs, Gll^Fmf, Gll^Fmf, Gs, Gll^Fmf, Gll^Fmf, Gs, Gll^Fmf, Hhd^Fmf, Hhd^Fmf, Gll^Fmf, Gs, Hhd^Fmf, Gll^Fmf, Gs, Gs, Gll^Fmf, Gs, Gll^Fmf, Gs, Gll^Fmf, Gll^Fmf, Hhd^Fmf, Hhd^Fmf, Hhd^Fmf, Gll^Fmf, Gll^Fmf, Gs, Gs, Gll^Fmf, Gs, Gs, Gll^Fmf, Gll^Fmf, Gll^Fmf, Gs
Wo, Wo, Wo, Wo, Wo, Wo, Wo, Wo, Wo, Wo, Wo, Wo, Wo, Wo, Wo, Wo, Wo, Wo, Wo, Wo, Wo, Wo, Wo, Wo, Wo, Wo, Wo, Ww, Ww, Ww, Ww, Ds, Gs, Gs, Gs, Gs, Gs, Gll^Fmf, Gll^Fmf, Gll^Fmf, Gs, Gll^Fmf, Gs, Gll^Fmf, Gd, Gll^Fmf, Gs, Hhd^Fmf, Hhd^Fmf, Hhd^Fmf, Hhd^Fmf, Gll^Fmf, Gll^Fmf, Gs, Gs, Gs, Hhd^Fmf, Hhd^Fmf, Hhd^Fmf, Hhd^Fmf, Hhd^Fmf, Hhd^Fmf, Gs, Gll^Fmf, Gll^Fmf, Gs, Gs, Gll^Fmf, Gll^Fmf, Gs, Gs, Gll^Fmf
Wo, Wo, Wo, Wo, Wo, Wo, Wo, Wo, Wo, Wo, Wo, Wo, Wo, Wo, Wo, Wo, Wo, Wo, Wo, Wo, Wo, Wo, Wo, Wo, Wo, Wo, Wo, Wo, Ww, Ww, Ww, Ds, Ds, Gs, Gs, Gs, Gs^Es, Gs, Gll^Fmf, Gs, Gll^Fmf, Gll^Fmf, Gll^Fmf, Gll^Fmf, Gll^Fmf, Gs, Gs, Hhd^Fmf, Hhd^Fmf, Gll^Fmf, Hhd^Fmf, Gs, Gll^Fmf, Gll^Fmf, Gll^Fmf, Hhd^Fmf, Hhd^Fmf, Hhd^Fmf, Hhd^Fmf, Hhd^Fmf, Hhd^Fmf, Hhd^Fmf, Gll^Fmf, Gs, Gll^Fmf, Gll^Fmf, Gll^Fmf, Gll^Fmf, Gll^Fmf, Gll^Fmf, Gll^Fmf, Gs
Wo, Wo, Wo, Wo, Wo, Wo, Wo, Wo, Wo, Wo, Wo, Wo, Wo, Wo, Wo, Wo, Wo, Wo, Wo, Wo, Wo, Wo, Wo, Wo, Wo, Wo, Wo, Wo, Ww, Ww, Ww, Ww, Ds, Gs, Gs, Gs, Gs, Gs, Gll^Fmf, Gll^Fmf, Gs, Gs, Gs, Gs, Gs, Gll^Fmf, Gll^Fmf, Gll^Fmf, Hhd^Fmf, Hhd^Fmf, Gd, Gll^Fmf, Gs, Gll^Fmf, Hhd^Fmf, Hhd^Fmf, Hhd^Fmf, Hhd^Fmf, Hhd^Fmf, Hhd^Fmf, Hhd^Fmf, Hhd^Fmf, Hhd^Fmf, Gs, Gs, Gll^Fmf, Gll^Fmf, Gs, Gs, Gs, Gll^Fmf, Gs
Wo, Wo, Wo, Wo, Wo, Wo, Wo, Wo, Wo, Wo, Wo, Wo, Wo, Wo, Wo, Wo, Wo, Wo, Wo, Wo, Wo, Wo, Wo, Wo, Wo, Wo, Wo, Wo, Wo, Ww, Ww, Ww, Gs, Ds, Gs, Gs, Gs, Gs, Gs, Gs, Gll^Fmf, Gs, Gll^Fmf, Gll^Fmf, Gs, Gs, Gs, Gll^Fmf, Gll^Fmf, Gll^Fmf, Gs, Gs, Gll^Fmf, Hhd^Fmf, Hhd^Fmf, Hhd^Fmf, Gs, Hhd^Fmf, Gs, Hhd^Fmf, Gll^Fmf, Hhd^Fmf, Hhd^Fmf, Hhd^Fmf, Gs, Gs, Gll^Fmf, Gll^Fmf, Gll^Fmf, Gll^Fmf, Gs, Gs
