Ms, Ms, Ms, Ms, Ms, Ms, Ms, Ms, Ms, Ms, Ms, Ms, Ms, Ms, Ms, Ms, Ms, Ms, Ms, Ms, Ms, Ms, Ms, Ms, Ms, Ms, Ms, Ms, Ms, Ms, Ms, Ms, Ms, Ms, Ms, Ms, Ms, Ms, Ms, Ms, Ms, Ms, Ms, Ms, Ms, Ms, Ms, Ms, Ms, Ms, Ms, Ms, Ms, Ms, Ms, Ms, Ms, Ms, Ms, Ms, Ms, Ms, Ms, Ms, Ms, Ms, Ms, Ms, Ms, Ms, Ms, Ms
Ms, Ms, Ms^Xm, Ms^Xm, Ms, Ms, Ms^Xm, Ms^Xm, Ms^Xm, Ms, Ms, Ms, Ms, Ms, Ms, Ms, Ms, Ms, Ms, Ms, Ms, Ms, Ms, Ms, Ms, Ms, Ms^Xm, Ms, Ms, Ms, Ms, Ms, Ms, Ms, Ms, Ms, Ms, Ms, Ms, Ms, Ms, Ms, Ms^Xm, Ms, Ms^Xm, Ms^Xm, Ms^Xm, Ms^Xm, Ms^Xm, Ms, Ms, Ms, Ms, Ms, Ms, Ms, Ms, Ms^Xm, Ms, Ms, Ms, Ms, Ms, Ms, Ms, Ms, Ms, Ms, Ms, Ms, Ms, Ms
Ms, Ms, Ms, Ms, Ms, Ms, Ms, Ms, Ms, Ms, Ms^Xm, Ms, Ms, Ms, Ms, Ms, Ms, Ms, Ms, Ms, Ms, Ms, Ms, Ms, Ms, Ms^Xm, Ms, Ms^Xm, Ms, Ms^Xm, Ms, Ms, Ms, Ms, Ms, Ms, Ms, Ms, Ms, Ms^Xm, Ms, Ms, Ms, Ms^Xm, Ms, Ms, Ms, Ms, Ms, Ms^Xm, Ms^Xm, Ms, Ms, Ms, Ms, Ms, Ms, Ms, Ms^Xm, Ms^Xm, Ms, Ms, Ms, Ms, Ms, Ms, Ms, Ms, Ms, Ms, Ms, Ms
Ms, Ms, Ms, Ms, Ms^Xm, Ms^Xm, Ms^Xm, Ms, Ms, Ms, Ms, Ms, Ms^Xm, Ms, Ms, Ms, Ms, Ms, Ms, Ms, Ms, Ms, Ms, Ms, Ms, Ms, Ms, Ms, Ms, Ms, Ms, Ms^Xm, Ms, Ms^Xm, Ms^Xm, Ms, Ms, Ms, Ms, Ms, Ms, Ms, Ms, Ms, Ms, Ms, Ms^Xm, Ms^Xm, Ms, Ms, Ms^Xm, Ms, Ms, Ms, Ms, Ms, Ms, Ms, Ms^Xm, Ms, Ms, Ms, Ms, Ms, Ms, Ms, Ms, Ms, Ms, Ms, Ms, Ms
Ms, Ms, Ms, Ms^Xm, Ms, Ms, Ms, Ms, Ms, Ms, Ms, Ms, Ms, Ms, Ms, Ms, Ms, Ms, Ms^Xm, Ms^Xm, Ms, Ms, Ms^Xm, Ms^Xm, Ms^Xm, Ms, Ms, Ms, Ms^Xm, Ms^Xm, Ms, Ms, Ms, Ms, Ms, Ms^Xm, Ms^Xm, Ms^Xm, Ms, Ms, Ms, Ms, Ms, Ms, Ms, Ms^Xm, Ms, Ms, Ms^Xm, Ms, Ms, Ms^Xm, Ms, Ms, Ms, Ms, Ms^Xm, Ms^Xm, Ms, Ms, Ms, Ms, Ms, Ms, Ms, Ms, Ms, Ms, Ms, Ms, Ms, Ms
Ms, Ms, Ms^Xm, Ms, Ms, Ms, Ms, Ms^Xm, Ms^Xm, Ms^Xm, Ms, Ms, Ms, Ms^Xm, Ms, Ms, Ms^Xm, Ms^Xm, Ms, Ms, Ms, Ms, Ms, Ms, Ms, Ms^Xm, Ms, Ms^Xm, Ms, Ms, Ms, Ms, Ms, Ms, Ms, Ms, Ms, Ms, Ms, Ms, Ms, Ms, Ms^Xm, Ms^Xm, Ms, Ms, Ms, Ms^Xm, Ms, Ms, Ms, Ms, Ms, Ms, Ms^Xm, Ms^Xm, Ms, Ms, Ms, Ms, Ms, Ms, Ms^Xm, Ms, Ms, Ms, Ms, Ms, Ms, Ms, Ms, Ms
Ms, Ms, Ms, Ms^Xm, Ms^Xm, Ms, Ms^Xm, Ms, Ms^Xm, Ms, Ms^Xm, Ms, Ms, Ms, Ms^Xm, Ms, Ms^Xm, Ms, Ms, Ms, Ms^Xm, Ms^Xm, Ms, Ms, Ms, Ms^Xm, Ms, Ms, Ms, Ms, Ms, Ms, Ms, Ms, Ms, Ms, Ms, Ms, Ms, Ms, Ms^Xm, Ms, Ms, Ms, Ms^Xm, Ms, Ms^Xm, Ms, Ms, Ms, Ms^Xm, Ms^Xm, Ms^Xm, Ms, Ms^Xm, Ms, Ms, Ms, Ms^Xm, Ms^Xm, Ms^Xm, Ms^Xm, Xu, Ms^Xm, Ms^Xm, Ms, Ms^Xm, Ms, Ms^Xm, Ms, Ms, Ms
Ms, Ms, Ms, Ms, Ms, Ms^Xm, Ms, Ms, Ms, Ms, Ms, Ms, Ms, Ms^Xm, Ms^Xm, Ms, Ms^Xm, Ms, Ms^Xm, Ms, Ms, Ms, Ms, Ms, Ms^Xm, Ms, Ms, Ms, Ms, Ms, Ms^Xm, Ms^Xm, Ms^Xm, Ms, Ms, Ms, Ms, Ms, Ms^Xm, Ms, Ms, Ms, Ms, Ms, Ms, Ms, Ms, Ms, Ms, Ms, Ms, Ms, Ms, Ms, Ms, Ms, Ms, Ms, Ms^Xm, Xu, Xu, Xu, Xu, Xu, Xu, Ms^Xm, Xu, Ms^Xm, Xu, Ms^Xm, Ms^Xm, Ms
Ms, Ms, Ms, Ms, Ms, Ms, Ms, Ms, Ms, Ms, Ms, Ms, Ms^Xm, Ms, Ms, Ms, Ms, Ms, Ms, Ms, Ms, Ms, Ms, Ms, Ms, Ms, Ms, Ms, Ms^Xm, Ms^Xm, Ms, Ms, Ms, Ms, Ms, Ms, Ms, Ms, Ms, Ms, Ms, Ms^Xm, Ms, Ms^Xm, Ms, Ms, Ms, Ms, Ms, Ms, Ms, Ms, Ms, Ms, Ms, Ms, Ms^Xm, Ms^Xm, Xu, Xu, Xu, Xu, Xu, Xu, Xu, Xu, Uh^Ii, Xu, Uh^Ii, Xu, Xu, Ms^Xm
Ms, Ms, Ms, Ms, Ms, Ms, Ms, Ms, Ms, Ms, Ms^Xm, Ms^Xm, Ms, Ms^Xm, Ms^Xm, Ms, Ms, Ms, Ms, Ms, Ms^Xm, Ms, Ms^Xm, Ms, Ms^Xm, Ms, Ms, Ms^Xm, Ms, Ms, Ms, Ms, Ms^Xm, Ms, Ms, Ms, Ms, Ms, Ms, Ms, Ms^Xm, Ms^Xm, Ms, Ms, Ms, Ms, Ms, Ms, Ms^Xm, Ms, Ms, Ms, Ms, Ms, Ms, Ms, Ms^Xm, Xu, Xu, Xu, Xu, Xu, Xu, Xu, Uu^Uf, Uh, Uu, Uh^Ii, Uu, Uu, Uu, Xu
Ms, Ms^Xm, Ms, Ms, Ms, Ms, Ms, Ms, Ms^Xm, Ms^Xm, Ms, Ms, Ms, Ms, Ms^Xm, Ms, Ms, Ms, Ms^Xm, Ms^Xm, Ms^Xm, Ms^Xm, Ms, Ms, Ms, Ms, Ms^Xm, Ms^Xm, Ms, Ms, Ms, Ms, Ms, Ms, Ms, Ms, Ms, Ms, Ms, Ms, Ms, Ms, Ms, Ms, Ms, Ms, Ms, Ms, Ms^Xm, Ms, Ms, Ms, Ms^Xm, Ms, Ms^Xm, Ms^Xm, Xu, Xu, Xu, Xu, Xu, Xu, Xu, Uu^Uf, Uu, Uu, Uu, Uu, Uh, Uu, Uu, Uu
Ms, Ms, Ms, Ms^Xm, Ms^Xm, Ms, Ms^Xm, Ms, Ms, Ms, Ms, Ms, Ms, Ms, Ms, Ms, Ms^Xm, Ms^Xm, Ms^Xm, Ms, Ms, Ms, Ms, Ms, Ms, Ms^Xm, Ms, Ms, Ms, Ms, Ha^Fpa, Ms, Ms, Ms, Ms, Ms, Ms, Ms, Ms, Ms, Ms, Ms, Ms, Ms, Ms, Ms, Ms, Ms, Ms, Ms, Ms, Ms, Ms^Xm, Ms^Xm, Xu, Xu, Uh, Xu, Chr, Xu, Xu, Xu, Xu, Uu^Uf, Uu, Uu, Uu, Uh, Uh, Uu, Ur, Ur
Ms, Ms, Ms, Ms, Ms, Ms, Ms, Ms, Ms, Ms, Ms, Ms, Ms, Ms, Ms, Ms^Xm, Ms, Ms^Xm, Ms, Ms, Ms, Ms, Ms, Ms, Ms, Ms, Ms, Ms, Ms, Ha^Fpa, Ai, Ha^Fpa, Ms^Xm, Ms, Ms, Ms, Ms, Ms, Ms, Ms, Ms, Ms, Ms, Ms, Ms, Ms, Ms, Ms, Ms, Ms, Ha^Fpa, Ms^Xm, Xu, Xu, Uu, Uu, Ur, Uh, Chr, Khr, Xu, Xu, Xu, Uh, Uu, Uu, Uu, Uu, Uu, Uu, Ur, Uu
Ms, Ms, Ms, Ms, Ms, Ms, Ms, Ms, Ms, Ms, Ms, Ms, Ms, Ms, Ms^Xm, Ms^Xm, Ms, Ms, Ms, Ms, Ms, Ms, Ms, Ms, Ha^Fpa, Ha^Fpa, Ha^Fpa, Ha^Fpa, Ai, Ai, Ai, Ms, Ms, Ms, Ms, Ms, Ms, Ms, Ms, Ms, Ms, Ms, Ms, Ms, Ha^Fpa, Ha^Fpa, Ha^Fpa, Ms, Ha^Fpa, Ha^Fpa, Aa, Xu, Aa, Uu, Ur, Ur, Ur, Ur, Ur, Chr, Xu, Xu, Xu, Uh, Uh, Uu, Ur, Ur, Ur, Ur, Uh, Xu
Ms, Ms, Ms, Ms, Ms, Ms, Ms, Ms, Ms^Xm, Ms, Ms, Ms, Ms, Ms, Ms, Ms^Xm, Ms, Ms, Ms, Ms, Ms, Ms, Ai, Ms, Ai, Ai, Ai, Ai, Ai, Ai, Ms, Ms^Xm, Ms, Ms, Ms, Ms, Ms^Xm, Ms, Ms, Ms, Ms, Ms, Ha^Fpa, Ha^Fpa, Aa^Fpa, Ha^Fpa, Aa^Fpa, Ha^Fpa, Aa, Ha^Fpa, Aa, Aa, Aa, Aa, Xu, Uh^Ii, Uh^Ii, Ur, Ur, Ur, Uh, Xu, Xu, Xu, Uh, Uu^Uf, Ur, Uu^Uf, Uu^Uf, Uu, Uh, Xu
Ms, Ms, Ms, Ms, Ms, Ms, Ms^Xm, Ms^Xm, Ms, Ms^Xm, Ms, Ms^Xm, Ms^Xm, Ms, Ms^Xm, Ms, Ms, Ms, Ms, Ms, Ha^Fpa, Ai, Ai, Ai, Ai, Ai, Ai, Ai, Ai, Ms, Ms, Ms, Ms, Ms^Xm, Ms, Ms, Ms, Ms, Ms, Ms, Ms, Ms, Ha^Fpa, Ha^Fpa, Aa^Fpa, Aa^Fpa, Aa, Aa, Rb, Rb, Aa, Rb, Ha^Fpa, Ha^Fpa, Ms^Xm, Xu, Uh, Uu, Ur, Ur, Uu^Uf, Xu, Xu, Xu, Uu^Uf, Uu^Uf, Ur, Uu^Uf, Uu, Uu, Qxua, Xu
Ms, Ms^Xm, Ms, Ms, Ms^Xm, Ms^Xm, Ms, Ms, Ms, Ms, Ms, Ms, Ms, Ms^Xm, Ms^Xm, Ms, Ms, Ms, Ms, Ha^Fpa, Ai, Ai, Ai, Ai, Ai, Ai, Ai, Ai, Ai, Ms, Ms, Ms, Ms, Ms, Ms, Ms, Ms, Ms, Ms, Ms, Ms, Ha^Fpa, Ha^Fpa, Aa^Fpa, Aa, Rb, Aa, Aa^Es, Aa, Aa, Ha^Fpa, Ha^Fpa, Ms, Ms, Ms^Xm, Xu, Uu, Uu, Ur, Ur, Uu^Uf, Xu, Xu, Xu, Uh, Uu, Uu, Ur, Uu, Uu, Qxua, Wog
Ms, Ms, Ms, Ms, Ms, Ms, Ms, Ms, Ms, Ms, Ms^Xm, Ms, Ms^Xm, Ms, Ms, Ms^Xm, Ms, Ms, Ms, Ha^Fpa, Ai, Ai, Ai, Ai, Ms, Ai, Ai, Ai, Ai, Ms, Ha^Fpa, Ms, Ms, Ms, Ha^Fpa, Ms, Ms, Ms, Ms, Ms, Ms, Ha^Fpa, Ha^Fpa, Aa, Aa^Es, Rb, Aa, Aa^Es, Ha^Vhha, Ha^Fpa, Ms, Ms, Ms^Xm, Ms, Ms^Xm, Xu, Uu, Ur, Ur, Ur, Uh, Xu, Xu, Xu, Xu, Uh, Uu, Ur, Uu, Uh, Xu, Wog
Ms, Ms, Ms, Ms, Ms, Ms, Ms, Ms, Ms^Xm, Ms^Xm, Ms, Ms, Ms, Ms^Xm, Ms^Xm, Ms^Xm, Ms^Xm, Ms, Ms, Ms, Ha^Fpa, Ai, Ms, Ms, Ms, Ms, Ha^Fpa, Ai, Ai, Ha^Fpa, Aa^Fpa, Ha^Fpa, Ha^Fpa, Ha^Fpa, Aa^Fpa, Ha^Fpa, Ms, Ms, Ms, Ms, Ms, Ha^Fpa, Ha^Fpa, Aa, Rb, Aa, Aa^Fpa, Aa^Fpa, Ha^Fpa, Ha^Fpa, Ms, Ms^Xm, Xu, Ms^Xm, Xu, Xu, Uu, Ur, Ur, Uh, Xu, Xu, Xu, Xu, Xu, Uh, Uu, Ur, Uu, Uh, Xu, Xu
Ms, Ms, Ms, Ms, Ms, Ms, Ms, Ms^Xm, Ms, Ms, Ms, Ms, Ms, Ms, Ms^Xm, Ms, Ms, Ms^Xm, Ms, Ms, Ms, Ha^Fpa, Ms^Xm, Ms, Ms, Ms, Ha^Fpa, Ai, Ai, Aa^Fpa, Aa, Aa^Fpa, Aa^Fpa, Aa^Fpa, Aa^Fpa, Ha^Fpa, Ha^Fpa, Ms, Ms, Ms, Ms, Ha^Fpa, Ha^Fpa, Aa, Aa, Aa, Aa^Fpa, Ha^Fpa, Ms, Ms, Ms^Xm, Ms^Xm, Xu, Xu, Uh, Uu^Ii, Uu, Ur, Ur, Uh, Qxua, Wog, Xu, Xu, Xu, Uu^Uf, Ur, Ur, Uh, Xu, Xu, Xu
Ms, Ms, Ms, Ms, Ms, Ms, Ms^Xm, Ms^Xm, Ms, Ms, Ms, Ms, Ms, Ms, Ms, Ms^Xm, Ms, Ms, Ms^Xm, Ms, Ms, Ms, Ms, Ms, Ms, Ha^Fpa, Ha^Fpa, Aa^Fpa, Aa, Ai, Aa, Aa, Aa, Aa^Fpa, Aa^Fpa, Ha^Fpa, Ha^Fpa, Ms, Ms, Ms, Ms, Ha^Fpa, Ha^Fpa, Aa, Aa, Rb, Aa, Ha^Fpa, Ms, Ms^Xm, Ms^Xm, Xu, Uh^Ii, Uh^Ii, Uu, Uu, Uh, Ur, Ur, Uu^Ufi, Qxua, Wog, Xu, Xu, Xu, Uu, Ur, Uu, Uh, Xu, Xu, Xu
Ms, Ms, Ms, Ms, Ms, Ms, Ms, Ms, Ms, Ms, Ms^Xm, Ms, Ms, Ms, Ms, Ms, Ms, Ms, Ms^Xm, Ms^Xm, Ms, Ms, Ms, Ms, Ha^Fpa, Ha^Fpa, Aa^Fpa, Aa^Fpa, Aa, Ai, Aa, Aa, Aa, Aa, Aa^Fpa, Aa^Fpa, Aa^Fpa, Ha^Fpa, Ms, Ms, Ms, Ha^Fpa, Ha^Fpa, Aa^Fpa, Aa, Aa, Aa, Ha^Fpa, Ha^Fpa, Ms, Ms^Xm, Xu, Xu, Uh, Uu, Uu, Uh, Ur, Uh, Uh, Xu, Xu, Xu, Xu, Uh, Uu, Uu, Ur, Uu, Uh, Xu, Xu
Ms, Ms, Ms, Ms, Ms^Xm, Ms^Xm, Ms, Ms, Ms^Xm, Ms^Xm, Ms, Ms, Ms, Ms, Ha^Fpa, Ms, Ms, Ms, Ms, Ms, Ms, Ms, Ms, Ha^Fpa, Ha^Fpa, Aa^Fpa, Aa^Fpa, Aa, Ai, Ai, Aa, Aa, Aa^Es, Aa, Aa, Aa^Fpa, Aa^Fpa, Ha^Fpa, Ms, Ms, Ha^Fpa, Ha^Fpa, Aa^Fpa, Aa^Fpa, Rb, Aa, Aa, Aa^Fpa, Ha^Fpa, Ms, Ms^Xm, Xu, Xu, Uh, Uu, Uu, Ur, Ur, Uh, Xu, Xu, Xu, Xu, Xu, Uh, Uu^Uf, Uu, Ur, Uu, Uu^Uf, Xu, Xu
Ms, Ms, Ms, Ms, Ms, Ms, Ms, Ms, Ms^Xm, Ms, Ms, Ms, Ha^Vhha, Ha^Fpa, Coa, Ha^Vhha, Ha^Fpa, Ms, Ms, Ms, Ms, Ms, Ms, Ha^Fpa, Ha^Fpa, Aa^Fpa, Aa, Aa, Ai, Aa, Aa, Aa, Aa, Rb, Aa, Aa^Fpa, Aa^Fpa, Ha^Fpa, Ha^Fpa, Ha^Fpa, Aa^Fpa, Aa^Es, Aa, Aa, Aa, Rb, Aa, Ha^Fpa, Ms, Ms, Ms, Ms^Xm, Xu, Uu, Uu, Ur, Ur, Ur, Uu^Uf, Xu, Xu, Xu, Wog, Qxua, Uu^Uf, Uu^Uf, Uu, Ur, Uu^Vu, Uu^Uf, Xu, Xu
Ms, Ms^Xm, Ms, Ms, Ms, Ms, Ms, Ms^Xm, Ms, Ms, Ms, Ms, Ha^Fpa, Coa, Koa, Coa, Ha^Fpa, Ha^Fpa, Ha^Fpa, Ms, Ha^Fpa, Ms, Ha^Fpa, Ha^Fpa, Aa^Fpa, Aa^Fpa, Ai, Ai, Aa^Fpa, Aa, Aa^Fpa, Aa, Aa, Rb, Aa, Aa^Es, Aa^Fpa, Ha^Fpa, Aa^Vla, Ha^Fpa, Aa^Fpa, Aa, Aa, Rb, Aa^Fpa, Aa, Ha^Fpa, Ha^Fpa, Ms, Ms, Ms^Xm, Ms^Xm, Xu, Uu^Ufi, Uu, Ur, Ur, Uu^Uf, Xu, Xu, Xu, Xu, Wog, Qxua, Uh, Uu, Ur, Ur, Uh, Uh, Xu, Xu
Ms, Ms, Ms, Ms, Ms, Ms, Ms^Xm, Ms^Xm, Ms, Ms, Ms, Ms, Ha^Fpa, Coa, Coa, Coa, Aa^Fpa, Aa^Fpa, Coa, Ha^Vhha, Ha^Fpa, Ha^Fpa, Aa^Fpa, Aa^Fpa, Ai, Ai, Aa^Fpa, Aa^Fpa, Ha^Fpa, Aa^Fpa, Ha^Fpa, Aa^Fpa, Aa^Fpa, Aa, Rb, Aa, Aa, Aa^Fpa, Aa^Fpa, Aa^Fpa, Rb, Aa, Aa, Aa^Fpa, Ha^Fpa, Ha^Fpa, Ms, Ms, Ms^Xm, Ms^Xm, Xu, Xu, Uh, Uu^Ufi, Ur, Ur, Uh, Uh, Xu, Xu, Xu, Xu, Xu, Xu, Uh, Uu, Ur, Uu, Uh, Xu, Xu, Xu
Ms, Ms, Ms, Ms, Ms, Ms^Xm, Ms^Xm, Ms, Ms, Ms, Ms, Ms, Ha^Fpa, Aa^Fpa, Aa, Rr, Rr, Aa, Aa, Aa, Aa, Aa^Fpa, Ai, Ai, Aa^Fpa, Aa^Fpa, Ha^Fpa, Ha^Fpa, Ms^Xm, Ha^Fpa, Ms, Ha^Fpa, Ha^Fpa, Aa^Fpa, Aa, Rb, Aa, Aa, Aa, Rb, Aa, Aa, Aa^Es, Aa^Fpa, Ha^Fpa, Ha^Fpa, Ms, Ms^Xm, Xu, Xu, Uh, Uh, Uu^Uf, Uu, Ur, Ur, Uh, Xu, Wog, Xu, Xu, Xu, Xu, Xu, Uu^Uf, Uu, Ur, Uu, Uh, Xu, Xu, Xu
Ms, Ms^Xm, Ms^Xm, Ms^Xm, Ms, Ms, Ms, Ms, Ms, Ms, Ha^Fpa, Ha^Vhha, Coa, Aa, Ai, Ai, Ai, Rr, Ai^Bsb\, Aa, Ai, Aa^Es, Ai, Aa^Fpa, Aa^Fpa, Ha^Fpa, Ms, Ms, Ms, Ms, Ms, Ha^Fpa, Aa^Fpa, Aa^Fpa, Aa, Aa, Aa, Aa, Aa, Aa, Aa^Fpa, Aa^Fpa, Ha^Fpa, Ha^Fpa, Ms, Ms, Ms^Xm, Ms^Xm, Xu, Xu, Uh, Uu^Uf, Uu^Uf, Uu, Ur, Ur, Ur, Xu, Qxua, Wog, Wog, Xu, Xu, Xu, Uh, Uu, Ur, Uu, Uu, Uh, Xu, Xu
Ms, Ms, Ms, Ms, Ms, Ms, Ms, Ms, Ms, Ha^Fpa, Aa^Fpa, Ha^Fpa, Aa, Aa, Ai, Ai, Aa^Fpa, Ai, Ai, Ai^Bsb\, Ai^Bsb\, Ai, Aa, Aa^Fpa, Ha^Fpa, Ha^Fpa, Ms, Ms, Ms, Ms, Ha^Fpa, Ha^Fpa, Aa^Fpa, Aa, Aa, Aa, Aa, Aa, Aa^Es, Aa^Fpa, Ha^Fpa, Aa^Fpa, Ha^Fpa, Ms, Ms, Ms^Xm, Xu, Xu, Xu, Xu, Uh^Ii, Uh, Uu^Uf, Uu, Uu^Ii, Ur, Ur, Ur, Ur, Xu, Xu, Xu, Xu, Xu, Xu, Uh, Uu, Ur, Uu, Uh, Uh, Xu
Ms, Ms, Ms, Ms, Ms, Ms, Ms, Ha^Fpa, Ha^Fpa, Ha^Fpa, Aa^Fpa, Aa, Ai, Ai, Ai, Coa, Ha^Fpa, Aa^Fpa, Aa^Fpa, Aa, Aa, Rr, Aa^Es, Aa^Fpa, Ha^Fpa, Ms, Ms^Xm, Ms, Ha^Fpa, Ha^Fpa, Aa^Fpa, Aa^Fpa, Aa, Aa, Aa, Aa, Aa, Aa, Ha^Fpa, Ha^Fpa, Ha^Fpa, Ha^Fpa, Ms, Ms, Ms^Xm, Ms^Xm, Xu, Xu, Xu, Xu, Xu, Uh^Ii, Uu, Uu, Uu, Uu, Uh^Ii, Ur, Ur, Uh, Xu, Xu, Xu, Xu, Xu, Uh, Uu, Ur, Uu, Uu^Uf, Uh, Xu
Ha^Fpa, Ha^Fpa, Ha^Fpa, Ms, Ms, Ms, Ha^Fpa, Ha^Fpa, Ha^Fpa, Aa^Fpa, Aa, Aa^Es, Ai, Ai, Ha^Fpa, Ha^Fpa, Ms, Ha^Fpa, Ha^Fpa, Aa^Fpa, Aa^Fpa, Rr, Rr, Aa, Ha^Fpa, Ms, Ms, Ms, Ha^Fpa, Aa^Fpa, Aa^Fpa, Aa, Aa, Aa, Aa, Aa, Ha^Fpa, Ha^Fpa, Ms, Ms, Ms, Ha^Fpa, Ms, Ms^Xm, Ms^Xm, Xu, Xu, Xu, Xu, Xu, Xu, Uh^Ii, Uu, Uu, Uu, Uh, Uh, Uu^Ufi, Uh, Ur, Uu^Vu, Xu, Xu, Xu, Xu, Uu, Uu, Ur, Uu, Uh, Xu, Xu
Aa^Fpa, Ha^Fpa, Ha^Fpa, Ha^Fpa, Ha^Fpa, Ha^Fpa, Ha^Fpa, Ha^Fpa, Aa^Fpa, Aa^Fpa, Aa, Ai, Ai, Aa, Ha^Fpa, Ms, Ms, Ms, Ms, Ha^Fpa, Ha^Fpa, Aa^Fpa, Rr, Aa, Ha^Fpa, Ms, Ms, Ms, Ha^Fpa, Aa^Fpa, Rr, Rr, Aa, Rr, Aa, Ha^Fpa, Ms, Ms, Ms, Ms, Ms, Ms, Ms^Xm, Ms^Xm, Ms^Xm, Xu, Xu, Xu, Ms^Xm, Xu, Ms^Xm, Xu, Xu, Uu, Uu^Vu, Uu, Uu^Ii, Uh, Uu, Ur, Ur, Uh, Uh, Xu, Xu, Uu^Ufi, Uu, Ur, Uu, Uh, Xu, Xu
Aa^Fpa, Aa^Fpa, Aa^Fpa, Ha^Fpa, Ha^Fpa, Aa^Fpa, Aa^Fpa, Aa^Fpa, Aa^Fpa, Aa, Ai, Ai, Ai, Aa, Ha^Fpa, Ms, Ms, Ms, Ms, Ms, Ha^Fpa, Aa^Fpa, Aa, Rr, Aa, Ha^Fpa, Ha^Fpa, Ha^Fpa, Rr, Rr, Aa, Aa, Aa, Rr, Aa, Ha^Fpa, Ms, Ms, Ms, Ms, Ms, Ms, Ms, Ms, Ms, Ms^Xm, Ms^Xm, Ms^Xm, Ms, Ms^Xm, Ms, Ms^Xm, Ms^Xm, Xu, Xu, Uu, Uu, Uu^Ii, Uu, Uh, Ur, Uh, Uu, Uu^Ufi, Uu^Vu, Uu^Ufi, Uu, Ur, Uu, Uu, Xu, Xu
Aa^Fpa, Aa^Fpa, Aa^Fpa, Aa^Fpa, Aa^Fpa, Aa^Fpa, Aa^Vla, Aa^Fpa, Aa, Aa, Ai, Ai, Aa^Vla, Aa, Aa^Fpa, Ha^Fpa, Ms, Ms, Ms, Ms, Ha^Fpa, Aa^Fpa, Aa, Aa^Es, Aa, Rr, Rr, Aa, Aa^Fpa, Aa, Aa^Fpa, Coa, Aa, Rr, Rr, Ha^Fpa, Ha^Vhha, Ms, Ms, Ms, Ms, Ms, Ha^Fpa, Ms, Ha^Fpa, Ms, Ms, Ms, Ha^Fpa, Ms, Ms, Ms, Ms, Ms^Xm, Xu, Uh, Uh, Uu^Ii, Uu, Uh, Uu, Ur, Ur, Uu, Uu, Uu, Ur, Ur, Uu, Uu, Xu, Xu
Aa^Fpa, Aa^Fpa, Aa^Fpa, Aa^Fpa, Aa^Fpa, Aa^Fpa, Aa^Fpa, Aa^Fpa, Aa^Es, Aa, Aa, Ai, Ai, Aa, Aa^Fpa, Ha^Fpa, Ha^Fpa, Ms, Ms, Ms, Ha^Fpa, Aa^Fpa, Aa^Vla, Aa, Aa^Fpa, Aa^Fpa, Aa^Fpa, Aa^Fpa, Ha^Vhha, Aa^Fpa, Aa^Fpa, Aa^Fpa, Coa, Aa, Aa, Rr, Aa, Ha^Fpa, Ha^Fpa, Ha^Fpa, Ha^Fpa, Ha^Fpa, Aa, Ha^Fpa, Aa, Ha^Fpa, Ha^Vhha, Ha^Fpa, Aa, Ha^Fpa, Ha^Fpa, Ha^Fpa, Ms, Ms^Xm, Ms^Xm, Xu, Uh, Uh, Uh, Uu, Uu, Uu, Uu, Ur, Uu^Uf, Co, Uu^Uf, Uu, Uu^Vu, Uu^Uf, Xu, Xu
Aa^Fpa, Aa^Fpa, Ha^Fpa, Aa^Fpa, Ha^Fpa, Ha^Fpa, Ha^Fpa, Aa^Fpa, Aa^Fpa, Aa^Es, Aa^Fpa, Ai, Ai, Ai, Aa^Es, Aa^Fpa, Ha^Fpa, Ms, Ms, Ms, Ms, Ha^Fpa, Aa^Fpa, Aa^Fpa, Ha^Fpa, Ha^Fpa, Ha^Fpa, Ha^Fpa, Ms, Ha^Fpa, Ha^Fpa, Coa, Koa, Coa, Aa, Aa^Es, Rr, Aa, Aa, Aa, Aa, Aa, Aa^Es, Aa, Aa, Aa, Aa, Aa, Aa, Aa, Aa, Ha^Fpa, Ms, Ms, Ms^Xm, Xu, Xu, Xu, Xu, Xu, Xu, Uu^Vu, Uu^Ufi, Co, Co, Co, Co, Co, Uu^Uf, Uu^Uf, Xu, Xu
Ha^Fpa, Ha^Fpa, Ha^Fpa, Ha^Fpa, Ha^Fpa, Ha^Fpa, Ms^Xm, Ha^Fpa, Ha^Fpa, Aa^Fpa, Aa^Fpa, Aa^Fpa, Ai, Ai, Aa, Aa^Fpa, Ha^Fpa, Ms, Ms, Ms, Ms, Ha^Fpa, Ha^Fpa, Ha^Fpa, Ms, Ms, Ms, Ms, Ms, Ms, Ha^Fpa, Coa, Coa, Coa, Aa, Aa, Aa^Fma, Rr, Rr, Aa, Rr, Aa, Aa, Rr, Rr, Aa, Aa, Aa, Aa, Aa, Aa, Ha^Fpa, Ms, Ms^Xm, Ms^Xm, Xu, Ms^Xm, Ms^Xm, Ms^Xm, Ms^Xm, Ms^Xm, Xu, Xu, Uu^Ufi, Co, Ko, Co, Uu^Uf, Xu, Xu, Xu, Xu
Ha^Fpa, Ha^Fpa, Ms, Ms, Ms^Xm, Ms^Xm, Ms^Xm, Ms, Ms, Ha^Fpa, Ha^Fpa, Aa^Fpa, Ai, Ai, Aa, Ha^Fpa, Ms, Ms, Ms, Ms, Ms^Xm, Ms, Ms, Ms, Ms^Xm, Ms, Ms^Xm, Ms^Xm, Ms, Ms, Ms, Ha^Fpa, Ha^Fpa, Aa^Fpa, Rr, Coa, Aa^Fma, Aa^Fma, Aa^Es, Aa, Aa, Rr, Aa, Aa, Aa^Es, Rr, Aa^Es, Aa^Fma, Aa^Fma, Aa, Aa, Ha^Fpa, Ms, Ms^Xm, Ms^Xm, Ms^Xm, Ms, Ms^Xm, Ms, Ms, Ms, Ms^Xm, Xu, Uu^Ufi, Xu, Co, Xu, Xu, Xu, Xu, Xu, Xu
Ms, Ms, Ms^Xm, Ms^Xm, Ms, Ms, Ms, Ms^Xm, Ms, Ms, Ha^Fpa, Aa^Fpa, Ai, Ai, Ha^Fpa, Ha^Fpa, Ms, Ms, Ms, Ms, Ms, Ms^Xm, Ms^Xm, Ms, Ms, Ms, Ms, Ms, Ms, Ms, Ms, Ms, Ha^Fpa, Coa, Aa, Rr, Rr, Rr, Aa, Aa, Aa^Fma, Aa^Fma, Aa^Fma, Aa, Aa, Aa, Rr, Aa^Fma, Aa, Aa, Aa, Ha^Fpa, Ms, Ms, Ms, Ms, Ha^Fpa, Ms, Ha^Fpa, Ha^Fpa, Ms, Ms^Xm, Ms^Xm, Xu, Xu, Xu, Xu, Xu, Xu, Xu, Xu, Xu
Ms, Ms, Ms, Ms, Ms^Xm, Ms, Ms, Ms, Ms, Ms, Ha^Fpa, Aa^Fpa, Ai, Ai, Ha^Fpa, Ms, Ms, Ms, Ms, Ms, Ms^Xm, Ms, Ms^Xm, Ms^Xm, Ms, Ms, Ms, Ms, Ha^Fpa, Ha^Fpa, Ha^Fpa, Ha^Vhha, Aa, Aa, Aa, Aa^Fma, Rr, Rr, Aa^Fma, Aa^Fma, Ha^Fpa, Ha^Fpa, Ha^Fpa, Aa^Fma, Aa^Fma, Aa, Aa, Rr, Rr, Aa^Es, Aa, Ha^Fpa, Ha^Fpa, Ms, Ha^Fpa, Ha^Fpa, Aa^Fpa, Ha^Fpa, Ha^Fpa, Ha^Fpa, Ms, Ms, Ms^Xm, Xu, Xu, Xu, Xu, Xu, Xu, Xu, Ms^Xm, Ms^Xm
Ms, Ms, Ms, Ms, Ms, Ms, Ha^Fpa, Ms, Ha^Fpa, Ms, Ha^Vhha, Aa^Fpa, Ai, Ai, Aa^Fpa, Ha^Fpa, Ms, Ms, Ms, Ms, Ms, Ms^Xm, Ms, Ms, Ms, Ms, Ha^Fpa, Ha^Fpa, Aa^Fpa, Aa^Fpa, Aa^Fpa, Aa, Aa, Aa, Aa, Rr, Aa, Aa, Aa^Fma, Aa^Fma, Ha^Fpa, Ms, Ms, Ha^Fpa, Ha^Fpa, Aa^Fma, Aa^Fma, Aa, Aa, Aa, Aa, Aa, Aa^Fpa, Ha^Fpa, Aa^Fpa, Aa^Fpa, Aa^Fpa, Ha^Fpa, Ms, Ms, Ms, Ms, Ms, Ms^Xm, Ms^Xm, Ms^Xm, Ms^Xm, Ms^Xm, Ms^Xm, Ms^Xm, Ms, Ms^Xm
Ms, Ms, Ms, Ms, Ha^Fpa, Ha^Fpa, Ha^Fpa, Ha^Fpa, Ha^Fpa, Ha^Fpa, Aa^Fpa, Aa^Fpa, Ai, Ai, Aa^Fpa, Ha^Fpa, Ms, Ms, Ms, Ms, Ms^Xm, Ms, Ms, Ms, Ha^Fpa, Ha^Fpa, Ha^Fpa, Aa^Fpa, Aa, Aa^Fpa, Aa, Aa, Rr, Rr, Aa, Aa, Aa^Fma, Aa^Fma, Ha^Fpa, Ha^Fpa, Ms, Ms, Ms, Ms, Ha^Fpa, Aa^Fma, Aa^Fma, Aa, Rr, Aa^Es, Aa, Aa, Aa, Aa^Fpa, Aa, Aa^Fpa, Ha^Fpa, Ha^Fpa, Ms, Ms, Ms, Ms, Ms, Ms, Ms, Ms, Ms, Ms^Xm, Ms^Xm, Ms, Ms, Ms
Ms, Ms, Ha^Fpa, Ha^Fpa, Ha^Fpa, Ha^Fpa, Aa^Fpa, Ha^Fpa, Aa^Fpa, Aa^Fpa, Aa, Aa, Ai, Ai, Aa^Fpa, Ha^Fpa, Ms, Ms, Ms, Ms^Xm, Ms, Ms, Ms, Ha^Fpa, Aa^Fpa, Aa^Fpa, Aa^Fpa, Aa^Fpa, Aa, Aa, Rr, Aa, Aa, Aa, Aa, Aa, Aa^Fma, Ha^Fpa, Ms, Ms, Ms, Ms, Ms, Ms, Ha^Fpa, Ha^Fpa, Aa^Fma, Rr, Aa, Aa, Aa, Aa, Aa, Aa, Aa, Aa^Fpa, Ha^Fpa, Ms, Ms, Ms, Ms, Ms, Ms, Ms, Ms, Ms, Ms, Ms, Ms, Ms, Ms, Ms
Ms, Ms, Ha^Fpa, Ha^Fpa, Ha^Fpa, Aa^Fpa, Aa^Fpa, Aa^Fpa, Aa, Aa, Aa, Ai, Ai, Ai, Aa^Fpa, Ha^Fpa, Ha^Fpa, Ms, Ms, Ms, Ms, Ha^Fpa, Ha^Fpa, Ha^Fpa, Aa^Fpa, Aa^Fpa, Aa, Aa, Rr, Rr, Aa, Aa, Aa^Fma, Aa^Fma, Aa^Fma, Aa^Fma, Ha^Fpa, Ha^Fpa, Ha^Fpa, Ms, Ms, Ms, Ha^Fpa, Ms, Ha^Fpa, Ha^Fpa, Aa, Aa, Aa^Vla, Aa, Aa, Aa, Aa^Fpa, Aa^Fpa, Ha^Fpa, Ha^Fpa, Ms, Ms, Ms, Ms, Ms^Xm, Ms, Ms^Xm, Ms, Ms^Xm, Ms, Ms, Ms, Ms, Ms, Ms, Ms
Ms, Ms, Ha^Fpa, Ha^Fpa, Aa^Fpa, Aa^Fpa, Aa, Aa, Aa, Aa^Es, Aa, Ai, Ai, Aa, Aa^Fpa, Aa^Fpa, Ha^Fpa, Ms, Ms, Ms, Ms, Ha^Fpa, Ha^Fpa, Aa^Fpa, Aa^Fpa, Aa, Rr, Rr, Aa^Fpa, Aa, Aa, Aa, Aa^Fma, Aa^Fma, Ha^Fpa, Ha^Fpa, Ms, Ha^Fpa, Ms, Ms, Ha^Fpa, Ha^Fpa, Ha^Fpa, Ha^Fpa, Aa, Aa, Rr, Rr, Aa^Es, Aa, Aa, Aa, Aa^Fpa, Ha^Fpa, Ms, Ms, Ms, Ms, Ms^Xm, Ms, Ms, Ms^Xm, Ms, Ms^Xm, Ms, Ms, Ms^Xm, Ms, Ms^Xm, Ms^Xm, Ms^Xm, Ms
Ms, Ms, Ha^Fpa, Ha^Fpa, Aa^Fpa, Aa, Aa, Aa, Aa, Aa, Aa, Ai, Ai, Aa^Es, Aa, Aa^Fpa, Ha^Fpa, Ms, Ms, Ms, Ha^Fpa, Ha^Fpa, Aa^Fpa, Aa^Fpa, Aa, Rr, Aa, Aa, Aa^Es, Rr, Rr, Aa^Fma, Aa^Fma, Ha^Fpa, Ms, Ms, Ms, Ms, Ms, Ha^Fpa, Ha^Fpa, Ha^Fpa, Aa, Aa, Aa, Aa^Es, Rr, Aa, Aa, Aa, Aa, Aa, Ha^Fpa, Ha^Fpa, Ms, Ms, Ms, Ms, Ms, Ms, Ms, Ms, Ms, Ms, Ms, Ms, Ms, Ms^Xm, Ms, Ms^Xm, Ms^Xm, Ms
Ha^Fpa, Ha^Fpa, Ha^Fpa, Aa^Fpa, Aa^Fpa, Aa, Aa^Es, Aa, Aa^Vla, Aa, Aa, Ai, Ai, Aa, Aa, Aa^Fpa, Ha^Vhha, Ms, Ha^Fpa, Ms, Ha^Fpa, Aa^Fpa, Aa, Rr, Ai, Ai, Ai, Aa, Aa^Es, Aa, Rr, Aa, Aa^Fma, Ha^Fpa, Ms, Ms, Ms, Ms, Ha^Fpa, Ha^Fpa, Aa, Aa, Aa, Aa, Ai, Ai, Ai^Bsb|, Ai, Ai, Aa, Ha^Fpa, Ha^Fpa, Ms, Ms, Ms, Ms, Ms, Ms, Ms, Ms, Ms, Ms, Ms, Ms, Ms, Ms^Xm, Ms, Ms, Ms, Ms, Ms^Xm, Ms
Ha^Fpa, Ha^Fpa, Ha^Fpa, Aa^Fpa, Aa^Fpa, Aa, Aa, Aa, Aa, Aa, Aa^Fpa, Ai, Ai, Aa^Fpa, Aa^Es, Aa, Aa, Ha^Fpa, Aa^Fpa, Ha^Fpa, Rr, Aa, Ai, Ai, Ai, Ai, Ai, Ai, Ai, Aa^Fpa, Aa^Fpa, Rr, Ha^Fpa, Ha^Fpa, Ms, Ms, Ms, Ms, Ha^Fpa, Ha^Fpa, Aa, Aa, Ai, Ai, Ai, Ai, Ai^Bsb|, Ai, Ai, Ai, Ai, Ms, Aa^Fpa, Ms, Ms, Ms, Ha^Fpa, Ha^Fpa, Ha^Fpa, Ha^Fpa, Ha^Fpa, Ms, Ms, Ms, Ms, Ms, Ms, Ms, Ms, Ms, Ms, Ms
Ha^Fpa, Ha^Fpa, Aa^Fpa, Aa^Fpa, Aa^Fpa, Aa, Aa^Es, Aa, Aa, Aa^Fpa, Aa^Fpa, Aa^Fpa, Ai, Ai, Ai, Aa^Fpa, Aa^Fpa, Aa, Aa^Es, Rr, Ai, Ai, Ai, Ai, Aa, Aa, Aa, Ai, Ai, Ai, Aa^Fpa, Aa, Ha^Fpa, Ms, Ms, Ms, Ha^Fpa, Ha^Fpa, Aa, Aa, Ai, Ai, Ai, Ai, Aa, Aa^Es, Rr, Aa, Ha^Fpa, Ha^Fpa, Ms, Ai, Ai, Aa^Fpa, Ms, Ha^Fpa, Ha^Fpa, Ha^Fpa, Aa^Fpa, Ha^Fpa, Ha^Fpa, Ha^Fpa, Ha^Fpa, Ha^Fpa, Ha^Fpa, Ms, Ha^Fpa, Ms, Ms, Ms, Ms, Ms
Ha^Fpa, Ha^Fpa, Ha^Fpa, Aa^Fpa, Aa^Fpa, Aa, Aa, Aa, Aa, Aa^Fpa, Aa^Fpa, Aa^Fpa, Aa^Fpa, Ai, Ai, Ai, Ai, Ai, Ai, Ai^Bsb|, Ai, Ai, Aa^Fpa, Aa, Aa^Fpa, Aa^Fpa, Aa^Fpa, Aa, Ai, Ai, Aa, Rr, Ha^Fpa, Ms, Ms, Ha^Fpa, Ha^Fpa, Ha^Fpa, Ai, Ai, Ai, Ai, Ha^Vhha, Aa, Aa, Aa, Rr, Aa, Ha^Fpa, Ms, Ms, Ms, Ms, Ai, Ai, Ha^Fpa, Ha^Fpa, Aa^Fpa, Aa^Fpa, Aa^Fpa, Aa^Fpa, Ha^Fpa, Aa^Fpa, Ha^Fpa, Ha^Fpa, Ha^Fpa, Ha^Fpa, Ha^Fpa, Ha^Fpa, Ms, Ms, Ms
Ha^Fpa, Ha^Fpa, Ha^Fpa, Aa^Fpa, Aa^Fpa, Aa^Fpa, Aa, Aa, Aa, Aa^Fpa, Ai, Ai, Ai, Ai, Ai, Ai, Ai, Ai, Ai, Ai^Bsb|, Aa, Aa^Fpa, Ha, Ha, Ha, Ha, Ha, Aa^Fpa, Ai, Ai, Aa, Rr, Ha^Fpa, Ms, Ha^Fpa, Ha^Fpa, Ai, Ai, Ai, Ai, Ha^Fpa, Ha^Fpa, Ha^Fpa, Aa, Aa, Aa, Aa, Aa, Ha^Fpa, Ms, Ms, Ms, Ms, Ms, Ha^Fpa, Ai, Ai, Aa^Fpa, Aa^Fpa, Aa^Fpa, Aa, Aa^Fpa, Aa, Aa^Fpa, Aa^Fpa, Ha^Fpa, Aa^Vla, Ha^Fpa, Ha^Fpa, Ms, Ms, Ms
Ms, Ha^Fpa, Ha^Fpa, Ha^Fpa, Ha^Fpa, Aa^Fpa, Aa, Aa, Aa, Ai, Ai, Ai, Ai, Ai, Aa^Es, Aa^Fpa, Aa^Fpa, Aa^Fpa, Aa, Rr, Aa, Aa^Fpa, Ha, Ha^Fpa, Ha^Fpa, Ha^Fpa, Ha, Aa^Fpa, Ai, Ai, Aa, Aa, Aa, Ha^Fpa, Ai, Ai, Ai, Ai, Aa, Ha^Fpa, Ms, Ms, Ms, Ha^Fpa, Aa, Aa, Rr, Aa, Aa, Ha^Fpa, Ms, Ms, Ms, Ms, Ha^Fpa, Aa^Fpa, Ai, Ai, Ai, Aa, Aa, Aa, Aa, Aa, Aa, Aa^Fpa, Aa^Fpa, Aa^Fpa, Aa^Fpa, Ha^Fpa, Ha^Fpa, Ms
Ms, Ms^Xm, Ms, Ha^Fpa, Ha^Fpa, Aa^Fpa, Aa, Aa, Aa^Es, Ai, Ai, Aa^Fpa, Aa^Fpa, Aa^Fpa, Aa, Aa, Aa, Aa, Aa^Fpa, Aa, Rr, Aa, Ha, Ha^Fpa, Ha^Fpa, Ha^Fpa, Ha, Aa, Ai, Ai, Ai, Rr, Ai, Ai, Ai, Ai, Aa, Aa, Ha^Fpa, Ha^Fpa, Ms, Ms^Xm, Ms, Ha^Fpa, Ha^Fpa, Aa, Aa^Es, Aa, Aa, Ha^Fpa, Ha^Fpa, Ms, Ha^Fpa, Ha^Fpa, Aa, Aa^Fpa, Aa^Fpa, Ai, Ai, Aa, Aa, Rrc^Vhca, Aa, Aa, Coa, Aa, Aa, Aa^Fpa, Aa^Fpa, Aa^Fpa, Aa^Fpa, Ha^Fpa
Ms, Ms^Xm, Ms, Ha^Fpa, Ha^Fpa, Aa^Fpa, Aa^Fpa, Aa, Ai, Ai, Ai, Aa^Fpa, Ha^Fpa, Aa^Fpa, Ha^Fpa, Aa, Aa, Aa, Aa^Fpa, Aa^Fpa, Rr, Aa, Aa^Fpa, Ha, Ha, Ha, Aa, Aa, Aa, Ai, Ai, Ai^Bsb|, Ai, Ai, Aa^Es, Aa, Aa, Aa, Ha^Fpa, Ms, Ms, Ms, Ms, Ha^Fpa, Aa, Aa, Rr, Rr, Aa^Fpa, Aa, Rr, Ha^Fpa, Aa, Aa, Rr, Aa, Rr, Ai, Ai, Aa, Aa, Aa, Coa, Rr, Coa, Rr, Coa, Aa, Aa, Aa^Fpa, Aa^Fpa, Aa^Fpa
Ms, Ms, Ha^Fpa, Ha^Fpa, Ha^Fpa, Aa^Fpa, Aa^Fpa, Ai, Ai, Ai, Ha^Fpa, Ha^Fpa, Ms, Ha^Fpa, Ms, Ha^Fpa, Aa, Aa, Aa, Aa^Es, Rr, Aa, Aa, Aa^Fpa, Aa^Fpa, Aa^Fpa, Aa, Aa, Aa, Aa, Aa, Ai^Bsb|, Aa, Aa, Aa, Aa, Aa, Ha^Fpa, Ms, Ms, Ms, Ms, Ha^Fpa, Ha^Fpa, Aa, Aa, Rr, Aa^Fpa, Aa^Fpa, Rr, Aa, Rr, Aa, Rr, Aa, Rr, Ai, Ai^Bsb\, Ai^Bsb\, Coa, Rr, Rr, Rr, Coa, 2 Koa, Coa, Rr, Aa, Rr, Aa, Rr, Aa
Ms, Ha^Fpa, Ha^Fpa, Ha^Fpa, Ha^Fpa, Aa^Fpa, Aa^Fpa, Ai, Ai, Aa^Vla, Ha^Fpa, Ms, Ms, Ms, Ms^Xm, Ha^Fpa, Ha^Fpa, Aa, Aa, Aa^Es, Aa^Es, Rr, Rr, Aa, Aa, Aa, Rr, Aa^Es, Rr, Aa, Rr, Rr, Rr, Aa, Aa, Aa^Es, Aa, Ha^Fpa, Ha^Fpa, Ms, Ms, Ms, Ha^Fpa, Aa, Rr, Rr, Aa, Aa, Aa, Aa^Fpa, Ha, Aa^Fpa, Ha, Aa, Aa, Aa, Ai, Ai, Coa, Rr, Aa, Aa, Coa, Coa, Coa, Coa, Coa, Rr, Aa, Rr, Aa, Rr
Ms, Ha^Fpa, Ms^Xm, Ha^Fpa, Ha^Fpa, Ha^Fpa, Aa^Fpa, Ai, Ai, Ai, Aa, Ha^Fpa, Ha^Fpa, Ms, Ms, Ms, Ha^Fpa, Aa, Aa, Aa, Aa, Aa, Aa, Rr, Aa, Rr, Aa, Rr, Aa, Aa, Aa^Vla, Aa, Aa, Rr, Rr, Aa, Rr, Ha^Fpa, Ha^Fpa, Ha^Fpa, Ha^Fpa, Ha^Fpa, Aa, Aa, Aa, Aa^Fpa, Aa^Fpa, Aa, Aa^Es, Aa^Fpa, Ha, Ha^Fpa, Ha^Fpa, Ha, Aa, Aa, Ai, Ai, Aa, Aa, Rr, Rr, Aa, Rr, Coa, Rr, Rr, Aa, Aa, Aa, Aa^Fpa, Aa^Fpa
Ms, Ms, Ms, Ms, Ha^Fpa, Ha^Fpa, Aa^Fpa, Aa^Fpa, Ai, Ai, Aa, Ha^Fpa, Ms, Ms^Xm, Ms, Ha^Fpa, Aa, Aa, Aa^Fpa, Aa, Aa^Fpa, Aa^Vla, Aa^Fpa, Aa, Aa, Aa^Es, Aa, Aa, Aa, Aa, Aa, Aa, Aa, Aa, Aa, Aa, Aa, Rr, Rr, Aa, Aa, Aa, Rr, Rr, Aa, Aa^Vla, Aa^Fpa, Aa, Aa, Aa^Fpa, Aa^Fpa, Ha^Fpa, Ha, Aa^Fpa, Aa, Aa, Ai, Ai, Aa, Aa, Rr, Aa, Aa, Aa, Aa, Aa, Aa, Rr, Rrc^Vhca, Aa^Fpa, Ha^Fpa, Ha^Fpa
Ms, Ms^Xm, Ms, Ms, Ms, Ha^Fpa, Ha^Fpa, Aa^Fpa, Ai, Ai, Aa^Fpa, Ha^Fpa, Ms, Ms^Xm, Ms, Ha^Fpa, Aa^Fpa, Aa, Aa^Fpa, Aa^Fpa, Aa^Fpa, Aa^Fpa, Aa^Fpa, Aa, Aa, Aa, Aa, Aa, Aa, Aa, Aa, Aa, Aa^Fpa, Aa^Fpa, Aa^Fpa, Aa^Fpa, Aa^Fpa, Aa, Aa, Aa, Rr, Rr, Aa, Aa^Es, Aa, Aa^Es, Aa^Fpa, Aa, Aa, Aa, Aa, Aa^Fpa, Aa, Aa, Aa, Ai, Ai, Ai, Aa, Aa, Rrc^Vhca, Aa^Fpa, Aa^Fpa, Aa^Fpa, Aa^Fpa, Rrc^Vhca, Aa, Rr, Aa^Fpa, Aa^Fpa, Ha^Fpa, Ms
Ms, Ms^Xm, Ms^Xm, Ms^Xm, Ms, Ha^Fpa, Ha^Fpa, Ha^Fpa, Ai, Ai, Aa^Fpa, Ha^Fpa, Ha^Fpa, Ms, Ha^Fpa, Ha^Fpa, Aa^Fpa, Aa^Vaa, Ha^Fpa, Aa^Fpa, Ha^Fpa, Ha^Fpa, Ha^Fpa, Aa, Aa^Fpa, Aa^Fpa, Aa^Fpa, Aa^Fpa, Aa^Fpa, Aa^Fpa, Aa^Fpa, Aa^Fpa, Aa^Fpa, Aa^Fpa, Aa^Fpa, Aa^Fpa, Ha^Fpa, Aa^Fpa, Aa, Aa^Es, Aa, Aa, Aa, Aa, Aa, Aa^Fpa, Aa, Aa^Es, Aa, Aa, Aa, Aa, Aa, Aa, Aa, Ai, Ai, Aa, Aa, Aa^Fpa, Aa^Fpa, Aa^Fpa, Aa^Fpa, Ha^Fpa, Ha^Fpa, Aa^Fpa, Aa^Fpa, Aa^Fpa, Ha^Fpa, Ha^Fpa, Ha^Fpa, Ms
Ms, Ms, Ms, Ms, Ms, Ms, Ha^Fpa, Ha^Vhha, Ai, Ai, Aa^Fpa, Aa^Fpa, Aa^Fpa, Ha^Fpa, Aa^Fpa, Aa^Fpa, Aa^Fpa, Ha^Fpa, Ms^Xm, Ha^Fpa, Ms, Ms, Ms, Ha^Fpa, Ha^Fpa, Ha^Fpa, Aa^Fpa, Aa^Fpa, Aa^Fpa, Aa^Fpa, Aa^Fpa, Aa^Fpa, Ha^Fpa, Ha^Fpa, Ha^Fpa, Ha^Fpa, Ha^Fpa, Aa^Fpa, Aa^Fpa, Aa^Fpa, Ha^Fpa, Aa, Aa, Aa, Aa, Aa, Aa, Aa, Aa^Fpa, Aa, Aa^Fpa, Aa, Aa, Aa, Aa, Ai, Ai, Ai, Aa^Fpa, Aa^Fpa, Ha^Fpa, Ha^Fpa, Ha^Fpa, Ha^Fpa, Ha^Fpa, Ha^Fpa, Ha^Fpa, Ha^Fpa, Ha^Fpa, Ha^Fpa, Ms, Ms
Ms, Ms, Ms, Ms, Ms, Ms, Ms, Aa^Fpa, Ai, Ai, Ha^Fpa, Ha^Fpa, Ha^Fpa, Aa^Fpa, Cea, 1 Cea, Cea, Ha^Fpa, Xu, Ms^Xm, Ms, Ms, Ms^Xm, Ms, Ms, Ha^Fpa, Ha^Fpa, Ha^Fpa, Ha^Fpa, Ha^Fpa, Ha^Fpa, Aa^Fpa, Ha^Fpa, Ha^Fpa, Ms, Ms, Ms, Ha^Fpa, Ha^Fpa, Ha^Fpa, Ms, Ha^Fpa, Ha^Fpa, Aa^Fpa, Aa^Fpa, Aa, Aa^Fpa, Aa^Fpa, Aa^Fpa, Aa^Fpa, Ha^Fpa, Aa^Fpa, Aa^Fpa, Aa^Vla, Aa^Fpa, Aa^Fpa, Aa^Fpa, Ai, Ai, Aa^Fpa, Ha^Fpa, Ha^Fpa, Ms, Ms, Ms, Ha^Fpa, Ha^Fpa, Ha^Fpa, Ms, Ms, Ms, Ms
Ms, Ms, Ms, Ms^Xm, Ms, Ms, Ai, Ai, Ha^Fpa, Ha^Fpa, Ms, Ha^Fpa, Ms^Xm, Xu, Ce, Kea, Ce, Uu, Xu, Ms^Xm, Ms, Ms, Ms, Ms, Ms, Ms, Ha^Fpa, Ha^Fpa, Ha^Fpa, Ha^Fpa, Ha^Fpa, Ha^Fpa, Ha^Fpa, Ms, Ms, Ms, Ms, Ha^Fpa, Ms^Xm, Ms, Ms, Ms, Ha^Fpa, Aa^Fpa, Aa^Fpa, Aa^Fpa, Aa^Fpa, Aa^Fpa, Ha^Fpa, Ha^Fpa, Ha^Fpa, Ha^Fpa, Ha^Fpa, Aa^Fpa, Ha^Fpa, Ha^Fpa, Ha^Fpa, Ai, Ai, Ha^Fpa, Ms, Ms, Ms, Ms, Ms, Ms, Ms, Ms, Ms, Ms, Ms, Ms
Ms, Ms^Xm, Ms, Ms, Ms^Xm, Ai, Ms, Ms, Ms, Ms, Ms^Xm, Ms, Ms^Xm, Xu, Xu, Ce, Uu, Uu, Xu, Ms^Xm, Ms^Xm, Ms, Ms, Ms, Ms, Ms^Xm, Ms, Ha^Fpa, Ha^Fpa, Ha^Fpa, Ha^Fpa, Ha^Fpa, Ha^Fpa, Ha^Fpa, Ms, Ms, Ms, Ms, Ms^Xm, Ms, Ms, Ms, Ha^Fpa, Aa^Fpa, Ha^Fpa, Aa^Fpa, Ha^Fpa, Ha^Fpa, Ms, Ms, Ms, Ms, Ms, Ha^Fpa, Ms^Xm, Ms, Ms, Ha^Fpa, Ai, Ms, Ms, Ms, Ms, Ms, Ms, Ms, Ms^Xm, Ms^Xm, Ms^Xm, Ms^Xm, Ms^Xm, Ms
Ms, Ms, Ms, Ms, Ms, Ms, Ms, Ms, Ms^Xm, Ms, Ms, Ms, Ms, Ms^Xm, Xu, Uu, Uu, Uu^Vu, Uu, Xu, Ms^Xm, Ms, Ms, Ms^Xm, Ms^Xm, Ms, Ms^Xm, Ha^Fpa, Ha^Fpa, Ha^Fpa, Ha^Fpa, Ha^Fpa, Ms, Ms, Ms, Ms^Xm, Ms, Ms, Ms^Xm, Ms, Ms, Ms, Ha^Fpa, Ha^Fpa, Ha^Fpa, Ha^Fpa, Ha^Fpa, Ms, Ms, Ms, Ms, Ms, Ms, Ms, Ms, Ms, Ms^Xm, Ms, Ms, Ai, Ms, Ms, Ms, Ms, Ms^Xm, Ms^Xm, Ms^Xm, Ms, Ms^Xm, Ms, Ms, Ms
Ms, Ms^Xm, Ms, Ms, Ms, Ms^Xm, Ms, Ms, Ms, Ms, Ms, Ms, Ms^Xm, Ms^Xm, Xu, Uu^Vu, Uu, Uu, Uu, Xu, Ms^Xm, Ms, Ms, Ms, Ms^Xm, Ms, Ms, Ms, Ms, Ms, Ms^Xm, Ms, Ms, Ms, Ms, Ms, Ms, Ms, Ms, Ms, Ms, Ms, Ha^Fpa, Ha^Fpa, Ha^Fpa, Ha^Fpa, Ha^Fpa, Ms, Ms, Ms, Ms, Ms^Xm, Ms, Ms, Ms, Ms, Ms, Ms, Ai, Ai, Ms, Ms, Ms, Ms, Ms, Ms, Ms, Ms^Xm, Ms, Ms, Ms^Xm, Ms
Ms, Ms, Ms, Ms, Ms, Ms, Ms, Ms, Ms, Ms, Ms, Ms^Xm, Xu, Xu, Uu, Uu, Uu, Uu, Uu, Xu, Ms, Ms^Xm, Ms, Ms^Xm, Ms, Ms, Ms, Ms, Gg, Ms, Ms, Ms, Gg, Ms, Gg, Ms, Gg, Ms, Ms, Ms, Ms, Ms, Ms, Ha^Fpa, Ha^Fpa, Ha^Fpa, Ha^Fpa, Ms, Gg, Ms, Gg, Ms, Ms, Ms, Gg, Ms, Ms, Ms, Ai, Ai, Ms, Ms, Ms, Ms^Xm, Ms^Xm, Ms, Ms, Ms, Ms, Ms, Ms, Ms^Xm
