border_size=1
usage=map

Ww, Ww, Ww, Ss, Ss, Ss, Ss, Ss, Ss, Ss, Ss, Ss, Ss, Ss, Ds, Ss, Ss, Ss, Ds, Ss, Ss, Ss, Ss, Ss, Ss, Ss, Ds, Ds, Ds, Ss, Ss, Ss, Ds, Ds, Gll, Gll^Ftr, Gll^Ftr, Gll^Ftr, Gll^Ftr, Gll^Ftr, Gll^Ftr, Gll^Ftr, Gll, Gs, Gs, Gs, Gs, Gs, Gs, Gs, Gs, Gs, Gs, Gs, Rr, Rr
Ww, Ww^Ewl, Ww, Ww^Ewl, Ww, Ss, Ss, Ds, Ds, Ss, Ds, Ss, Ds, Ss, Ds, Ds, Ds, Ds, Ds, Ss, Ss, Ss, Ds, Ds, Ss, Ds, Ds, Ss, Ss, Ds, Ss, Ds, Ds, Ds, Gll, Gll^Ftr, Gll^Ftr, Gll^Ftr, Gll^Ftr, Gll^Ftr, Gll^Ftr, Gll^Ftr, Gll^Ftr, Gll, Gs, Gs, Gs, Gs, Gs, Gs, Gs, Gs, Rr, Rr, Rr, Rr
Ss, Ww, Ww, Ww^Ewl, Ww^Ewl, Ww, Ww, Ss^Emf, Ds, Ds, Ds, Ds, Gll^Ftr, Ds, Sm, Sm, Ds, Sm, Ds, Ds, Ds, Ds, Ss^Emf, Ss, Ds, Ds, Ss, Ds, Ds, Ds, Ss, Ss, Ds, Ds, Gll, Gll^Ftr, Gll^Ftr, Gll^Ftr, Gll^Ftr, Gll^Ftr, Gll^Ftr, Gll^Ftr, Gll^Ftr, Gll, Gs, Gs, Gs, Gs, Gs, Gs, Rr, Rr, Rr, Rr, Rr, Rr
Ss, Ds, Ds, Ww, Ww^Ewl, Ww, Ww, Ds, Ss, Ds, Gll^Ftr, Gll^Ftr, Gll^Ftr, Ds, Sm, Ww, Ww, Sm, Ww, Ww, Ww, Ds, Ds, Ss^Emf, Ds, Ss, Ss, Ss, Ds, Ds, Ds, Ds, Ss, Ds, Ds, Gll, Re^Vct, Gll^Ftr, Gll^Ftr, Gll^Ftr, Ce, Gll^Ftr, Gll, Re^Vct, Gs, Gs, Gs, Gs, Rr, Rr, Rr, Rr, Rr, Rr, Gs, Gs
Ds, Ds, Ss, Ww, Ww^Ewl, Ww^Ewl, Ww^Ewl, Ss, Ss, Ds, Ds, Gll^Ftr, Gll^Ftr, Gll^Ftr, Ds, Ss, Ss, Ss, Ds, Ww, Ds, Ds, Ss, Ss, Ss, Ss, Ss, Ds, Ds, Ss^Vhs, Ds, Ds, Ss, Ss, Ds, Gll, Gll, Gll^Ftr, Ce, Gll^Ftr, Ce, Gll^Ftr, Ce, Gs, Gs, Gs, Rr, Rr, Rr, Rr, Rr, Rr, Gs, Gs, Gs, Gs
Ds, Ds, Ss, Ss, Ww, Ww^Ewl, Ds, Ww^Ewl, Ww^Ewl, Ss, Ss, Sm, Sm, Ds, Ds, Ds, Ds, Ss, Ss, Ds, Ds, Ss, Ss, Ss^Emf, Ds, Ds, Ds, Ds, Ds, Ss, Ds, Ds, Ss, Ss, Ss, Ds, Gs, Gll, Gll, Ce, 3 Ke, Ce, Gs, Gs, Rr, Rr, Rr, Rr, Rr, Rr, Gs, Gs, Gs, Gs, Gll, Gs
Ds, Ss, Ds, Ss, Ss, Wwf, Ww, Ds, Ww, Ww^Ewl, Ww, Ss, Ds, Ss^Emf, Ds, Ds, Sm, Ds, Ds, Ss, Ss, Ss, Sm, Sm, Ww, Ds, Gll^Ftr, Gll^Ftr, Ds, Ss, Ss, Ds, Ds, Ds, Ss, Ds, Ds, Gs, Ce, Ce, Ce, Ce, Rr, Rr, Rr, Rr, Rr, Rr, Gs, Re^Vct, Gll, Gs, Gll, Gll, Gll^Ftr, Gll
Ss, Ss, Ds, Ds, Ss, Ds, Ds, Ww^Ewl, Ww^Ewl, Ww^Ewl, Ds, Wwf, Ss^Vhs, Ds, Ss, Ds, Ss, Ds, Ss, Ss, Ds, Ds, Ww, Ds, Ww, Ds, Ds, Gll^Ftr, Ds, Ww, Ww, Ss, Ds, Ds, Ds, Ss, Ds, Gs, Gs, Gs, Rr, Rr, Rr, Rr, Rr, Rr, Ce, Gs, Gll, Gll, Gll^Ftr, Gll, Gll^Ftr, Gll, Gll^Ftr, Gll^Ftr
Ss, Ds, Ss^Emf, Ss, Ss, Ds, Ss^Vhs, Ds, Ds, Ww, Ds, Ww^Ewl, Ds, Ss, Gll^Ftr, Gll^Ftr, Gll^Ftr, Gll^Ftr, Gll^Ftr, Ss, Ds, Ds, Ds, Ww, Ww, Ww, Ds, Ds, Ss, Ww, Ss^Emf, Ss, Ss, Ss, Ds, Ss, Ss, Ds, Ds, Re^Vct, Rr, Rr, Rr, Rr, Gs, Ce, Ke, Ce, Gll^Ftr, Gll^Ftr, Gll^Ftr, Gll^Ftr, Gll^Ftr, Gll^Ftr, Gll^Ftr, Gll^Ftr
Ss, Ss^Emf, Ss^Emf, Ds, Ds, Ss, Ds, Ds, Wwf, Wwf, Ww^Ewl, Ww^Ewl, Wwf, Ds, Ss^Emf, Gll^Ftr, Ss^Emf, Gll^Ftr, Ss^Vhs, Ss, Ww, Ss, Ss, Ss, Ss, Ds, Ss, Ds, Ds, Ds, Ds, Ds, Ss, Ss, Ds, Ss, Ss, Ds, Ds, Gs, Rr, Rr, Rr, Gs, Gs, 1 Ce, Ce, Ce, Gll^Ftr, Gll^Ftr, Gll^Ftr, Gll^Ftr, Gll^Ftr, Gll^Ftr, Gll^Ftr, Gll^Ftr
Ss, Ds, Ss, Ds, Ss, Ds, Ww, Ww, Ds, Ww, Chs, Ss, Wwf, Ss, Ww^Ewl, Gll^Ftr, Ww^Ewl, Ww, Ww, Ss, Ss, Sm, Ss, Ss, Ds, Ds, Ss^Emf, Ss^Emf, Ss, Ds, Ss, Ss, Ds, Ds, Ds, Ss^Vhs, Ds, Ss, Ss^Bsb/, Rr, Rr, Rr, Gs, Gs, Ds, Re^Vct, Gll, Gll^Ftr, Gll^Ftr, Gll^Ftr, Gll^Ftr, Gll^Ftr, Gll^Ftr, Gll^Ftr, Gll^Ftr, Gll
Ss, Ds, Ss, Ss, Wwf, Wwf, Ds, Ds, Ss, Ds, Chs, Ds, Ds, Ww, Ss, Ww^Ewl, Ww^Ewl, Ww^Ewl, Ds, Sm, Ds, Ds, Ds, Ds, Ss, Ds, Ss, Ss^Emf, Ds, Ds, Ds, Ss, Ss, Ds, Ds, Ds, Rr, Rr, Rr, Ss^Bsb/, Ss^Bsb/, Rr, Ds, Ds, Ds, Ds, Ds, Gll, Gll, Gll^Ftr, Gll, Gll^Ftr, Gll^Ftr, Gll^Ftr, Gll, Gll
Ss, Ds, Ds, Ss, Wwf, Ds, Ds, Ss, Ds, Ss, Ss, Chs, Chs, Ss, Ww, Ww^Ewl, Ds, Ss, Sm, Ww, Ds, Gll^Ftr, Gll^Ftr, Gll^Ftr, Ds, Ds, Ds, Ds, Ww, Ss, Ss, Ss, Ds, Ds, Rr, Rr, Rr, Rr, Rr, Rr, Ss, Ss, Sm, Ss^Vhs, Ss, Ss, Ss, Ds, Ds, Gll, Gll, Gll, Ds, Gll, Ds, Ds
Ss, Ds, Ds, Ss, Ss^Emf, Wwf, Ss, Ds, Ss^Emf, Ss^Vhs, Ss, Sm, 5 Khs, Chs, Ss, Ww^Ewl, Ww, Ds, Ww, Ww^Ewl, Ds, Gll^Ftr, Gll^Ftr, Ds, Ww, Ww, Ds, Ww, Ds, Ds, Ww, Ss^Vhs, Ds, Rr, Rr, Rr, Rr, Rr, Ds, Ds, Ss, Ww, Ss, Ww, Ds, Ss, Sm, Ss, Ds, Ds, Ds, Ds, Ss, Ds, Ss, Ss
Ww, Ss, Sm, Ss^Emf, Ww, Ww, Ww, Ds, Ss, Ds, Ds, Sm, Chs, Chs, Ds, Ss^Vhs, Ss, Sm, Sm, Ww, Ww^Ewl, Ds, Ds, Ds, Ss, Ss, Ds, Sm, Ds, Ss, Ww, Ww, Ds, Rr, Rr, Rr, Ds, Ds, Gll^Ftr, Ds, Ds, Ss, Ds, Ds, Ds, Ds, Sm, Ss, Ss, Ds, Ds, Ss, Ds, Ss, Ds, Ss
Ww, Ss, Ww, Sm^Emf, Ww, Ss^Emf, Ww, Ss, Ss, Ds, Wwf, Ww, Chs, Ss, Ds, Ds, Ss, Ss, Sm, Ww, Ww^Ewl, Ss, Ss, Ds, Ss, Ss, Ss, Ds, Ss, Ss, Ss, Ss, Ds, Rr, Rr, Rr, Ds, Gll^Ftr, Gll^Ftr, Gll^Ftr, Ds, Ds, Gll^Ftr, Ds, Ds, Ds, Gll^Ftr, Sm, Ss, Sm, Ss^Emf, Ss, Ss, Sm, Sm, Ss
Ss, Ww, Ss, Ss^Emf, Ds, Ww, Ds, Ww, Ww, Wwf, Ds, Ww^Ewl, Ww^Ewl, Chs, Sm, Ss, Ww^Ewl, Ww^Ewl, Ww, Ww, Ww^Ewl, Ss^Vhs, Ww, Ss, Ww, Ss^Vhs, Ww, Ds, Ds, Ss, Ds, Ds, Rr, Rr, Rr, Rr, Ds, Gll^Ftr, Gll^Ftr, Gll^Ftr, Ds, Ds, Gll^Ftr, Gll^Ftr, Gll^Ftr, Gll^Ftr, Gll^Ftr, Sm, Ds, Ss, Ss, Ss, Ds, Sm, Ss, Ss
Ds, Ww, Ss, Ds, Ds, Ss, Ds, Ww, Ds, Ds, Ds, Ds, Ds, Ww^Ewl, Ww^Vm, Ww, Ww, Ww, Ds, Ww^Ewl, Ww^Ewl, Ww, Ww^Ewl, Ww^Ewl, Ww^Ewl, Ww^Ewl, Ww^Ewl, Ww^Ewl, Ww^Ewl, Ds, Ww^Bsb/, Ds^Bsb/, Ww^Bsb/, Rr, Rr, Rr, Ds, Ds, Ds, Ds, Ds, Ds, Gll^Ftr, Gll^Ftr, Gll^Ftr, Gll^Ftr, Ds, Ds, Ds, Ss, Ss, Ds, Ds, Ss, Ww, Ww
Ss, Ww, Ds, Ds, Ss, Ss^Emf, Ss^Emf, Ds, Gll^Ftr, Gll^Ftr, Gll^Ftr, Gll^Ftr, Ds, Ds, Ww, Ww^Ewl, Ds, Ds, Gll^Ftr, Ds, Ds, Ww^Ewl, Ds, Ww, Ww^Ewl, Ww^Ewl, Chw, Ww^Ewl, Ww^Bsb/, Ww^Bsb/, Ww^Bsb/, Ww^Bsb/, Rp^Bsb/, Rp^Bsb/, Ds, Ds, Ds, Ss, Ss, Ds, Ss, Ds, Ds, Gll^Ftr, Ds, Ds, Ww, Ds, Ss, Sm, Ww, Sm, Ss, Ss, Ww, Ww
Ss, Ww, Ds, Ds, Ds, Ss, Ds, Ds, Gll^Ftr, Gll^Ftr, Gll^Ftr, Gll^Ftr, Ds, Ds, Wwf, Wwf, Ds, Gll^Ftr, Gll^Ftr, Gll^Ftr, Gll^Ftr, Wwf, Ds, Ds, Ds, Ds, Rr, Ww^Bsb/, Ww^Bsb/, Ww^Bsb/, Ww^Bsb/, Ww^Bsb/, Ww^Ewl, Ds, Ww, Ss^Vhs, Ds, Ss, Ds, Ss, Ds, Ss, Ss, Ds, Ss^Vhs, Ww, Ds, Ss, Ds, Ss, Ww, Ss, Ds, Ss, Ss, Ss
Ss, Ww, Ww, Ss, Ss, Ds, Ss, Ds, Ds, Gll^Ftr, Gll^Ftr, Gll^Ftr, Ds, Ww, Ww^Ewl, Ww^Ewl, Ds, Gll^Ftr, Gll^Ftr, Gll^Ftr, Gll^Ftr, Wwf, Wwf, Ds, Ds, Rr, Rr, Rr, Rr, Rr, Chw, Ww, Ww^Ewl, Ww^Ewl, Ww^Ewl, Ww, Ss, Ds, Ds, Ds, Ss, Ss, Ss, Wwf, Ds, Gll^Ftr, Gll^Ftr, Ds, Ds, Ds, Ss^Emf, Ss, Ss, Ds, Ds, Ss
Ds, Ss, Ss, Ww, Ds, Ss^Emf, Ss^Emf, Ds, Ss, Ds, Ds, Ds, Ww, Ww, Ww^Ewl, Ww, Ds, Gll^Ftr, Gll^Ftr, Gll^Ftr, Gll^Ftr, Gll^Ftr, Wwf, Gll^Ftr, Gll, Rr, Rr, Rr, Ds, Ds, Ds, Ww, Ww, Ww, Ww^Ewl, Ww, Ds, Ss, Ss, Ss, Sm, Sm, Ss, Ds, Ds, Ds, Gll^Ftr, Ss, Ds, Ds, Ds, Ds, Ss, Ds, Ds, Ss
Ds, Ds, Ds, Ww, Wwf, Ds, Ww, Ss, Ds, Ds, Ss, Ss, Ww, Ww^Ewl, Ww^Ewl, Ww, Ww, Ds, Gll^Ftr, Gll^Ftr, Gll^Ftr, Wwf, Gll^Ftr, Gll^Ftr, Rr, Rr, Rr, Rr, Gll, Ds, Gll^Ftr, Ds, Ds, Ww^Ewl, Ww^Ewl, Ww, Ds, Ss, Ss, Sm, Ss, Ss, Ss, Gll^Ftr, Ss, Ds, Ds, Gll^Ftr, Ds, Ss, Ss, Sm, Ds, Ds, Ss, Ss
Ds, Ss, Ds, Ss, Ds, Ww, Ds, Wwf, Ds, Ss, Ss^Vhs, Ww, Ds, Ww, Ww, Ww^Ewl, Ww, Ds, Ds, Gll^Ftr, Wwf, Wwf, Gll^Ftr, Gll, Rr, Rr, Rr, Rr, Gll^Ftr, Gll, Gll^Ftr, Gll^Ftr, Ds, Ww, Ww, Ww, Wwf, Ds, Ss, Ss, Ds, Ds, Ds, Gll^Ftr, Gll^Ftr, Ss, Gll^Ftr, Ds, Ss, Sm, Ss, Sm, Ss^Emf, Ds, Ss, Ss
Ss, Ss, Ds, Ss, Ds, Ds, Ss, Sm, Wwf, Ww, Ds, Wwf, Wwf, Ds, Ww, Ww^Ewl, Ww^Ewl, Ww, Ww, Ds, Ww, Ds, Gll^Ftr, Gll, Rr, Rr, Rr, Khr, Chr, Gll^Ftr, Gll^Ftr, Gll^Ftr, Gll^Ftr, Ds, Ds, Wwf, Ww, Ww^Ewl, Ww^Ewl, Ss, Ds, Ds, Wwf, Ds, Ds, Gll^Ftr, Ds, Ds, Ss, Sm, Sm, Sm, Sm, Ds, Ss, Ss
Ss, Ds, Ds, Ss, Ds, Ss, Ss, Ds, Ds, Ss, Ds, Ds, Wwf, Ds, Ww, Ww, Ww, Ww, Ww^Ewl, Ww, Ww, Ds, Ds, Ds, Rr, Rr, Rr, Chr, Gll^Ftr, Gll^Ftr, Gll^Ftr, Gll^Ftr, Gll^Ftr, Ds, Ds, Ww, Ww^Ewl, Ww, Ss, Ww, Ds, Wwf, Ds, Wwf, Ss, Wwf, Ds, Ww, Ww, Ss^Vhs, Ss, Ds, Ds, Ds, Ds, Ds
Ss, Ss, Sm, Ss, Ds, Ds, Ss, Ds, Ss, Ds, Ss, Ds, Ds, Ww, Ww, Ww^Ewl, Ww, Ww^Ewl, Ww^Ewl, Ww, Ww^Ewl, Chw, Rr, Rr, Rr, Rr, Rr, Gll^Ftr, Gll^Ftr, Gll^Ftr, Gll^Ftr, Gll^Ftr, Gll^Ftr, Ds, Ds, Ww^Ewl, Ww^Ewl, Ww, Ss, Wwf, Ww, Wwf, Ss, Ds, Ss, Ss, Ss^Emf, Ss, Ds, Ds, Wwf, Ds, Ss, Ss, Ss, Ss
Ww, Sm, Ds, Wwf, Ww, Ds, Ss, Ds, Ds, Ss, Ss, Ss^Emf, Ds, Ss, Ss, Ww^Ewl, Ww^Ewl, Ww, Ww, Ww^Ewl, Ww^Bsb/, Ww^Bsb/, Ww^Bsb/, Rr, Rr, Rr, Ds, Gll^Ftr, Gll^Ftr, Gll^Ftr, Gll^Ftr, Gll^Ftr, Ds, Ds, Ww, Wwf, Ds, Ss, Ds, Ds, Ds, Ww, Wwf, Ds, Sm, Sm, Sm, Ss, Ss, Ss, Wwf, Ww, Ww, Sm, Ss, Ss
Ss, Ww, Chs, Ds, Ww, Ww, Ds, Ss, Ds, Ds, Ds, Ss, Ds, Ds, Ds, Ds, Ds, Chs, Ss^Bsb/, Ww^Bsb/, Ww^Bsb/, Ww^Bsb/, Ww^Bsb/, Ds^Bsb/, Chw, Ds, Ds, Ds, Gll^Ftr, Gll^Ftr, Gll^Ftr, Ds, Ww, Ww^Ewl, Ww^Ewl, Ww, Ds, Ss, Ds, Gll^Ftr, Gll^Ftr, Ds, Ww, Ss, Ss, Ss, Ds, Ds, Ds, Ds, Ww, Sm, Ss, Ww, Ss, Ss
Ww, Ww, Ww^Vm, Ds, Ds, Wwf, Wwf, Ds, Ww, Ss, Ss, Ds, Ss, Ds, Ss, Ss, Ds, Rr, Rr, Ss^Bsb/, Ss^Bsb/, Ww^Bsb/, Ww^Ewl, Ww, Ww^Ewl, Ds, Ww, Ds, Ds, Gll^Ftr, Ds, Ds, Ww, Ww^Ewl, Ww, Ds, Ss, Ss, Ss, Ds, Ds, Ds, Ss, Ww, Ss, Ss, Ss, Ds, Ss, Ss, Ss, Ss, Ss, Ww, Ss, Ds
Ww, Sm, Ww, Ss, Ww, Ds, Ds, Ww, Ss, Ww, Ds, Ds, Ds, Ss, Ss^Emf, Ss, Ds, Rr, Rr, Rr, Ds, Chs, Ds, Ww^Ewl, Ww, Ww, Ww^Ewl, Ww, Ww, Ds, Ww, Ww, Ww^Ewl, Ww^Ewl, Ww, Ww, Ww, Ww, Ss, Sm, Ss, Ss, Ww, Ww, Ss, Ss^Vhs, Ss, Ss, Ss, Sm, Ww, Ss, Ss, Ds, Ds, Ds
Ss, Ss, Chs, Chs, Chs, Ss^Emf, Ds, Ss^Emf, Ds, Wwf, Wwf, Ds, Ds, Ss, Ds, Ds, Ds, Rr, Rr, Rr, Ds, Ss, Ss, Ds, Ww, Ww^Ewl, Ww^Ewl, Ww^Ewl, Ww, Wwf, Wwf, Ww, Ww, Ww^Ewl, Ww^Ewl, Ww^Ewl, Ww^Vm, Ww, Ww, Ss, Ww, Ww, Ww, Ww^Ewl, Ww, Ss, Ds, Ds, Ss, Ww, Ss, Ds, Ds, Ds, Sm, Ss
Ss, Ss^Emf, Khs, Wwf, Chs, Ss^Emf, Ss^Emf, Ds, Ss^Vhs, Ds, Ww, Ss, Ss, Ds, Ss, Ds, Ds, Rr, Rr, Rr, Ww, Ww, Ss, Ww, Ww^Ewl, Ww^Ewl, Ww, Ww, Ww, Ww, Ds, Ds, Ds, Ww, Ww, Ww, Ww, Ww^Ewl, Ww^Ewl, Ww, Ww^Ewl, Ww^Ewl, Ww^Ewl, Ww, Ww^Ewl, Ww, Ww, Ds, Ss, Ds, Ds, Ss, Ss^Emf, Ss, Sm, Ss
Ss, Ss^Emf, Chs, Wwf, Wwf, Chs, Khs, Ss, Ss, Chs, Chs, Ss, Ss, Ss^Vhs, Ds, Ss^Emf, Ss, Ss^Bsb|, Ss^Bsb|, Ss^Bsb|, Ww, Ds, Ds, Ww, Ww, Ww, Ds, Ds, Ds, Ds, Ss^Emf, Ss^Emf, Ss, Ds, Ss, Ww, Ww, Ww, Ww, Ww, Ww, Ww, Ss, Ww^Ewl, Ww, Ww^Ewl, Ww^Ewl, Ss, Ds, Ds, Ss, Ss, Sm, Ss^Emf, Ss, Ss
Ds, Ss^Emf, Chs, Wwf, Wwf, Wwf, Chs, Ss^Emf, Ss^Emf, Ss^Vhs, Chs, Ww, Ww, Wwf, Wwf, Ss, Ss, Ss^Bsb|, Ww^Bsb|, Ds^Bsb|, Ww, Ss^Vhs, Ss, Ds, Ds, Wwf, Ww, Ss, Ds, Ds, Ss, Sm, Ss, Ds, Ss, Ss, Chs, Chs, Chs, Chs, Chs, Ss, Ds, Ss, Ss, Ww^Ewl, Ww^Ewl, Ww^Ewl, Ds, Ss, Ss, Sm, Ss, Sm^Emf, Sm, Ss
Ds, Ds, Ss^Emf, Khs, Chs, Chs, Wwf, Chs, Khs, Ss^Emf, Ss, Ss^Emf, Ss^Emf, Ds, Ds, Ww, Ww, Ww^Bsb|, Ds^Bsb|, Ww^Bsb|, Ss, Ss^Emf, Ss, Ds, Ds, Ds, Ds, Ss^Vhs, Ww, Ss, Ds, Ds, Ww, Ds, Ss, Sm, Ss, Sm, 4 Khs, Ss, Ss, Ds, Ds, Ds, Ss, Ww, Ww^Ewl, Ww, Ww, Ds, Ds, Ds, Sm, Sm, Ss, Ss
Ss, Ds, Ss^Emf, Wwf, 2 Khs, Wwf, Wwf, Wwf, Chs, Ss^Emf, Ss, Chs, Ss, Ss, Ds, Ss^Emf, Ds, Ds^Bsb|, Rr, Ss^Bsb|, Ss, Ss, Ww, Ww, Ds, Ss, Ds, Ds, Wwf, Ds, Ss, Ss, Ss, Ds, Ss^Vhs, Ss, Sm, Sm, Ss, Ss, Ss, Ds, Wwf, Ss^Vhs, Ww, Ww, Ww, Ww, Wwf, Ds, Ss, Ds, Ss, Ss, Ss, Ss
Ss, Ds, Ww, Wwf, Chs, Wwf, Wwf, Wwf, Chs, Ss^Vhs, Ss, Chs, Ss, Ds, Ss, Ds, Ds, Rr, Rr, Rr, Ds, Ds, Ds, Ss, Ss, Ss^Emf, Ww, Ds, Ww, Ds, Ww, Ss, Ds, Ds, Ds, Ss, Ss^Emf, Ss, Ww, Ww^Ewl, Ww, Ww, Ds, Ww, Ss, Ss^Emf, Ds, Ds, Ww^Ewl, Ss^Vhs, Ss, Ss, Ww, Ss, Ww, Ww
Ww, Ww, Ds, Ww, Ww, Khs, Chs, Chs, Ss^Emf, Ss, Chs, Chs, Ss, Ss, Ds, Ss^Vhs, Ss, Rr, Ss^Bsb|, Rr, Ds, Ds, Ds, Ss, Ss, Ww, Ds, Ss, Ds, Ss, Ds, Wwf, Wwf, Ds, Ss^Emf, Ds, Ds, Ww, Ww^Ewl, Ww^Ewl, Ds, Ss^Vhs, Ds, Ss, Ss, Ss^Emf, Ss, Ds, Ww, Ww, Ww^Ewl, Ww, Ww^Ewl, Ww^Ewl, Ww^Ewl, Ww^Ewl
Ss, Ds, Ss, Ds, Ww, Ss^Vhs, Ss^Emf, Ss^Emf, Ss, Chs, Ss^Emf, Ss, Ds, Ds, Ss, Ds, Ss, Ss^Bsb|, Ds^Bsb|, Ds^Bsb|, Ss, Ss, Ds, Ds, Ww, Ss, Ds, Ss, Ds, Ds, Ss^Emf, Ds, Ss, Ww, Ww, Ss, Ss, Ds, Ds, Ds, Ds, Ss^Emf, Sm, Sm, Ss, Ds, Ss, Ds, Ww, Ww^Ewl, Ww^Ewl, Ww^Ewl, Ww, Ww, Ww, Ww
Ss, Ds, Ds, Ss, Ww, Ds, Ds, Ss, Ds, Ss^Emf, Ds, Ds, Ss, Ds, Ss, Ds, Ss, Ds^Bsb|, Ds^Bsb|, Ds^Bsb|, Ss, Ss, Ds, Ss^Emf, Ds, Wwf, Ss, Ds, Ss, Ss, Ss, Ss, Ds, Ds, Ds, Ds, Ss, Ss, Ss, Ss, Ds, Ss, Sm, Ds, Ss, Ds, Ds, Ds, Ss, Ww, Ww, Ww, Ss, Ss, Ss, Ss
Ds, Ds, Ss, Ds, Ww, Ww, Ss, Ss, Ds, Ds, Ss, Ss, Ss, Ss, Ss, Ds, Ds, Ss^Bsb|, Ds, Ss^Bsb|, Ss, Ss, Ss, Ds, Ds, Ww, Ss, Ss, Ss, Ss, Ds, Ds, Ss, Ss, Ds, Ww, Ww, Ds, Ss, Ss, Ss, Ss, Ss, Ss, Ss, Ss, Ds, Ss, Ss, Ss, Ss, Ss, Ss, Ss, Ss, Ss
