Xu, Xu, Xu, Xu, Xu, Uu, Ur, Ur, Ur, Uu, Xu, Xu, Xu, Xu, Xu, Xu, Xu, Xu, Xu, Xu, Xu, Xu, Xu, Xu, Xu, Uh, Uu, Ur, Ur, Ur, Ur, Ur, Uu, Uh, Xu, Xu, Xu, Xu, Xu, Xu, Xu, Xu, Xu, Xu, Xu, Xu, Xu, Xu, Xu, Uu, Ur, Ur, Uu^Uf, Uh, Uu^Uf, Ur, Ur, Uu, Uu, Xu, Xu, Xu, Xu, Xu
Xu, Xu, Xu, Xu, Xu, Uu, Ur, Ur, Ur, Uh, Uh, Xu, Xu, Xu, Xu, Xu, Xu, Xu, Xu, Xu, Xu, Xu, Xu, Xu, Uh, Uh, Uu, Ur, Ur, Ur, Ur, Ur, Ur, Uh, Uh, Xu, Xu, Xu, Xu, Xu, Xu, Xu, Xu, Xu, Xu, Xu, Xu, Uh, Uu, Uu, Ur, Ur, Uu^Uf, Uh, Uu^Uf, Ur, Ur, Uu, Xu, Xu, Xu, Xu, Xu, Xu
Xu, Xu, Xu, Xu, Uh, Uu, Ur, Ur, Ur, Ur, Uh, Xu, Xu, Xu, Xu, Xu, Xu, Xu, Xu, Xu, Xu, Xu, Xu, Uh, Uu^Uf, Uu, Ur, Ur, Ur, Ur, Ur, Ur, Uu, Uh, Uh, Xu, Xu, Xu, Xu, Xu, Xu, Xu, Xu, Xu, Xu, Xu, Xu, Uh, Uu, Uu, Ur, Ur, Uu^Uf, Uh, Ur, Ur, Ur, Uu, Xu, Xu, Xu, Xu, Xu, Xu
Xu, Xu, Xu, Xu, Uh, Uu^Uf, Ur, Ur, Ur, Ur, Uu^Uf, Xu, Xu, Xu, Xu, Xu, Xu, Xu, Xu, Xu, Xu, Xu, Uh, Uh, Uu^Uf, Ur, Ur, Ur, Ur, Ur, Ur, Ur, Ur, Uu^Uf, Uu^Uf, Uh, Xu, Xu, Xu, Xu, Xu, Xu, Xu, Xu, Xu, Xu, Uh, Uh, Uu^Uf, Ur, Ur, Ur, Uu^Uf, Uu^Uf, Ur, Ur, Uu^Uf, Uh, Xu, Xu, Xu, Xu, Xu, Xu
Xu, Xu, Xu, Xu, Xu, Uh, Uu, Ur, Ur, Ur, Uu^Uf, Uh, Xu, Xu, Xu, Xu, Xu, Xu, Xu, Xu, Xu, Xu, Uh, Uu^Uf, Uu, Ur, Ur, Ur, Ur, Ur, Ur, Uh, Ur, Uu^Uf, Uh, Uh, Xu, Xu, Xu, Xu, Xu, Xu, Xu, Xu, Xu, Xu, Uh, Uh, Ur, Ur, Ur, Ur, Ur, Ur, Ur, Ur, Uh, Uh, Xu, Xu, Xu, Xu, Xu, Xu
Xu, Xu, Xu, Xu, Xu, Xu, Uu, Ur, Ur, Ur, Ur, Uh, Uh, Xu, Xu, Xu, Xu, Xu, Xu, Xu, Xu, Xu, Xu, Uh, Uu^Vu, Ur, Uu^Uf, Uu^Uf, Ur, Ur, Ur, Uh, Ur, Uu, Wwg, Xu, Wog, Wog, Wog, Wog, Xu, Xu, Xu, Xu, Xu, Xu, Uu^Vu, Uu^Uf, Ur, Ur, Ur, Ur, Ur, Ur, Ur, Uu^Uf, Xu, Xu, Xu, Xu, Xu, Xu, Xu, Xu
Xu, Xu, Xu, Xu, Xu, Xu, Uu^Vu, Ur, Ur, Ur, Ur, Ur, Uu^Uf, Xu, Xu, Xu, Xu, Xu, Xu, Xu, Xu, Wog, Wwg, Uu^Uf, Ur, Ur, Uh, Ur, Ur, Ur, Ur, Ur, Ur, Uu^Vu, Wwg, Wog, Xu, Wog, Xu, Wog, Wog, Xu, Xu, Xu, Xu, Xu, Wwg, Ur, Ur, Ur, Ur, Ur, Ur, Ur, Uu^Uf, Wwg, Xu, Xu, Xu, Xu, Xu, Xu, Xu, Xu
Xu, Xu, Xu, Xu, Xu, Xu, Uh, Ur, Ur, Ur, Ur, Ur, Uu^Uf, Xu, Xu, Xu, Xu, Xu, Xu, Xu, Xu, Xu, Wwg, Uu^Uf, Ur, Ur, Cud, Cud, Kud, Cud, Cud, Ur, Ur, Ur, Uh, Xu, Xu, Xu, Xu, Xu, Wog, Xu, Xu, Xu, Xu, Xu, Wwg, Ur, Ce, Ce, Ce, Ur, Ur, Uu^Uf, Xu, Xu, Xu, Xu, Xu, Xu, Xu, Xu, Xu, Xu
Xu, Xu, Xu, Xu, Xu, Xu, Uh, Ur, Ce, Ce, Ce, Ur, Ur, Uu^Vu, Uh, Xu, Xu, Xu, Xu, Xu, Xu, Xu, Xu, Uh, Ur, Ur, Kud, Ur, Cud, Ur, Kud, Ur, Uh, Ur, Uh, Xu, Xu, Xu, Xu, Wog, Wwg, Wog, Xu, Xu, Uh, Uu^Vu, Ur, Ur, Ce, 7 Ke, Ce, Ur, Ur, Wwg, Xu, Xu, Xu, Xu, Xu, Xu, Xu, Xu, Xu, Xu
Xu, Xu, Xu, Xu, Uh, Uh, Ur, Ur, Ce, 6 Ke, Ce, Ur, Ur, Ur, Ur, Uu^Uf, Xu, Xu, Xu, Xu, Xu, Xu, Uh, Uh, Ur, Cud, Ur, Cud, Kud, Cud, Ur, Cud, Uh, Ur, Uu^Uf, Xu, Uh, Xu, Uu^Uf, Wwg, Wwg, Wwg, Xu, Xu, Uh, Uh, Ur, Ur, Ur, Ce, Ur, Ur, Wwg, Wwg, Xu, Xu, Xu, Xu, Xu, Xu, Xu, Xu, Xu, Xu
Xu, Xu, Xu, Xu, Uh, Ur, Ur, Ur, Ur, Ce, Ur, Ur, Ur, Ur, Ur, Uu^Uf, Uu, Uu, Uu, Uu, Uu, Uu^Vu, Ur, Ur, Uh, Cud, Kud, Cud, 1 Cud, Cud, Kud, Cud, Ur, Ur, Ur, Uu^Uf, Ur, Uh, Ur, Uh, Ur, Uh, Uu^Uf, Uh, Ur, Ur, Ur, Ur, Ur, Ur, Uh, Uu^Vu, Xu, Xu, Xu, Xu, Xu, Xu, Xu, Xu, Xu, Xu, Xu, Xu
Xu, Xu, Uu^Vu, Uu, Ur, Ur, Uu, Uu, Uh, Uh, Uh, Ur, Ur, Ur, Ur, Ur, Ur, Ur, Uu, Uu, Xu, Uu, Ur, Ur, Ur, Uu^Uf, Cud, Ur, Kud, Ur, Cud, Ur, Ur, Ur, Ur, Ur, Ur, Ur, Ur, Ur, Ur, Ur, Ur, Ur, Uu^Uf, Uu^Uf, Ur, Ur, Ur, Ur, Uh, Xu, Xu, Xu, Xu, Xu, Xu, Xu, Xu, Xu, Xu, Xu, Xu, Xu
Xu, Xu, Uu, Ur, Uu, Uu, Xu, Xu, Xu, Xu, Uh, Ur, Ur, Ur, Ur, Ur, Ur, Ur, Uu, Xu, Xu, Uu^Vu, Uu, Ur, Ur, Ur, Ur, Cud, Ur, Cud, Ur, Ur, Ur, Ur, Ur, Ur, Uu, Uu, Uu, Ur, Ur, Ur, Ur, Ur, Ur, Uu^Uf, Ur, Ur, Ur, Uh, Xu, Xu, Xu, Xu, Xu, Xu, Xu, Xu, Xu, Xu, Xu, Xu, Xu, Xu
Xu, Xu, Uu, Ur, Uu, Xu, Xu, Xu, Xu, Xu, Xu, Uu^Vu, Uu, Ur, Ur, Ur, Ur, Ur, Ur, Uu, Xu, Xu, Uu, Ur, Uu, Ur, Ur, Ur, Ur, Ur, Ur, Ur, Ur, Ur, Uu, Uu, Xu, Xu, Xu, Uu, Uu, Ur, Xu, Ur, Ur, Ur, Ur, Xu, Ur, Uu^Vu, Xu, Xu, Xu, Xu, Xu, Xu, Xu, Xu, Xu, Xu, Xu, Xu, Xu, Xu
Uu^Uf, Uu^Uf, Ur, Ur, Uu, Xu, Xu, Xu, Xu, Xu, Xu, Xu, Xu, Uu, Ur, Ur, Ur, Ur, Ur, Uu, Uu, Uu, Uu, Uu, Xu, Uu, Uu, Ur, Ur, Ur, Ur, Xu, Ur, Uu, Xu, Xu, Xu, Xu, Xu, Xu, Uu, Ur, Ur, Ur, Uh, Uh, Uh, Ur, Ur, Uu, Xu, Xu, Xu, Xu, Xu, Xu, Xu, Xu, Xu, Xu, Xu, Xu, Xu, Xu
Uu^Uf, Ur, Ur, Ur, Uu^Uf, Xu, Xu, Xu, Xu, Xu, Xu, Xu, Uu, Uu, Ur, Ur, Ur, Ur, Ur, Ur, Ur, Ur, Wwg, Xu, Xu, Wwg, Wwg, Uu, Ur, Ur, Ur, Ur, Ur, Uu, Xu, Xu, Xu, Xu, Xu, Uu, Ur, Ur, Ur, Ur, Wwg, Xu, Xu, Ur, Xu, Uu, Xu, Xu, Xu, Xu, Xu, Xu, Xu, Xu, Xu, Xu, Xu, Xu, Xu, Xu
Xu, Uh, Ur, Ur, Ur, Uh, Uh, Xu, Xu, Xu, Xu, Xu, Xu, Uu, Ur, Ur, Xu, Xu, Ur, Ur, Ur, Uu, Xu, Wog, Wog, Wwg, Xu, Uu^Uf, Uu, Ur, Xu, Ur, Ur, Uu^Vu, Uu, Xu, Xu, Xu, Xu, Uu, Uu, Xu, Ur, Wwg, Xu, Wog, Xu, Uu, Ur, Uu, Uu^Uf, Xu, Xu, Xu, Xu, Xu, Xu, Xu, Xu, Xu, Xu, Xu, Xu, Xu
Xu, Uh, Uu^Uf, Ur, Ur, Ur, Uu^Uf, Xu, Xu, Xu, Xu, Xu, Xu, Uu, Uu, Ur, Xu, Ur, Ur, Xu, Ur, Uu, Uh, Xu, Xu, Wog, Xu, Xu, Uh, Ur, Ur, Xu, Ur, Ur, Ur, Wwg, Wog, Xu, Xu, Xu, Uu, Ur, Ur, Wwg, Uu, Xu, Uu, Uu, Ur, Ur, Uu^Uf, Wwg, Wwg, Xu, Xu, Xu, Xu, Xu, Xu, Xu, Xu, Xu, Xu, Xu
Xu, Xu, Uu^Uf, Ur, Ur, Ur, Ur, Uu^Uf, Uh, Xu, Xu, Xu, Xu, Xu, Uu, Ur, Ur, Ur, Uh, Ur, Ur, Ur, Ur, Uh, Xu, Wog, Xu, Xu, Uh, Ur, Ur, Ur, Ur, Ur, Uu, Wwg, Xu, Xu, Xu, Uu, Ur, Ur, Xu, Wwf, Ur, Uu, Uu, Uu, Uu, Xu, Ur, Uu^Uf, Wwf, Xu, Xu, Xu, Xu, Xu, Xu, Xu, Xu, Xu, Xu, Xu
Xu, Xu, Xu, Uh, Uh, Uu, Uu^Vu, Ur, Uh, Xu, Xu, Xu, Xu, Xu, Uu, Ur, Ur, Uh, Uh, Ur, Xu, Ur, Ur, Uh, Xu, Wog, Xu, Uu^Uf, Ur, Ur, Ur, Xu, Ur, Ur, Uu, Xu, Xu, Xu, Xu, Uu, Ur, Ur, Wwf, Wwf, Uu, Uu, Xu, Xu, Xu, Uu, Ur, Ur, Wwf, Uu^Vu, Xu, Xu, Xu, Xu, Xu, Xu, Xu, Xu, Xu, Xu
Xu, Xu, Xu, Xu, Xu, Xu, Uu, Ur, Ur, Uu^Uf, Xu, Xu, Xu, Xu, Uu, Ur, Xu, Ur, Ur, Ur, Ur, Ur, Ur, Uu, Wwg, Wwg, Uh, Uh, Ur, Ur, Ur, Ur, Xu, Ur, Uu, Xu, Uu^Vu, Xu, Uu, Uu, Xu, Wwg, Ur, Uu, Xu, Xu, Xu, Xu, Xu, Uu^Uf, Uu, Xu, Wwg, Wwf, Wwg, Xu, Uh, Xu, Xu, Xu, Xu, Xu, Xu, Xu
Xu, Xu, Xu, Xu, Xu, Xu, Uu, Ur, Xu, Uu^Uf, Uu, Xu, Uu, Uu, Ur, Ur, Ur, Ur, Ur, Ur, Ur, Ur, Ur, Wwf, Uu, Uu, Ur, Ur, Ur, Xu, Xu, Ur, Ur, Ur, Ur, Uu, Ur, Uu, Ur, Ur, Ur, Wwg, Ur, Uu, Xu, Xu, Xu, Xu, Xu, Xu, Uu, Ur, Wwg, Xu, Wwf, Wwf, Wwf, Uh, Xu, Xu, Xu, Xu, Xu, Xu
Xu, Xu, Xu, Xu, Xu, Xu, Uu, Ur, Ur, Ur, Ur, Uu, Uu, Uu, Uu, Uu, Uu, Ur, Ur, Uu^Uf, Uu, Xu, Ur, Wwg, Ur, Ur, Uu, Uu, Uu, Ur, Ur, Ur, Ur, Ur, Ur, Xu, Ur, Ur, Xu, Ur, Ur, Wwg, Ur, Uu, Xu, Xu, Xu, Xu, Xu, Xu, Uh, Wwf, Wwf, Wwf, Wwf, Xu, Wwf, Uh, Uh, Xu, Xu, Xu, Xu, Xu
Xu, Xu, Xu, Xu, Xu, Xu, Xu, Uu, Ur, Ur, Uu, Uu, Xu, Xu, Xu, Xu, Xu, Uu, Ur, Xu, Ur, Ur, Wwf, Wwg, Ur, Uu, Xu, Xu, Uu^Uf, Ur, Ur, Ur, Ur, Ur, Uu, Ur, Ur, Ur, Ur, Ur, Wwf, Wwf, Wwf, Uu^Uf, Uu^Uf, Xu, Uu^Uf, Xu, Xu, Xu, Uu^Uf, Wwf, Wwf, Wwg, Xu, Wwf, Wwg, Uh, Xu, Xu, Xu, Xu, Xu, Xu
Xu, Xu, Xu, Xu, Xu, Xu, Uu, Uu, Xu, Uu, Xu, Xu, Xu, Xu, Wog, Xu, Xu, Uh, Uh, Ur, Uu, Wwf, Wwg, Xu, Ur, Uu, Xu, Xu, Xu, Uu, Ur, Ur, Ur, Uu, Xu, Uu, Uu^Uf, Uu, Uu, Ur, Wwg, Xu, Wwf, Uu^Uf, Ur, Uu, Uu, Uh, Uh, Uh, Wwg, Wwg, Xu, Wwf, Wwf, Wwf, Wwf, Uu^Vu, Xu, Xu, Xu, Xu, Xu, Xu
Xu, Xu, Xu, Xu, Xu, Xu, Uu^Uf, Ur, Ur, Uu, Xu, Xu, Wog, Wog, Xu, Wog, Wog, Xu, Xu, Uh, Xu, Wwf, Ur, Wwf, Ur, Uu^Vu, Xu, Xu, Xu, Uu, Ur, Ur, Uu, Uu^Uf, Xu, Xu, Xu, Xu, Uu^Uf, Ur, Ur, Wwg, Wwf, Ur, Wwg, Ur, Wwg, Wwg, Wwf, Wwf, Wwf, Wwg, Wwf, Wwf, Wwg, Wwf, Wwg, Uh, Xu, Xu, Xu, Xu, Xu, Xu
Xu, Xu, Xu, Xu, Xu, Xu, Uu^Uf, Ur, Ur, Uu, Wwf, Wog, Xu, Xu, Xu, Xu, Xu, Wog, Wog, Xu, Wwg, Wwg, Ur, Wwg, Xu, Ur, Xu, Xu, Xu, Uh, Ur, Ur, Uu, Xu, Xu, Xu, Xu, Xu, Xu, Uu, Ur, Wwg, Xu, Wwg, Xu, Wwf, Wwf, Xu, Wwf, Xu, Wwg, Wwf, Wwg, Xu, Wwf, Xu, Wwg, Uu^Uf, Uu^Uf, Xu, Xu, Xu, Xu, Xu
Xu, Xu, Xu, Xu, Xu, Xu, Uu, Xu, Ur, Wwf, Uu^Vu, Xu, Xu, Xu, Uu^Uf, Xu, Xu, Xu, Xu, Wwg, Xu, Xu, Ur, Wwf, Ur, Ur, Xu, Xu, Xu, Uh, Ur, Ur, Uu, Uu^Uf, Xu, Xu, Xu, Xu, Xu, Uh, Ur, Wwg, Wwg, Wwf, Wwg, Wwf, Wwg, Wwf, Xu, Wwg, Xu, Xu, Xu, Wwf, Wwg, Wwf, Wwf, Wwf, Uu^Uf, Wwg, Xu, Xu, Xu, Xu
Xu, Xu, Xu, Xu, Xu, Xu, Uu, Ur, Wwg, Wwf, Wwf, Wwg, Uu, Uu^Uf, Wwg, Uu^Uf, Uu, Xu, Xu, Xu, Xu, Uu^Uf, Wwg, Wwf, Wwg, Ur, Xu, Xu, Xu, Uu, Ur, Ur, Uh, Xu, Xu, Xu, Xu, Xu, Uh, Uh, Ur, Ur, Ur, Wwf, Wwf, Uu^Vu, Xu, Xu, Xu, Xu, Xu, Xu, Xu, Xu, Uu^Vu, Wwg, Xu, Wwg, Uh, Xu, Xu, Xu, Xu, Xu
Xu, Xu, Xu, Xu, Xu, Xu, Wwg, Wwf, Ur, Wwg, Xu, Wwf, Wwf, Xu, Wwf, Xu, Wwg, Uu, Uu^Vu, Uu^Uf, Uh, Uh, Wwg, Xu, Wwf, Ur, Uu, Uu^Uf, Uu, Uu, Ur, Ur, Ur, Uh, Uu^Uf, Xu, Uu^Uf, Uh, Ur, Ur, Ur, Xu, Uu, Uu, Uu, Wwf, Wwf, Xu, Xu, Wwg, Wwg, Xu, Xu, Xu, Wwf, Wwg, Wwf, Wwg, Re^Vct, Xu, Xu, Xu, Xu, Xu
Xu, Xu, Xu, Wog, Wog, Wog, Xu, Uu, Uh, Wwg, Wwg, Wwg, Wwf, Wwg, Wwf, Wwf, Wwg, Wwf, Wwg, Wwg, Wwf, Wwf, Wwf, Wwf, Wwf, Wwg, Wwf, Uu, Ur, Ur, Ur, Ur, Ur, Ur, Ur, Uu^Uf, Ur, Ur, Xu, Ur, Uu, Uu, Xu, Xu, Xu, Uu, Wwf, Uu^Uf, Ur, Uu^Uf, Xu, Xu, Xu, Wwg, Uu^Uf, Wwf, Ur, Ur, Uu^Uf, Xu, Xu, Xu, Xu, Xu
Wog, Xu, Wog, Wog, Xu, Xu, Xu, Xu, Uh, Wwg, Wwf, Wwf, Wwf, Xu, Wwf, Wwg, Xu, Wwf, Wwf, Wwf, Wwg, Xu, Wwg, Wwf, Wwg, Xu, Wwg, Ur, Xu, Uh, Uh, Ur, Ur, Ur, Uh, Ur, Uu, Ur, Ur, Ur, Uu, Xu, Xu, Xu, Xu, Uu^Uf, Uu^Uf, Wwf, Xu, Ur, Xu, Xu, Xu, Uu^Uf, Ur, Wwg, Ur, Ur, Ce, Uu^Uf, Uh, Uh, Uh, Xu
Xu, Wog, Xu, Xu, Xu, Xu, Xu, Uu^Uf, Xu, Wwf, Wwg, Xu, Wwf, Wwg, Wwg, Wwf, Uu, Uu, Uh, Uu, Qxu, Wwg, Wwg, Xu, Wwg, Wwg, Qxu, Uu^Uf, Xu, Xu, Uh, Ur, Ur, Uh, Xu, Uh, Xu, Uu, Uu, Ur, Uu, Xu, Xu, Xu, Wog, Wwg, Wwf, Wwf, Xu, Ur, Xu, Xu, Uh, Uu^Uf, Ur, Wwf, Ce, Ce, Ce, Ce, Ce, Ur, Re^Vct, Uu
Xu, Xu, Xu, Xu, Xu, Xu, Uu^Uf, Uu^Uf, Wwg, Wwf, Xu, Wwg, Wwf, Uu^Vu, Uu, Uu, Xu, Xu, Xu, Xu, Xu, Qxu, Wwg, Wwf, Wwg, Qxu, Xu, Xu, Xu, Xu, Cud, Ur, Ur, Uh, Cud, Xu, Xu, Xu, Uu, Ur, Xu, Uu, Uu^Vu, Xu, Xu, Xu, Wwf, Xu, Wwf, Ur, Uu, Uh, Ur, Ur, Wwf, Wwf, Wwf, Ce, 9 Ke, Ce, Ur, Ur, Ur, Ur
Xu, Xu, Xu, Xu, Uh, Uh, Xu, Wwg, Wwf, Wwf, Wwf, Wwg, Wwf, Xu, Uu, Xu, Xu, Xu, Xu, Xu, Xu, Qxu, Uu^Uf, Wwf, Xu, Qxu, Xu, Xu, Uu^Uf, Uu^Uf, Ur, Ur, Ur, Uu^Uf, Uu^Vu, Xu, Xu, Xu, Xu, Uu, Ur, Ur, Uu^Uf, Xu, Xu, Xu, Uh, Wwf, Ur, Wwf, Wwf, Ur, Ur, Ur, Wwf, Xu, Wwf, Ce, Ce, Ce, Ur, Ur, Ur, Ur
Xu, Xu, Xu, Wog, Wwg, Wwf, Wwf, Wwg, Wwf, Xu, Wwf, Wwf, Wwg, Ur, Uu^Uf, Xu, Xu, Xu, Xu, Xu, Xu, Xu, Xu, Uh, Uh, Uu^Uf, Xu, Xu, Uu^Uf, Xu, Ur, Ur, Ur, Ur, Xu, Uh, Wwg, Xu, Xu, Uu^Uf, Uu^Uf, Ur, Ur, Uu^Uf, Ur, Ur, Ur, Ur, Xu, Ur, Ur, Wwf, Wwf, Xu, Wwf, Wwg, Wwf, Wwg, Xu, Ur, Ur, Re^Vct, Uu, Uu
Xu, Xu, Xu, Xu, Wwf, Wwf, Wwg, Xu, Wwf, Wwg, Wwf, Xu, Wwg, Uu^Uf, Xu, Xu, Xu, Xu, Xu, Xu, Xu, Xu, Xu, Ur, Xu, Uh, Xu, Xu, Xu, Uh, Ur, Ur, Ur, Ur, Ur, Wwg, Uh, Xu, Xu, Xu, Uu^Uf, Ur, Ur, Ur, Ur, Ur, Xu, Xu, Xu, Xu, Uu, Ur, Wwg, Wwf, Wwg, Xu, Wwg, Wwf, Qxu, Ur, Uu, Uu, Xu, Xu
Xu, Xu, Xu, Re^Vct, Wwg, Wwg, Ce, Wwg, Wwg, Wwf, Xu, Wwg, Uu, Uu^Uf, Xu, Xu, Xu, Xu, Xu, Xu, Xu, Xu, Xu, Uu, Uu, Uh, Xu, Xu, Wwg, Uu^Vu, Ur, Ur, Ur, Ur, Ur, Ur, Uu^Uf, Xu, Xu, Xu, Xu, Uu, Xu, Xu, Ur, Xu, Xu, Xu, Xu, Xu, Uu, Ur, Xu, Wwf, Wwg, Wwf, Wwf, Wwg, Qxu, Re^Vct, Xu, Xu, Xu, Xu
Uh, Uh, Uu^Uf, Uu^Uf, Wwf, Ce, 8 Ke, Ce, Wwg, Wwf, Wwg, Wwg, Xu, Xu, Xu, Xu, Xu, Xu, Xu, Xu, Xu, Xu, Xu, Ur, Uu, Xu, Xu, Xu, Wwg, Ur, Ur, Ur, Wwg, Ur, Wwg, Ur, Ur, Uu^Uf, Xu, Xu, Xu, Uu, Ur, Ur, Uu^Uf, Xu, Xu, Xu, Xu, Xu, Uh, Ur, Wwf, Wwg, Wwf, Xu, Wwf, Xu, Qxu, Uu, Xu, Xu, Xu, Xu
Uh, Uh, Uh, Uu^Uf, Wwf, Ce, Ce, Ce, Wwg, Re^Vct, Ur, Uu, Xu, Xu, Xu, Xu, Xu, Xu, Xu, Xu, Xu, Xu, Uu^Uf, Ur, Ur, Xu, Xu, Wwg, Ur, Ur, Ur, Wwg, Ur, Wwg, Ur, Xu, Wwg, Uh, Uu^Uf, Xu, Xu, Uh, Ur, Ur, Uu^Uf, Xu, Xu, Xu, Xu, Xu, Uh, Xu, Wwg, Wwf, Xu, Wwg, Wwf, Qxu, Xu, Xu, Xu, Xu, Xu, Xu
Uh, Uh, Uh, Uu^Uf, Uu^Uf, Wwf, Ur, Wwf, Re^Vct, Ur, Ur, Uu, Xu, Xu, Xu, Xu, Wog, Wog, Wog, Xu, Xu, Xu, Uu, Ur, Ur, Xu, Xu, Uh, Ur, Xu, Ur, Ur, Ur, Cud, Ur, Ur, Wwg, Ur, Uh, Xu, Xu, Uu^Uf, Uu^Uf, Ur, Xu, Xu, Xu, Xu, Xu, Uh, Xu, Wwg, Wwf, Wwf, Wwf, Wwf, Wwg, Uu, Xu, Xu, Xu, Xu, Xu, Xu
Uh, Xu, Xu, Uu^Uf, Uu^Uf, Ur, Ur, Wwf, Wwg, Ur, Ur, Uu, Xu, Xu, Xu, Xu, Wog, Wog, Wog, Xu, Xu, Xu, Uu, Ur, Uh, Xu, Xu, Wwg, Wwg, Ur, Ur, Cud, Cud, Cud, Cud, Cud, Xu, Ur, Uu^Uf, Xu, Xu, Xu, Uh, Ur, Ur, Xu, Xu, Xu, Uh, Uh, Wwg, Wwf, Xu, Wwg, Wwf, Xu, Uu, Uu, Xu, Xu, Xu, Xu, Xu, Xu
Xu, Xu, Xu, Xu, Xu, Uh, Qxu, Qxu, Wwg, Xu, Wwf, Uu, Wwf, Xu, Wwg, Wwg, Xu, Wog, Xu, Xu, Xu, Xu, Ur, Uu, Xu, Xu, Xu, Xu, Wwg, Ur, Wwg, Ur, Cud, 2 Kud, Cud, Ur, Ur, Ur, Uh, Wwg, Xu, Xu, Uu^Uf, Ur, Ur, Xu, Xu, Xu, Uu^Uf, Ur, Wwg, Wwf, Wwf, Wwf, Wwf, Wwg, Wwg, Xu, Wog, Xu, Xu, Xu, Xu, Xu
Xu, Xu, Xu, Xu, Uu, Uh, Wwg, Xu, Wwg, Wwg, Xu, Wwf, Qxu, Wwg, Xu, Xu, Xu, Xu, Xu, Xu, Xu, Xu, Ur, Ur, Ur, Xu, Xu, Xu, Uh, Xu, Wwg, Cud, Ur, Cud, Ur, Cud, Ur, Uh, Xu, Xu, Xu, Uh, Ur, Ur, Ur, Xu, Xu, Uh, Wwf, Wwf, Wwf, Xu, Wwg, Wwg, Wwg, Uu, Xu, Wwg, Wog, Xu, Xu, Xu, Xu, Xu
Xu, Xu, Xu, Xu, Wwf, Wwg, Xu, Wwg, Ur, Ur, Uu, Uu, Xu, Xu, Xu, Xu, Xu, Xu, Xu, Xu, Xu, Uh, Ur, Xu, Ur, Uu^Vu, Xu, Wwg, Ur, Uu^Vu, Ur, Wwg, Ur, Cud, Ur, Ur, Uu^Vu, Uh, Xu, Xu, Uh, Uu^Uf, Ur, Ur, Uu, Ur, Ur, Uh, Wwg, Xu, Wwf, Wwf, Wwf, Xu, Wwf, Uu, Uu^Uf, Xu, Xu, Xu, Xu, Xu, Xu, Xu
Xu, Xu, Wog, Wwg, Uu, Ur, Ur, Ur, Ur, Xu, Xu, Xu, Xu, Xu, Xu, Xu, Xu, Xu, Xu, Xu, Xu, Uh, Uu, Ur, Ur, Xu, Xu, Wwg, Ur, Ur, Xu, Ur, Ur, Ur, Ur, Xu, Wwg, Xu, Uh, Uu^Uf, Ur, Ur, Xu, Xu, Xu, Uu, Uu, Xu, Xu, Wwf, Ur, Wwf, Wwg, Wwf, Wwf, Wwg, Uu^Uf, Xu, Xu, Xu, Xu, Xu, Xu, Xu
Wog, Wog, Xu, Xu, Uu, Ur, Xu, Ur, Ur, Xu, Wwg, Xu, Xu, Xu, Xu, Xu, Wwg, Xu, Xu, Xu, Xu, Xu, Uu, Xu, Ur, Ur, Xu, Wwg, Uh, Ur, Ur, Ur, Ur, Ur, Ur, Ur, Wwg, Xu, Uu^Uf, Ur, Ur, Xu, Xu, Xu, Xu, Uu, Uu, Uh, Uh, Xu, Uu^Uf, Ur, Wwf, Xu, Wwg, Wwf, Uh, Xu, Xu, Xu, Xu, Xu, Xu, Xu
Wog, Xu, Xu, Xu, Uu, Ur, Ur, Xu, Ur, Uu^Uf, Xu, Wwg, Xu, Xu, Uu, Uu, Wwg, Xu, Xu, Xu, Xu, Xu, Uu, Ur, Ur, Ur, Xu, Xu, Xu, Uu^Vu, Wwg, Ur, Ur, Cud, Ur, Uh, Xu, Xu, Uu^Uf, Ur, Ur, Xu, Xu, Xu, Xu, Uu^Uf, Uu, Uh, Xu, Xu, Uh, Ur, Qxu, Wwg, Qxu, Qxu, Xu, Uh, Uh, Xu, Xu, Xu, Xu, Xu
Wog, Xu, Xu, Xu, Uu, Ur, Ur, Ur, Ur, Uu, Uu, Uu^Uf, Uu, Uu, Ur, Ur, Ur, Wwg, Xu, Xu, Xu, Xu, Xu, Uu, Xu, Ur, Uu^Uf, Xu, Xu, Xu, Xu, Cud, Ur, Ur, Ur, Cud, Wwg, Wwg, Ur, Ur, Ur, Xu, Xu, Xu, Xu, Xu, Uu, Uu, Uu^Vu, Uu, Ur, Ur, Ur, Qxu, Xu, Uu^Uf, Xu, Uu^Uf, Uh, Uh, Xu, Xu, Xu, Xu
Wog, Xu, Xu, Uu^Vu, Uu, Xu, Ur, Ur, Ur, Xu, Ur, Ur, Xu, Ur, Ur, Ur, Ur, Ur, Ur, Xu, Xu, Xu, Xu, Uu, Ur, Ur, Uu^Uf, Xu, Xu, Xu, Xu, Wwg, Ur, Ur, Ur, Ur, Ur, Ur, Ur, Ur, Ur, Xu, Xu, Xu, Xu, Xu, Uu, Ur, Ur, Ur, Xu, Ur, Ur, Xu, Uu^Uf, Xu, Uh, Uh, Xu, Xu, Xu, Xu, Xu, Xu
Wog, Xu, Xu, Uh, Uu, Uu, Ur, Xu, Ur, Ur, Xu, Ur, Ur, Ur, Ur, Xu, Xu, Ur, Ur, Ur, Ur, Wwg, Uu, Uu, Ur, Ur, Ur, Xu, Xu, Xu, Uh, Uh, Ur, Ur, Uh, Ur, Ur, Ur, Uh, Ur, Ur, Xu, Uh, Uu^Uf, Uu^Uf, Uu, Ur, Ur, Ur, Ur, Xu, Ur, Ur, Ur, Ur, Uu^Uf, Xu, Xu, Xu, Xu, Xu, Xu, Xu, Xu
Xu, Wog, Wwg, Uh, Uh, Xu, Uu, Ur, Ur, Uu, Xu, Uu, Xu, Xu, Ur, Ur, Ur, Ur, Ur, Xu, Ur, Ur, Ur, Ur, Ur, Ur, Ur, Ur, Uu^Uf, Uu^Uf, Ur, Ur, Ur, Uu^Uf, Uu^Uf, Uu^Uf, Ur, Xu, Xu, Uh, Ur, Ur, Ur, Ur, Ur, Ur, Ur, Ur, Xu, Xu, Uu^Uf, Ur, Xu, Ur, Ur, Uu^Uf, Xu, Xu, Xu, Xu, Xu, Xu, Xu, Xu
Xu, Xu, Xu, Wwg, Wwg, Uu, Uu, Xu, Ur, Xu, Xu, Uu, Xu, Xu, Uu, Ur, Ur, Xu, Ur, Ur, Xu, Ur, Ur, Ur, Ur, Xu, Xu, Ur, Ur, Ur, Xu, Ur, Ur, Ur, Ur, Ur, Ur, Xu, Xu, Xu, Xu, Ur, Ur, Xu, Xu, Uu^Uf, Uu^Uf, Ur, Xu, Uu^Uf, Ur, Ur, Xu, Ur, Ur, Uu, Xu, Xu, Xu, Xu, Xu, Xu, Xu, Xu
Xu, Xu, Xu, Xu, Wwg, Uu, Xu, Ur, Ur, Uu^Uf, Ur, Ur, Uu, Uu, Uu, Xu, Ur, Ur, Ur, Xu, Wwg, Xu, Ur, Ur, Ur, Ur, Xu, Uh, Ur, Ur, Uu, Uu, Xu, Xu, Xu, Ur, Ur, Uu^Vu, Uh, Xu, Xu, Uu^Uf, Ur, Ur, Uu^Uf, Xu, Ur, Ur, Ur, Ur, Uu^Uf, Xu, Uu^Uf, Ur, Uu, Uu, Xu, Xu, Xu, Xu, Xu, Xu, Xu, Xu
Xu, Xu, Xu, Xu, Xu, Uu, Ur, Ur, Ur, Ur, Ur, Ur, Xu, Xu, Uu, Ur, Xu, Xu, Ur, Uu, Uu, Uu, Ur, Ur, Ur, Ur, Xu, Uh, Ur, Ur, Uh, Xu, Xu, Xu, Xu, Xu, Uh, Ur, Ur, Xu, Ur, Uu^Vu, Ur, Ur, Uu^Uf, Xu, Ur, Ur, Uu^Uf, Uu^Uf, Xu, Xu, Uu^Uf, Ur, Uu, Xu, Xu, Xu, Xu, Xu, Xu, Xu, Xu, Xu
Xu, Xu, Xu, Xu, Xu, Uh, Uu^Uf, Ur, Ur, Xu, Ur, Ur, Ur, Xu, Uu, Xu, Ur, Ur, Uu, Uu, Xu, Uu, Uu, Ur, Ur, Xu, Ur, Ur, Ur, Ur, Xu, Xu, Xu, Xu, Xu, Xu, Xu, Uh, Ur, Ur, Ur, Ur, Ur, Ur, Xu, Xu, Ur, Ur, Ur, Xu, Xu, Uu^Uf, Ur, Ur, Uu^Vu, Xu, Xu, Xu, Xu, Xu, Xu, Xu, Xu, Xu
Xu, Xu, Xu, Xu, Xu, Xu, Uh, Ur, Ur, Ur, Ur, Ur, Xu, Ur, Ur, Ur, Uu, Uu, Xu, Xu, Xu, Xu, Uu, Ur, Ur, Ur, Ur, Ur, Xu, Xu, Xu, Xu, Xu, Xu, Xu, Xu, Xu, Uu, Ur, Ur, Xu, Xu, Xu, Ur, Ur, Ur, Ur, Ur, Ur, Ur, Ur, Ur, Xu, Ur, Ur, Uu, Wwg, Xu, Xu, Xu, Xu, Xu, Xu, Xu
Xu, Xu, Xu, Xu, Xu, Xu, Xu, Uu^Vu, Ur, Xu, Ur, Ur, Ur, Ur, Xu, Ur, Uu, Xu, Xu, Xu, Xu, Xu, Uu, Ur, Ur, Ur, Uu^Uf, Xu, Xu, Xu, Xu, Xu, Xu, Xu, Xu, Xu, Xu, Ur, Ur, Uu^Uf, Xu, Xu, Xu, Xu, Uu, Ur, Xu, Xu, Xu, Ur, Ur, Ur, Ur, Ur, Ur, Ur, Uu, Xu, Xu, Xu, Xu, Xu, Xu, Xu
Xu, Xu, Xu, Xu, Xu, Xu, Xu, Uh, Ur, Xu, Ur, Ur, Ur, Ur, Xu, Xu, Uu, Xu, Xu, Xu, Xu, Xu, Uu, Xu, Ur, Ur, Xu, Xu, Xu, Xu, Wog, Xu, Xu, Xu, Xu, Xu, Uu^Vu, Ur, Ur, Xu, Xu, Xu, Xu, Xu, Uu, Ur, Uu, Xu, Xu, Xu, Uh, Ur, Xu, Ur, Ur, Xu, Ur, Uu, Uu, Xu, Xu, Xu, Xu, Xu
Xu, Xu, Xu, Xu, Xu, Xu, Xu, Uh, Ur, Ur, Xu, Ur, Ur, Ur, Ur, Ur, Ur, Uu^Uf, Xu, Xu, Xu, Xu, Uu, Ur, Ur, Ur, Xu, Xu, Wwg, Wog, Wog, Xu, Xu, Xu, Xu, Wwg, Ur, Ur, Ur, Xu, Xu, Xu, Xu, Xu, Uu, Ur, Ur, Uu^Vu, Xu, Xu, Uh, Ur, Ur, Ur, Ur, Ur, Ur, Ur, Uh, Xu, Xu, Xu, Xu, Xu
Xu, Xu, Xu, Xu, Xu, Wog, Wwg, Uu^Vu, Ur, Ur, Ur, Xu, Ur, Ur, Ur, Ur, Ur, Uh, Xu, Xu, Xu, Xu, Uu, Ur, Ur, Ur, Ur, Wwg, Wwg, Xu, Xu, Xu, Xu, Xu, Xu, Uu, Xu, Ur, Xu, Xu, Xu, Xu, Xu, Xu, Wwg, Ur, Ur, Uu, Xu, Xu, Xu, Uh, Ur, Ur, Ur, Ur, Ur, Uu^Uf, Uh, Xu, Xu, Xu, Xu, Xu
Xu, Xu, Xu, Xu, Uh, Wwg, Xu, Ur, Ur, Ur, Ce, Ur, Ur, Xu, Uu^Vu, Ur, Ur, Uh, Xu, Xu, Xu, Xu, Uu, Ur, Ur, Ur, Xu, Xu, Uu, Xu, Xu, Xu, Xu, Xu, Xu, Uu, Ur, Ur, Xu, Xu, Xu, Xu, Xu, Xu, Xu, Uu, Ur, Uu, Wwg, Xu, Xu, Xu, Ur, Xu, Ur, Ur, Uu^Uf, Uh, Xu, Xu, Xu, Xu, Xu, Xu
Xu, Xu, Xu, Xu, Uh, Ur, Ur, Ur, Ur, Ce, 4 Ke, Ce, Ur, Ur, Uu, Ur, Uu^Uf, Uu^Uf, Xu, Xu, Xu, Xu, Uu, Ur, Ur, Xu, Ur, Uu, Xu, Xu, Xu, Xu, Xu, Xu, Xu, Xu, Ur, Ur, Xu, Wog, Wog, Xu, Xu, Xu, Uu, Uu, Ur, Ur, Ur, Xu, Xu, Uu^Vu, Ur, Ur, Uh, Uu^Uf, Uu^Uf, Xu, Xu, Xu, Xu, Xu, Xu, Xu
Xu, Xu, Xu, Uh, Ur, Ur, Ur, Ur, Ur, Ce, Ce, Ce, Ur, Xu, Uu, Uu, Uh, Xu, Xu, Xu, Xu, Xu, Uu, Ur, Ur, Xu, Ur, Xu, Xu, Xu, Xu, Xu, Xu, Xu, Xu, Xu, Ur, Ur, Uu, Xu, Wwg, Wwg, Ur, Uu^Vu, Ur, Ur, Uu^Uf, Uu^Uf, Ur, Ur, Ur, Ur, Ur, Uh, Xu, Xu, Xu, Xu, Xu, Xu, Xu, Xu, Xu, Xu
Xu, Xu, Uu^Uf, Uu, Uu, Ur, Xu, Xu, Ur, Ur, Ur, Ur, Uu^Vu, Xu, Uu, Uu, Uh, Xu, Xu, Xu, Xu, Wwg, Uu^Uf, Ur, Ur, Xu, Ur, Ur, Ur, Xu, Xu, Xu, Xu, Xu, Xu, Xu, Ur, Ur, Uu, Xu, Xu, Uu, Uu, Ur, Ur, Ur, Xu, Xu, Xu, Ur, Ce, Ur, Uu, Uh, Xu, Xu, Xu, Xu, Xu, Xu, Xu, Xu, Xu, Xu
Xu, Xu, Uu^Uf, Uu, Xu, Uu, Xu, Uu^Vu, Ur, Ur, Ur, Ur, Xu, Uu, Uu, Uh, Xu, Xu, Xu, Xu, Xu, Wwg, Uu, Ur, Ur, Ur, Ur, Ur, Ur, Xu, Xu, Xu, Xu, Xu, Ur, Ur, Ur, Xu, Xu, Uu, Uu, Uu, Xu, Uu, Uu, Ur, Ur, Uu^Uf, Ur, Ce, 5 Ke, Ce, Uu, Xu, Xu, Xu, Xu, Xu, Xu, Xu, Xu, Xu, Xu, Xu
Xu, Uu^Uf, Uu, Uu, Uu, Uu, Ur, Ur, Ur, Ur, Ur, Ur, Uu, Xu, Uu^Uf, Uu^Uf, Xu, Xu, Xu, Xu, Xu, Xu, Uu, Ur, Ur, Ur, Xu, Ur, Ur, Xu, Xu, Xu, Xu, Uu^Uf, Ur, Xu, Ur, Ur, Xu, Uu, Xu, Xu, Xu, Xu, Xu, Uu, Uu, Ur, Ur, Ce, Ce, Ce, Xu, Uu, Uu^Vu, Xu, Xu, Xu, Xu, Xu, Xu, Xu, Xu, Xu
Xu, Xu, Uu, Uu, Uu, Uu, Ur, Ur, Ur, Ur, Ur, Ur, Ur, Xu, Uu^Uf, Uu^Uf, Xu, Xu, Xu, Xu, Xu, Xu, Uu, Xu, Ur, Ur, Ur, Ur, Ur, Uu^Uf, Uu^Uf, Xu, Uu^Uf, Uu^Uf, Ur, Ur, Uu^Uf, Wwg, Xu, Xu, Xu, Xu, Xu, Xu, Xu, Xu, Xu, Uu^Vu, Uu, Xu, Ur, Ur, Ur, Uu, Xu, Uu, Uh, Xu, Xu, Xu, Xu, Xu, Xu, Xu
Xu, Uh, Uh, Uu, Xu, Ur, Ur, Ur, Ur, Ur, Xu, Ur, Ur, Uu, Uh, Xu, Xu, Xu, Xu, Xu, Xu, Xu, Uu, Ur, Ur, Ur, Ur, Xu, Ce, Ur, Ce, Xu, Ur, Xu, Ur, Ur, Uu^Uf, Xu, Xu, Xu, Xu, Xu, Xu, Xu, Xu, Xu, Xu, Uh, Uh, Uu, Ur, Ur, Ur, Ur, Uu, Uu, Uu^Uf, Uh, Xu, Xu, Xu, Xu, Xu, Xu
Xu, Uh, Uu^Uf, Uh, Xu, Ur, Ur, Ur, Ur, Ur, Uu, Uu, Uu, Uh, Xu, Xu, Xu, Xu, Xu, Xu, Xu, Xu, Uu, Xu, Ur, Ur, Ur, Ce, Re^Vct, Ce, Re^Vct, Ce, Ur, Ur, Ur, Xu, Uu, Xu, Xu, Xu, Xu, Xu, Xu, Xu, Xu, Xu, Xu, Xu, Uh, Uu, Xu, Ur, Ur, Ur, Ur, Xu, Uu^Uf, Uh, Xu, Xu, Xu, Xu, Xu, Xu
Uh, Uu^Uf, Uu^Uf, Xu, Uu^Uf, Ur, Ur, Ur, Xu, Ur, Uh, Uh, Xu, Xu, Xu, Xu, Xu, Xu, Xu, Xu, Xu, Xu, Uh, Uh, Uu, Xu, Ce, Ce, Ce, Ce, Ce, Ce, Ce, Ur, Xu, Xu, Uu, Xu, Xu, Xu, Xu, Xu, Xu, Xu, Xu, Xu, Xu, Xu, Xu, Uu, Ur, Ur, Ur, Ur, Ur, Xu, Xu, Uu^Uf, Xu, Xu, Xu, Xu, Xu, Xu
Uh, Uu^Uf, Xu, Xu, Ur, Ur, Ur, Ur, Ur, Uu^Uf, Uu^Uf, Xu, Xu, Xu, Xu, Xu, Xu, Xu, Xu, Xu, Xu, Xu, Uu^Uf, Uh, Uu, Xu, Ce, Re^Vct, Ce, Ke, Ce, Re^Vct, Ce, Ur, Ur, Ur, Uu, Xu, Xu, Xu, Xu, Xu, Xu, Xu, Xu, Xu, Xu, Xu, Uu^Uf, Uu, Xu, Ur, Ur, Ur, Ur, Uu^Uf, Xu, Uu, Xu, Xu, Xu, Xu, Xu, Xu
Uh, Uu^Uf, Xu, Uu^Uf, Ur, Ur, Xu, Ur, Ur, Uu^Uf, Uh, Uu^Uf, Xu, Xu, Xu, Xu, Xu, Xu, Xu, Xu, Xu, Xu, Uu^Uf, Uh, Xu, Ur, Ur, Ce, Re^Vct, Ce, Re^Vct, Ce, Ur, Ur, Ur, Uu, Uh, Uu^Uf, Xu, Xu, Xu, Xu, Xu, Xu, Xu, Xu, Xu, Uu^Uf, Uu^Uf, Uu, Uh, Xu, Ur, Ur, Ur, Xu, Xu, Uu, Xu, Xu, Xu, Xu, Xu, Xu
Xu, Uh, Uu, Ur, Ur, Xu, Uu^Uf, Ur, Xu, Ur, Uh, Xu, Xu, Xu, Xu, Xu, Xu, Xu, Xu, Xu, Xu, Xu, Xu, Uh, Uu, Ur, Ur, Ce, Ce, Ce, Ce, Ce, Xu, Xu, Xu, Uu, Uh, Xu, Xu, Xu, Xu, Xu, Xu, Xu, Xu, Xu, Xu, Xu, Uu^Uf, Uu, Uu, Xu, Ur, Ur, Ur, Xu, Ur, Uu, Xu, Xu, Xu, Xu, Xu, Xu
Xu, Wwg, Uu, Ur, Ur, Xu, Ur, Ur, Xu, Uu, Xu, Xu, Xu, Xu, Xu, Xu, Xu, Xu, Xu, Xu, Xu, Xu, Xu, Uu, Uh, Xu, Uu, Ur, Ur, Ur, Ur, Ur, Ur, Ur, Ur, Ur, Wwg, Xu, Xu, Xu, Xu, Xu, Xu, Xu, Xu, Xu, Xu, Xu, Xu, Uu^Uf, Uu, Xu, Ur, Ur, Ur, Ur, Uu, Uu, Xu, Xu, Xu, Xu, Xu, Xu
Xu, Xu, Uu, Ur, Ur, Ur, Ur, Ur, Uu, Uu, Xu, Xu, Xu, Xu, Xu, Xu, Xu, Xu, Xu, Xu, Xu, Xu, Xu, Xu, Uh, Uu, Uu, Xu, Xu, Ur, Ur, Ur, Ur, Ur, Ur, Uu, Xu, Xu, Xu, Xu, Xu, Xu, Xu, Xu, Xu, Xu, Xu, Xu, Xu, Uh, Uh, Ur, Ur, Ur, Ur, Ur, Uu, Uu, Xu, Xu, Xu, Xu, Xu, Xu
Xu, Uh, Uh, Uu, Ur, Xu, Ur, Ur, Uu, Xu, Xu, Xu, Xu, Xu, Xu, Xu, Xu, Xu, Xu, Xu, Xu, Xu, Xu, Xu, Ur, Uh, Uu, Xu, Ur, Ur, Ur, Ur, Ur, Xu, Ur, Uu, Xu, Xu, Xu, Xu, Xu, Xu, Xu, Xu, Xu, Xu, Xu, Xu, Xu, Xu, Xu, Uu, Uu, Ur, Ur, Ur, Ur, Uu, Ur, Xu, Xu, Xu, Xu, Xu
