Md, Md, Md, Md, Md, Md, Md, Md, Md, Md, Md, Md, Md, Md, Md, Md, Md, Md, Md, Md, Md, Md, Md, Md, Md, Md, Hd, Hd, Dd, Dd, Hd, Hd, Md, Md, Md, Md, Md^Xm, Md, Md, Md^Xm, Md^Xm, Md, Md^Xm, Md, Hd, Hd, Hd, Hd, Hd, Hd, Md, Md, Md, Md, Md, Md^Xm, Md^Xm, Md^Xm, Md, Md, Md^Xm, Hd, Md, Md, Md^Xm, Md^Xm, Md, Md, Md, Md, Md, Md, Md^Xm, Md^Xm, Md^Xm, Md^Xm, Md, Md, Hd, Hd, Hd, Hd, Dd, Dd, Dd
Md, Md, Md, Md, Md, Md, Md, Md, Md, Md, Md, Md, Md, Md, Md, Md, Md, Md, Md, Md, Md, Md, Md, Md, Md, Md, Hd, Hd, Dd, Dd, Dd, Hd, Md, Md^Xm, Md^Xm, Md, Md, Md, Md, Md, Md^Xm, Md^Xm, Md, Md, Hd, Hd, Hd, Hd, Hd, Hd, Md, Md, Md, Md, Md, Md, Md, Md^Xm, Md^Xm, Md^Xm, Md, Md^Xm, Md^Xm, Md^Xm, Md^Xm, Md, Md^Xm, Md^Xm, Md^Xm, Md^Xm, Md^Xm, Md^Xm, Md, Md, Md, Md, Hd, Hd, Hd, Hd, Hd, Hd, Dd^Esd, Dd^Esd, Dd
Md, Md, Md, Md, Md, Md, Md, Md, Md, Md, Md, Md, Md, Md, Md, Md, Md, Md, Md, Md, Md, Md, Md, Md, Md, Md, Hd, Hd, Dd, Dd, Dd, Hd, Hd, Md, Md, Md^Xm, Md, Md, Md, Md, Md, Md, Hd, Hd, Dd, Dd, Dd, Dd, Hd, Md, Md, Md, Hd, Hd, Hd, Md, Hd, Md, Md, Md, Md, Md, Md, Md, Md, Md^Xm, Md, Md, Md, Md, Md, Md, Hd, Hd, Hd, Hd, Hd, Hd, Hd, Hd, Dd, Dd, Dd, Dd^Esd, Dd
Md, Md, Md, Md, Md, Md, Md, Md, Md, Md, Md, Md, Md, Md, Md, Md, Md, Md, Md, Md, Md, Md, Md, Md, Md, Md, Hd, Hd, Dd, Dd, Dd, Dd, Hd, Md, Hd, Md, Hd, Hd, Hd, Hd, Hd, Hd, Dd, Dd, Dd, Dd, Dd, Dd, Hd, Md, Hd, Hd, Hd, Hd, Hd, Hd, Hd, Hd, Hd, Hd, Hd, Md, Hd, Hd, Hd, Md, Hd, Hd, Hd, Hd, Hd, Hd, Hd, Hd, Hd, Hd, Hd, Hd, Hd, Dd, Dd^Esd, Dd^Esd, Dd, Dd, Dd
Md, Md, Md, Md, Md, Md, Md, Md, Md, Md, Md, Md, Md, Md, Md, Md, Md, Md, Md, Md, Md, Md, Md, Md, Hd, Hd, Hd, Dd, Dd, Dd^Esd, Dd, Dd, Hd, Hd, Hd, Hd, Hd, Hd, Hd, Hd, Dd, Dd, Dd, Dd, Dd, Dd, Dd, Dd, Dd, Hd, Dd, Hd, Dd, Dd, Hd, Hd, Dd, Hd, Hd, Hd, Hd, Hd, Hd, Hd, Hd, Hd, Hd, Hd, Hd, Hd, Hd, Hd, Hd, Hd, Hd, Hd, Dd, Dd, Dd, Dd, Dd^Esd, Dd, Dd, Dd, Dd
Md, Md, Md, Md, Md, Md, Md, Md, Md, Md, Md, Md, Md, Md, Md, Md, Md, Md, Md, Md, Md, Md, Hd, Hd, Hd, Hd, Dd, Dd, Dd, Dd, Dd, Dd, Dd, Hd, Hd, Hd, Hd, Hd, Dd, Dd, Dd, Dd, Md, Md, Md, Dd, Md, Dd, Dd, Dd, Dd, Dd^Ftd, Md, Md, Hd, Hd, Dd, Dd, Hd, Hd, Hd, Hd, Hd, Hd, Hd, Hd, Hd, Hd, Hd, Hd, Hd, Hd, Hd, Hd, Dd, Dd, Dd, Dd, Dd, Dd^Esd, Dd, Dd, Dd, Dd, Dd
Md, Md, Md, Md, Md, Md, Md, Md, Md, Md, Md, Md, Md, Md, Md, Md, Hd^Ftd, Hd^Ftd, Hd^Ftd, Md, Hd^Ftd, Hd^Ftd, Hd, Hd, Dd, Dd, Dd^Esd, Dd, Dd^Esd, Dd^Esd, Dd, Dd, Dd, Dd, Hd, Hd, Hd, Hd, Hd, Hd, Hd, Md, Md^Xm, Md, Md, Md, Md, Dd^Ftd, Dd, Dd, Dd, Dd^Ftd, Md, Md, Md, Hd, Hd, Dd, Dd, Hd, Hd, Hd, Dd, Hd, Dd, Hd, Dd, Dd, Dd, Dd, Dd, Hd, Dd, Dd, Dd^Esd, Dd, Dd, Dd^Esd, Dd, Dd, Dd, Hd, Hd, Hd, Hd
Md, Md, Md, Md, Md, Md, Md, Md, Md, Md, Md, Md, Md, Md, Md, Md, Hd^Ftd, Hd^Ftd, Hd, Hd^Ftd, Hd^Ftd, Hd^Ftd, Hd, Dd, Dd, Dd, Dd, Dd, Dd, Dd^Esd, Dd^Esd, Dd, Dd, Dd^Edp, Dd, Hd, Hd, Hd, Hd, Hd, Hd, Md, Md, Md, Md, Md^Xm, Md, Md, Hd, Dd, Dd, Md, Md, Md, Hd, Hd, Dd, Dd, Dd^Esd, Dd, Dd, Dd, Dd, Dd, Dd^Esd, Dd, Dd, Dd, Dd, Dd, Dd, Dd, Dd^Esd, Dd^Esd, Dd^Esd, Dd^Esd, Dd, Dd, Hd, Dd, Hd, Hd, Hd, Hd, Dd
Md, Md, Md, Md, Md, Md, Md, Md, Md, Md, Hd^Ftd, Md, Hd^Ftd, Md, Hd^Ftd, Hd^Ftd, Hd, Hd, Dd, Hd, Hd, Hd, Dd, Dd, Dd, Dd, Dd^Esd, Dd^Esd, Dd, Dd, Dd, Dd^Esd, Dd, Dd^Esd, Dd, Hd, Dd, Dd, Dd, Hd, Hd, Hd, Hd, Md, Md, Md, Md, Md, Hd, Dd, Dd, Dd, Hd, Hd, Hd, Hd, Dd, Dd, Dd^Esd, Dd^Esd, Dd^Esd, Dd^Vdt, Dd^Esd, Dd^Esd, Dd^Esd, Dd, Dd^Esd, Dd^Esd, Dd^Esd, Dd, Dd, Dd^Esd, Dd, Dd, Dd, Dd^Esd, Dd, Hd, Hd, Hd, Hd, Dd, Hd, Hd, Ds
Md, Md, Md, Md, Md, Md, Md, Hd, Hd, Hd, Hd, Hd^Ftd, Hd, Hd^Ftd, Hd, Hd, Hd, Dd, Dd, Dd, Dd, Dd, Dd, Dd, Dd, Dd, Dd^Esd, Dd, Dd, Dd, Dd, Dd^Esd, Dd^Esd, Dd, Dd, Dd, Dd, Dd, Dd, Dd, Dd, Hd, Hd, Hd, Hd, Hd, Hd, Hd, Hd, Hd, Hd, Hd, Hd, Hd, Dd, Dd, Dd^Esd, Dd, Rd, Dd, Rd, Dd, Dd, Dd^Esd, Dd^Esd, Dd^Esd, Dd^Vdt, Dd^Esd, Dd, Dd^Esd, Dd, Dd, Hd, Dd, Hd, Dd, Hd, Hd, Hd, Hd, Hd, Hd, Ds, Hd, Ds
Md, Md, Md, Md, Md, Md, Hd^Ftd, Hd^Ftd, Hd, Hd, Hd, Hd, Dd, Hd, Hd, Dd, Dd, Dd, Dd, Dd^Esd, Dd, Dd^Esd, Dd^Esd, Dd^Esd, Dd, Dd^Esd, Dd, Dd, Dd, Dd, Dd, Dd^Esd, Dd, Dd, Dd, Dd, Dd, Dd, Dd^Vdt, Dd, Dd^Esd, Hd, Ce, Hd, Ce, Hd, Hd, Hd, Hd, Hd, Hd, Hd, Dd, Dd, Dd, Dd^Esd, Dd^Esd, Dd^Esd, Dd^Esd, Rd, Dd, Dd, Ce, Dd^Esd, Dd^Esd, Dd^Esd, Dd^Esd, Dd, Dd, Dd, Dd, Dd, Hd, Hd, Hd, Hd, Hd, Hd, Hd, Hd, Ds, Ds, Ds, Ds, Wwt
Md, Md, Md, Md, Md, Hd^Ftd, Hd, Hd, Hd, Dd, Dd, Dd, Dd, Dd, Dd, Dd, Dd^Esd, Dd, Dd, Dd, Dd^Esd, Dd^Esd, Dd^Esd, Dd, Dd, Dd, Hd, Dd, Hd, Hd, Hd, Hd, Dd, Dd, Dd, Dd^Esd, Dd, Dd^Esd, Dd, Dd, Dd, Ce, Ce, Ce, Ce, Ce, Dd, Dd^Vdt, Dd, Dd, Dd, Dd, Dd^Esd, Dd^Esd, Dd^Esd, Dd, Rd, Dd, Dd, Dd^Esd, Ce, Dd^Vdt, Ce, Dd^Vdt, Ce, Dd^Esd, Dd, Dd, Hd, Hd, Dd, Hd, Hd, Hd, Ds, Ds, Ds, Hd, Ds, Ds, Wwt, Wwt, Wwt, Wwt, Wwt
Md, Md, Md, Hd, Hd, Hd, Dd, Hd, Dd, Dd, Dd, Dd, Dd^Esd, Dd, Dd, Dd^Esd, Dd^Esd, Dd^Esd, Dd^Esd, Dd^Vdt, Dd, Dd^Esd, Dd, Dd^Vdt, Dd, Dd, Hd, Hd, Hd, Hd, Hd, Hd, Hd, Dd, Dd, Dd^Esd, Dd, Dd, Dd^Esd, Dd, Dd, Dd, Ce, Ke, Ce, Dd, Dd^Esd, Dd, Dd, Dd, Dd, Dd, Dd^Esd, Dd^Esd, Dd, Dd, Rd, Dd, Dd^Esd, Dd^Esd, Dd^Vdt, Ce, 7 Ke, Ce, Dd^Vdt, Dd^Esd, Dd, Dd, Hd, Hd, Hd, Hd, Hd, Dd, Ds, Wwt, Wwt, Ds, Wwt, Wwt, Wwt, Wwt, Wwrt, Wwt, Wwrt
Md, Md, Hd^Ftd, Hd, Hd, Hd, Dd, Dd, Dd^Esd, Dd, Dd^Esd, Dd^Esd, Dd, Dd^Esd, Dd, Dd^Esd, Dd^Esd, Dd^Esd, Dd, Dd^Esd, Dd, Dd^Esd, Dd^Esd, Dd, Dd, Dd, Hd, Hd, Hd, Hd, Hd, Hd, Hd, Dd, Dd^Esd, Dd, Dd^Esd, Dd, Dd^Vdt, Dd^Esd, Dd, Ce, Ce, Ce, 1 Ce, Ce, Dd^Esd, Dd, Dd^Vdt, Dd, Dd, Dd, Dd, Dd, Rd, Rd, Dd, Dd, Dd^Esd, Dd, Ce, Ce, Ce, Ce, Ce, Dd^Esd, Dd, Dd, Hd, Hd, Hd, Hd, Hd, Ds, Wwt, Wwt, Wwt, Wwt, Wwrt, Wwrt, Wwrt, Wwt, Wwt, Wwrt, Wwt
Md, Md, Hd^Ftd, Hd^Ftd, Dd, Dd, Dd, Dd, Dd^Esd, Dd^Esd, Dd^Esd, Dd, Dd, Dd, Dd, Dd, Hd, Dd, Hd, Hd, Hd, Dd^Esd, Dd^Esd, Dd^Esd, Dd, Hd, Hd, Hd, Hd, Hd, Dd, Hd, Dd, Hd, Dd^Esd, Dd, Dd, Dd^Esd, Dd, Dd^Esd, Dd, Dd, Dd^Esd, Dd^Esd, Dd, Dd, Dd^Esd, Dd, Dd, Dd, Dd, Dd, Dd, Rd, Dd, Dd, Dd^Esd, Dd^Vdt, Dd, Dd^Esd, Dd, Dd^Vdt, Ce, Dd^Vdt, Dd^Esd, Dd, Dd, Hd, Hd, Hd, Hd, Hd, Ds, Ds, Wwt, Wwt, Wwt, Wwt, Wwt, Wwt, Wwt, Wwt, Wwt, Wwt, Wot
Md, Hd^Ftd, Hd^Ftd, Hd, Dd, Dd, Dd, Dd^Esd, Dd^Esd, Dd, Dd^Esd, Dd^Esd, Dd^Esd, Dd, Dd, Hd, Hd, Hd, Hd, Hd, Ce, Ce, Ce, Ce, Ce, Dd, Dd, Hd, Dd, Dd, Dd^Esd, Dd, Dd, Dd, Dd^Esd, Dd, Dd, Dd^Esd, Dd^Esd, Dd, Dd, Dd, Dd^Esd, Dd^Vdt, Dd^Esd, Dd^Esd, Dd, Dd^Esd, Dd^Esd, Dd, Rd, Rd, Dd, Dd^Esd, Dd^Esd, Dd^Esd, Dd^Esd, Dd^Esd, Hd, Dd, Hd, Dd, Dd^Esd, Dd, Dd, Dd, Hd, Hd, Hd, Ds, Ds, Ds, Ds, Wwt, Wwt, Wwt, Wwrt, Wwrt, Wot, Wot, Wot, Wot, Wot, Wot, Wot
Md, Hd^Ftd, Hd, Hd, Dd, Dd^Esd, Dd, Dd, Dd, Dd, Dd, Dd^Esd, Dd^Esd, Dd, Dd, Hd, Hd, Hd, Dd^Vdt, Hd, Dd^Esd, Ce, 2 Ke, Ce, Dd^Esd, Dd, Dd, Dd^Vdt, Dd^Esd, Dd^Esd, Dd^Esd, Dd^Esd, Dd^Esd, Dd^Esd, Dd, Dd, Dd, Dd^Esd, Dd, Dd, Dd, Dd^Vdt, Dd, Dd^Esd, Dd^Esd, Dd, Dd, Dd, Rd, Dd^Esd, Dd, Dd, Dd^Esd, Dd^Esd, Dd, Dd^Esd, Dd, Hd, Hd, Hd, Hd, Dd, Dd^Esd, Dd, Hd, Hd, Hd, Hd, Ds, Ds, Wwg, Wwt, Wwt, Wwt, Wwt, Wwt, Wwrt, Wwt, Wot, Wot, Wot, Wot, Wot, Wot, Wot
Hd, Hd, Hd, Dd, Dd^Esd, Dd^Esd, Hd, Dd, Dd, Dd, Dd, Dd^Esd, Dd, Dd, Hd, Hd, Hd, Hd, Hd, Dd, Ce, Ce, Ce, Ce, Ce, Dd, Dd^Esd, Dd, Dd^Esd, Dd^Esd, Dd^Esd, Dd^Esd, Dd, Dd^Esd, Dd, Dd, Dd, Dd, Dd^Esd, Dd, Dd, Dd, Dd^Esd, Dd, Dd, Dd^Esd, Dd, Dd, Rd, Dd, Dd, Dd, Dd, Dd, Dd, Dd, Hd, Hd, Hd, Hd, Hd, Dd^Esd, Dd, Dd^Vdt, Hd, Hd, Hd, Ds, Ds, Wwg, Wwt, Wwt, Wwt, Wwt, Wwrt, Wwrt, Wot, Wot, Wot, Wot, Wot, Wot, Wot, Wot, Wot
Hd, Hd, Dd, Dd, Dd^Esd, Hd, Hd, Hd, Dd, Dd, Dd, Dd^Esd, Dd, Dd, Hd, Hd, Hd, Hd, Hd, Dd, Dd, Ce, Dd, Ce, Dd^Esd, Dd, Dd^Esd, Dd^Esd, Dd, Dd, Rd, Dd, Rd, Dd^Esd, Dd, Rd, Rd, Dd^Esd, Dd, Dd, Dd, Dd^Esd, Dd, Dd^Esd, Dd^Esd, Dd, Dd, Rd, Dd, Dd, Dd^Esd, Dd^Esd, Dd^Esd, Dd^Esd, Dd^Esd, Dd, Dd, Dd, Hd, Hd, Hd, Dd, Dd, Hd, Hd, Hd, Hd, Hd, Ds, Wwg, Wwg, Wwt, Wwt, Wwt, Wot, Wot, Wot, Wot, Wot, Wot, Wot, Wot, Wot, Wot, Wot
Dd, Hd, Dd^Esd, Dd^Esd, Dd, Hd, Hd, Hd, Dd, Dd, Dd, Dd^Esd, Dd, Dd, Hd, Hd, Hd, Hd, Dd, Dd, Dd, Dd^Esd, Dd^Esd, Dd, Dd^Esd, Dd^Esd, Dd^Esd, Dd, Dd, Dd^Esd, Dd, Dd, Dd, Rd, Dd, Dd, Dd, Rd, Dd^Esd, Dd^Esd, Dd^Esd, Dd, Dd, Dd, Dd, Dd^Esd, Rd, Dd^Esd, Dd, Dd, Dd^Esd, Dd, Dd^Esd, Dd, Dd^Esd, Dd, Dd, Dd, Hd, Hd, Dd^Esd, Dd, Dd, Hd, Ds, Hd, Ds, Ds, Wwg, Wwg, Wwg, Wwt, Wwt, Wwt, Wot, Wot, Wot, Wot, Wot, Wot, Wot, Wot, Wot, Wot, Wot
Dd, Dd, Dd^Esd, Dd, Hd, Hd, Hd, Dd, Dd, Dd, Dd^Esd, Dd^Esd, Dd, Dd, Hd, Hd, Hd, Hd, Hd, Dd, Dd^Vdt, Dd^Esd, Dd, Dd, Dd^Vdt, Dd^Esd, Dd^Esd, Dd^Vdt, Dd, Dd, Dd, Dd, Dd, Dd, Dd^Esd, Dd, Dd, Rd, Rd, Dd, Dd^Esd, Dd^Esd, Dd, Dd^Esd, Dd, Dd, Rd, Dd, Dd, Dd^Esd, Dd^Esd, Dd^Esd, Dd, Dd, Dd, Dd^Esd, Dd^Esd, Dd^Esd, Dd^Esd, Dd, Dd^Esd, Dd, Dd, Ds, Ds, Ds, Ds, Ds, Wwg, Wwg, Wwg, Wog, Wog, Wwrt, Wot, Wot, Wot, Wot, Wot, Wot, Wot, Wot, Wot, Wot, Wot
Dd, Dd^Esd, Dd, Dd, Dd, Hd, Dd, Dd, Dd^Esd, Dd^Esd, Dd^Esd, Dd, Dd, Dd, Dd, Hd, Hd, Hd, Hd, Dd, Dd, Dd, Dd^Esd, Dd, Dd, Dd, Dd, Dd, Dd^Esd, Dd, Dd, Dd, Dd, Dd, Dd, Dd, Dd^Esd, Dd, Dd, Dd, Dd^Esd, Dd^Esd, Dd, Dd, Dd, Rd, Dd, Dd, Cski, Cski, Cski, Dd, Hd, Hd, Hd, Dd, Dd, Dd, Dd^Esd, Dd^Esd, Dd, Dd, Ds, Dd, Wwg, Wwg, Wwg, Wwg, Wwg, Wwg, Wog, Wog, Wog, Wot, Wot, Wot, Wot, Wot, Wot, Wot, Wot, Wot, Wot, Wot, Wot
Dd^Esd, Dd, Dd^Esd, Dd, Dd, Dd, Dd, Dd^Esd, Dd, Dd^Esd, Dd, Dd^Esd, Dd^Esd, Dd, Dd^Esd, Dd, Dd, Hd, Dd, Dd, Dd, Dd, Dd^Esd, Dd, Dd, Dd^Esd, Dd, Dd, Dd, Dd^Esd, Dd, Hd, Hd, Hd, Hd, Dd^Esd, Cski, Cski, Cski, Dd^Esd, Dd, Dd, Rd, Rd, Dd, Dd, Dd, Dd^Esd, Cski, Kski, Wwb, Cski, Hd, Hd, Hd, Hd, Hd, Dd, Dd, Dd^Esd, Ds, Ds, Wwg, Wwg, Wwg, Wwg, Wwg, Wwg, Wwg, Wwg, Wwrg, Wog, Wog, Wot, Wot, Wot, Wot, Wot, Wot, Wot, Wot, Wot, Wot, Wot, Wot
Dd^Esd, Dd, Dd, Dd^Esd, Dd, Dd, Dd, Dd, Dd^Esd, Dd^Esd, Dd, Dd^Esd, Dd^Esd, Dd, Dd, Dd^Esd, Dd^Esd, Dd, Dd, Dd, Dd^Esd, Dd, Dd, Dd^Esd, Dd, Rd, Dd, Dd, Dd, Dd^Esd, Dd^Esd, Dd, Dd, Hd, Hd, Cski, Wwb, Kski, Cski, Dd^Esd, Dd^Esd, Rd, Rd, Dd^Esd, Dd^Esd, Dd, Rd, Rd, Cski, Wwb, Wwb, Cski, Hd, Hd, Hd, Hd, Dd^Esd, Dd, Ds, Ds, Wwg, Wwg, Wwg, Wwg, Wwg, Wwg, Wwrg, Wwrg, Wog, Wog, Wog, Wog, Wog, Wot, Wot, Wot, Wot, Wot, Wot, Wot, Wot, Wot, Wot, Wot, Wot
Dd, Dd^Esd, Dd^Esd, Dd, Dd, Dd^Esd, Dd^Esd, Dd, Dd, Dd, Dd, Dd^Esd, Dd, Dd^Esd, Dd^Esd, Dd, Dd, Dd^Esd, Dd^Esd, Dd^Esd, Hd, Hd, Hd, Dd, Dd, Dd, Dd, Rd, Dd^Esd, Dd^Esd, Dd^Esd, Dd, Dd, Hd, Hd, Cski, Wwb, Wwb, Cski, Dd^Esd, Dd^Esd, Dd, Rd, Dd, Dd^Esd, Rd, Dd, Dd, Hd, Cski, Wwb, Hd, Hd, Hd, Dd^Esd, Dd, Dd, Dd, Ds, Ds, Wwg, Wwg, Wwg, Wwg, Wog, Wwrg, Wog, Wog, Wog, Wog, Wog, Wog, Wot, Wot, Wot, Wot, Wot, Wot, Wot, Wot, Wot, Wot, Wot, Wot, Wot
Dd, Dd, Dd, Dd^Esd, Dd^Esd, Dd, Dd, Dd, Dd^Esd, Dd, Dd^Esd, Dd, Dd^Esd, Dd^Esd, Dd^Esd, Dd, Dd^Esd, Dd^Esd, Hd, Hd, Hd, Hd, Hd, Hd, Dd, Dd^Esd, Dd, Rd, Rd, Dd, Dd^Esd, Dd, Dd, Dd, Hd, Hd, Wwb, Cski, Dd^Esd, Rd, Rd, Dd, Dd, Dd, Rd, Rd, Dd^Esd, Hd, Hd, Hd, Wwb, Hd, Hd, Dd^Esd, Dd, Dd, Ds, Ds, Wwg, Wwg, Wwg, Wog, Wog, Wog, Wwrg, Wwrg, Wog, Wog, Wog, Wog, Wot, Wog, Wot, Wot, Wot, Wot, Wot, Wot, Wot, Wot, Wot, Wot, Wot, Wot, Wot
Dd, Dd, Dd^Esd, Dd, Dd, Dd, Dd, Dd, Dd, Dd, Dd^Esd, Dd, Dd^Esd, Dd, Dd, Dd^Esd, Dd, Dd, Hd, Hd, Hd, Hd, Cski, Cski, Cski, Dd, Dd, Rd, Dd, Dd, Dd^Esd, Dd^Esd, Dd, Hd, Hd, Dd, Dd, Wwb, Dd^Esd, Dd, Rd, Dd, Rd, Dd, Rd, Dd, Dd^Esd, Hd, Wwb, Wwb, Hd, Hd, Hd, Dd^Esd, Dd, Dd, Ds, Wwg, Wwg, Wwg, Wog, Wog, Wog, Wog, Wog, Wog, Wog, Wog, Wog, Wog, Wot, Wot, Wot, Wot, Wot, Wot, Wot, Wot, Wot, Wot, Wot, Wot, Wot, Wot, Wot
Dd, Dd, Dd^Esd, Dd^Esd, Dd, Dd, Dd^Esd, Dd^Esd, Dd^Esd, Dd^Esd, Dd, Dd^Esd, Dd^Esd, Dd, Hd, Hd, Hd, Dd, Hd, Hd, Hd, Hd, Cski, Kski, Wwb, Cski, Dd, Rd, Dd, Dd, Dd^Esd, Dd^Esd, Dd, Hd, Dd, Dd, Dd^Esd, Wwb, Rd, Dd, Rd, Dd^Esd, Rd, Rd, Dd, Dd, Dd, Hd, Wwb, Hd, Hd, Hd, Dd^Esd, Dd, Dd, Ds, Wwg, Wwg, Wwg, Wog, Wog, Wog, Wog, Wog, Wwrg, Wog, Wog, Wog, Wog, Wot, Wot, Wot, Wot, Wot, Wot, Wot, Wot, Wot, Wot, Wot, Wot, Wot, Wot, Wot, Wot
Dd, Dd, Dd, Dd^Esd, Dd, Dd^Esd, Dd, Dd^Esd, Dd^Esd, Dd, Dd^Esd, Dd^Esd, Dd, Dd, Hd, Hd, Hd, Hd, Hd, Hd, Hd, Hd, Cski, Wwb, Wwb, Cski, Rd, Rd, Dd, Dd^Esd, Dd^Esd, Dd^Esd, Dd, Dd, Dd, Dd, Dd^Esd, Wwb, Wwb, Rd, Dd, Rd, Rd, Dd, Dd^Esd, Dd^Esd, Wwb, Wwb, Hd, Hd, Hd, Dd^Esd, Dd^Esd, Dd, Dd, Ds, Ds, Wwg, Wwg, Wog, Wog, Wog, Wwrg, Wog, Wog, Wog, Wog, Wog, Wog, Wog, Wog, Wot, Wot, Wot, Wot, Wot, Wot, Wot, Wot, Wot, Wot, Wot, Wot, Wot, Wot
Dd, Dd^Esd, Dd, Dd, Dd, Dd, Dd, Dd, Dd, Dd^Esd, Dd, Dd^Esd, Dd^Esd, Dd, Dd, Hd, Hd, Hd, Hd, Hd, Hd, Hd, Hd, Cski, Dd^Esd, Wwb, Rd, Rd, Dd, Dd, Dd^Esd, Dd, Dd, Dd, Dd, Dd, Dd, Dd^Esd, Dd^Esd, Wwb, Wwb, Dd, Rd, Dd^Esd, Wwb, Wwb, Hd, Dd, Dd, Hd, Dd, Dd, Dd^Esd, Dd, Dd, Ds, Ds, Wwg, Wwb, Wwb, Wwb, Wog, Wwrg, Wog, Wog, Wwrg, Wog, Wog, Wog, Wog, Wog, Wog, Wog, Wot, Wot, Wot, Wot, Wot, Wot, Wot, Wot, Wot, Wot, Wot, Wot
Dd, Dd, Dd^Esd, Dd^Esd, Dd, Dd^Esd, Dd^Vdt, Dd, Dd^Esd, Dd, Dd^Esd, Dd^Esd, Dd^Esd, Dd, Dd, Hd, Hd, Hd, Hd, Hd, Hd, Hd, Hd, Dd, Dd^Esd, Wwb, Dd, Dd, Rd, Dd^Esd, Dd, Dd, Dd, Dd, Hd, Dd, Hd, Hd, Hd, Dd^Esd, Dd, Wwb, Rd, Wwb, Dd, Hd, Hd, Dd, Dd, Dd, Dd, Dd^Esd, Dd^Esd, Dd, Dd, Ds, Ds, Ds, Wwt^Bsb/, Wwb^Bsb/, Wwb^Bsb/, Wwb, Wwb, Wwb, Wwb, Wog, Wwrg, Wog, Wwrg, Wwg, Wwrg, Wog, Wog, Wog, Wot, Wot, Wot, Wot, Wot, Wot, Wot, Wot, Wot, Wot, Wot
Dd, Dd, Dd, Dd, Dd, Dd, Dd, Dd, Dd, Dd^Esd, Dd^Esd, Dd^Esd, Dd^Esd, Dd, Dd, Dd, Dd, Hd, Dd, Hd, Dd, Dd, Dd, Dd, Dd, Wwb, Wwb, Dd, Dd, Dd, Dd, Dd, Dd, Dd, Hd, Hd, Hd, Hd, Hd, Hd, Dd, Wwb, Kski, Wwb, Dd, Hd, Hd, Hd, Hd, Hd, Dd, Dd, Dd^Esd, Dd^Esd, Dd, Dd, Ds, Cski, Kski, Wwb^Bsb/, Wwb^Bsb/, Wwb, Wwb, Wwb, Wwb, Wwb, Wwg, Wwrg, Wwg, Wwrg, Wog, Wog, Wwg, Wog, Wog, Wot, Wot, Wot, Wot, Wot, Wot, Wot, Wot, Wot, Wot
Hd, Dd, Hd, Hd, Hd, Dd, Dd, Dd^Esd, Dd, Dd^Esd, Dd^Vdt, Dd^Esd, Dd, Dd^Esd, Dd, Dd, Dd^Esd, Dd, Dd, Dd, Dd, Dd, Dd^Esd, Dd^Esd, Dd^Esd, Dd^Esd, Dd, Wwb, Rd, Dd, Dd, Dd, Dd, Hd, Hd, Hd, Cski, Kski, Cski, Cski, Kski, Wwb, Rrc, Wwb, Kski, Cski, Cski, Kski, Cski, Hd, Dd, Dd^Esd, Dd, Dd, Dd, Dd, Rr, Cski, Cski, Wwb^Bsb/, Wwb, Wwb, Wwb, Wwb, Wwb, Wwb, Wwb, Wwg, Wwg, Wwg, Wwg, Wwrg, Wwrg, Wog, Wog, Wog, Wog, Wot, Wot, Wot, Wot, Wot, Wot, Wot, Wot
Hd, Hd, Hd, Hd, Hd, Hd, Hd, Dd, Dd^Esd, Dd, Dd^Esd, Dd^Esd, Dd^Esd, Dd^Esd, Dd, Dd, Dd, Dd^Esd, Dd^Esd, Dd^Esd, Dd, Dd^Esd, Dd^Esd, Dd, Dd^Esd, Dd^Esd, Dd, Wwb, Wwb, Rd, Rd, Dd, Dd, Hd, Kski, Cski, Rrc, Rrc, Rrc, Rrc, Rrc, Wwb^Bsb/, Wwb, Wwb^Bsb\, Rrc, Rrc, Rrc, Rrc, Rrc, Cski, Kski, Dd, Dd, Dd, Rr, Rr, Dd^Esd, Dd, Dd, Ds, Wwb, Wwb, Wwb, Wwb, Wwb, Wwb, Wwb, Wwg, Ds, Wwg, Wwg, Wwg, Wog, Wog, Wwrg, Wog, Wog, Wot, Wot, Wot, Wot, Wot, Wot, Wot, Wot
Dd, Hd, Hd, Hd, Hd, Ce, Ce, Ce, Dd^Esd, Dd^Esd, Dd, Dd^Esd, Dd^Vdt, Dd, Dd, Dd^Esd, Dd, Dd, Dd^Esd, Dd^Esd, Dd, Dd^Esd, Dd, Dd^Esd, Dd, Dd, Dd, Dd, Dd, Wwb, Wwb, Rd, Dd, Dd, Cski, Rrc, Cski, Rrc, Cski, Rrc, Wwb, Wwb, Kski, Wwb, Wwb, Rrc, Cski, Rrc, Cski, Rrc, Cski, Dd, Dd, Rr, Dd, Dd^Esd, Dd^Esd, Dd^Esd, Dd, Ds, Ds, Wwb, Wwb, Wwb, Wwb, Wwb, Ds, Ds, Ds, Ds, Wwg, Wwg, Wog, Wwrg, Wog, Wog, Wog, Wot, Wot, Wot, Wot, Wot, Wot, Wot, Wot
Dd^Esd, Dd^Vdt, Hd, Hd, Ce, Ce, 6 Ke, Ce, Ce, Dd^Esd, Dd, Dd^Esd, Dd^Esd, Dd, Dd, Dd^Esd, Dd^Esd, Dd, Dd, Dd^Esd, Dd^Esd, Dd^Esd, Dd^Esd, Dd, Dd, Dd, Dd, Dd, Dd, Dd, Wwb, Rd, Rd, Rd, Kski, Rrc, Rrc, Kski, Wwb, Wwb, Cski, Cski, Wwb, Cski, Cski, Wwb, Wwb, Kski, Rrc, Rrc, Kski, Dd, Rr, Rr, Dd, Dd^Esd, Dd^Esd, Dd^Esd, Dd^Esd, Dd, Wwb, Wwb, Ds, Ds, Ds, Ds, Dd, Dd, Dd, Ds, Wwg, Wwg, Wwg, Wog, Wog, Wog, Wog, Wot, Wot, Wot, Wot, Wot, Wot, Wot, Wot
Dd^Esd, Dd^Esd, Hd, Hd, Hd, Ce, Ce, Ce, Hd, Dd, Dd, Dd, Dd^Esd, Dd^Esd, Dd^Esd, Dd^Esd, Dd^Esd, Dd, Dd, Dd^Esd, Dd, Dd^Esd, Dd^Esd, Dd, Hd, Hd, Hd, Hd, Cski, Kski, Cski, Wwb, Wwb, Rrc, Rrc, Rrc, Rrc, Cski, Wwb, Wwb, Cski, Wwb, Wwb, Wwb, Cski, Wwb, Wwb, Kski, Rrc, Rrc, Rrc, Rr, Rr, Rr, Cski, Kski, Cski, Dd, Wwb, Wwb, Dd, Dd, Dd, Ds, Dd, Dd, Dd, Dd, Dd, Ds, Wwg, Wwg, Wwg, Wwrg, Wog, Wog, Wog, Wog, Wog, Wot, Wot, Wot, Wot, Wot, Wot
Dd, Dd^Esd, Hd, Hd, Hd, Ce, Hd, Ce, Hd, Hd, Dd, Dd, Dd, Dd, Dd, Dd, Dd, Dd, Dd, Dd, Dd^Esd, Dd^Esd, Dd, Dd, Hd, Hd, Kski, Cski, Rrc, Rrc, Rrc, Kski, Rrc, Wwb, Rrc, Rrc, Rrc, Rrc, Wwb, Cski, Wwb, Cski, 3 Kski, Cski, Wwb, Cski, Wwb, Rrc, Rrc, Rrc, Rrc, Rrc, Rrc, Kski, Wwb, Wwb, Wwb, Wwb, Kski, Dd^Esd, Dd^Esd, Dd, Dd, Dd, Dd, Dd^Esd, Dd^Esd, Dd, Dd, Ds, Ds, Wwg, Wwg, Wog, Wog, Wwrg, Wwrg, Wog, Wog, Wot, Wot, Wot, Wot, Wot, Wot
Dd, Dd^Esd, Dd, Hd, Dd, Hd, Dd, Hd, Hd, Hd, Dd, Dd^Esd, Dd^Esd, Dd, Dd, Dd, Dd, Hd, Hd, Dd^Esd, Dd^Esd, Dd, Dd, Dd, Hd, Hd, Cski, Rrc, Rrc, Rrc, Rrc, Rrc, Rrc, Wwb^Bsb\, Rrc, Rrc, Wwb, Wwb^Bsb|, Wwb, Cski, Cski, Cski, Cski, Cski, Cski, Cski, Wwb, Wwb, Wwb, Rrc, Rrc, Rrc, Rrc, Wwb, Cski, Rrc, Rrc, Rrc, Cski, Dd, Dd, Dd^Esd, Dd, Dd, Dd, Dd, Dd^Esd, Dd, Dd, Dd, Ds, Wwg, Wwg, Wwg, Wog, Wog, Wog, Wog, Wog, Wog, Wot, Wot, Wot, Wot, Wot
Dd, Dd^Esd, Dd, Dd, Dd, Dd, Dd, Dd^Vdt, Dd, Dd^Esd, Dd^Vdt, Dd, Dd^Esd, Dd, Dd, Dd, Dd, Hd, Hd, Dd, Dd^Esd, Dd^Esd, Dd, Dd, Dd, Hd, Cski, Rrc, Rrc, Rrc, Rrc, Rrc, Wwb, Wwb, Wwb, Rrc, Wwb, Cski, Wwb^Bsb/, Wwb^Bsb/, Cski, Wwb, Cski, Wwb, Cski, Wwb^Bsb\, Wwb^Bsb\, Cski, Wwb, Rrc, Wwb, Wwb^Bsb|, Wwb, Wwb^Bsb\, Cski, Kski, Cski, Rrc, Cski, Dd, Dd, Dd, Dd^Esd, Dd^Esd, Dd, Dd, Rd, Dd^Esd, Dd, Dd, Ds, Wwg, Wwg, Wwg, Wwg, Wog, Wog, Wwrg, Wwrg, Wog, Wog, Wot, Wot, Wot, Wot
Dd, Dd^Esd, Dd, Dd^Vdt, Dd^Esd, Dd^Esd, Dd^Esd, Dd, Dd^Esd, Dd^Esd, Dd^Esd, Dd, Dd^Esd, Dd, Dd, Dd, Hd, Hd, Hd, Dd, Dd, Dd, Dd, Dd, Dd, Dd, Cski, Rrc, Rrc, Rrc, Rrc, Wwb^Bsb\, Cski, Cski, Cski, Wwb, Cski, Kski, Cski, Wwb, Wwb, Cski, Wwb, Cski, Wwb, Wwb, Cski, Kski, Cski, Wwb, Cski, Cski, Cski, Wwb, Rrc, Cski, Rrc, Rrc, Cski, Hd, Dd, Dd, Dd^Esd, Dd^Esd, Dd, Dd^Esd, Dd, Dd, Dd, Dd, Ds, Ds, Ds, Wwg, Wwg, Wwg, Wwg, Wwg, Wwrg, Wog, Wog, Wog, Wog, Wot, Wot
Dd, Dd^Esd, Dd^Esd, Dd^Esd, Dd, Dd, Dd^Esd, Dd, Dd, Dd^Esd, Dd^Esd, Dd^Esd, Dd^Esd, Dd, Dd, Dd^Esd, Dd, Hd, Dd^Esd, Dd, Dd, Dd^Esd, Dd, Dd, Dd, Dd, Kski, Rrc, Rrc, Rrc, Rrc, Wwb, Cski, 5 Kski, Cski, Wwb^Bsb/, Wwb, Wwb, Wwb, Wwb, Rrc, Wwb, Rrc, Wwb, Rrc, Wwb^Bsb/, Wwb, Wwb, Wwb, Wwb^Bsb\, Cski, 4 Kski, Cski, Wwb, Rrc, Rrc, Rrc, Rrc, Kski, Hd, Dd, Dd, Dd, Dd, Dd, Dd^Esd, Rd, Dd^Esd, Dd, Dd, Dd, Dd, Dd, Ds, Ds, Wwg, Wwg, Wwg, Wog, Wog, Wwrg, Wog, Wog, Wot, Wot
Dd, Dd^Esd, Dd^Esd, Dd, Dd^Esd, Dd^Esd, Dd, Dd, Hd, Dd, Dd, Dd^Esd, Dd^Esd, Dd^Esd, Dd^Esd, Dd, Dd, Dd, Dd, Dd, Dd, Dd^Esd, Dd, Dd, Hd, Hd, Hd, Cski, Cski, Rrc, Rrc, Wwb^Bsb/, Wwb, Cski, Wwb, Wwb, Rrc, Rrc, Rrc, Rrc, Cski, Cski, Kski, Cski, Cski, Rrc, Rrc, Rrc, Rrc, Wwb, Wwb, Cski, Wwb, Wwb^Bsb\, Rrc, Rrc, Cski, Cski, Hd, Hd, Hd, Dd, Dd, Dd, Dd^Esd, Dd, Rd, Dd, Dd, Dd, Dd, Dd, Dd, Dd, Ds, Wwg, Wwg, Wwg, Wog, Wog, Wog, Wog, Wog, Wog, Wot
Dd, Dd, Dd^Esd, Dd, Dd^Esd, Dd^Esd, Dd, Hd, Hd, Hd, Dd, Dd, Dd^Esd, Dd, Dd, Dd, Dd^Esd, Dd, Dd, Dd^Esd, Dd, Dd, Dd, Dd, Hd, Hd, Hd, Hd, Hd, Kski, Rrc, Rrc, Rrc, Wwb, Rrc, Rrc, Rrc, Rrc, Rrc, Kski, Rrc, Rrc, Wwb, Rrc, Rrc, Kski, Rrc, Rrc, Rrc, Rrc, Rrc, Wwb, Rrc, Rrc, Rrc, Kski, Hd, Hd, Hd, Hd, Hd, Dd, Dd, Dd, Dd, Rd, Dd, Dd, Dd, Dd^Esd, Dd, Dd, Dd, Dd, Ds, Wwg, Wwg, Wwg, Wog, Wog, Wog, Wwrg, Wog, Wog, Wog
Dd, Dd^Esd, Dd^Esd, Dd^Esd, Dd^Esd, Dd^Esd, Dd, Hd, Hd, Dd, Hd, Dd, Dd, Dd, Dd^Esd, Dd^Esd, Dd, Dd, Dd, Dd, Dd, Dd, Dd, Dd, Dd, Hd, Dd, Hd, Hd, Cski, Rrc, Rrc, Wwb^Bsb\, Wwb, Wwb, Rrc, Wwb^Bsb|, Rrc, Wwb, Wwb, Wwb, Wwb, Rrc, Wwb, Wwb, Wwb, Wwb, Wwb^Bsb|, Wwb, Rrc, Wwb, Wwb, Wwb^Bsb/, Rrc, Rrc, Cski, Hd, Hd, Hd, Hd, Dd, Dd, Dd, Dd, Rd, Dd, Dd^Esd, Dd, Dd, Dd, Dd^Esd, Dd^Esd, Dd, Dd, Ds, Wwg, Wwg, Wwg, Wwg, Wog, Wog, Wwrg, Wog, Wog, Wot
Dd, Dd, Dd^Esd, Dd, Dd^Esd, Dd, Dd, Dd, Hd, Hd, Hd, Dd, Dd, Dd, Dd, Dd^Esd, Dd, Dd^Esd, Dd^Esd, Dd, Dd^Esd, Dd, Dd^Esd, Dd, Dd, Dd, Dd, Hd, Hd, Kski, Cski, Rrc, Wwb, Rrc, Rrc, Wwb, Rrc, Wwb, Rrc, Kski, Rrc, Wwb, Wwb, Wwb, Rrc, Kski, Rrc, Rrc, Rrc, Wwb, Rrc, Rrc, Wwb, Rrc, Cski, Kski, Hd, Hd, Hd, Hd, Dd, Dd, Dd, Rd, Dd, Dd, Dd, Dd, Dd, Dd, Dd^Esd, Dd, Dd, Dd, Ds, Ds, Wwg, Wwg, Wwg, Wog, Wog, Wwrg, Wog, Wog, Wot
Hd, Dd, Dd, Dd^Esd, Dd^Esd, Dd^Esd, Dd^Esd, Dd, Dd, Hd, Hd, Hd, Dd, Dd, Dd^Esd, Dd^Esd, Dd^Esd, Dd^Esd, Dd, Dd, Dd, Dd, Dd^Esd, Dd, Dd^Esd, Dd, Dd, Hd, Dd, Dd, Dd, Kski, Wwb, Rrc, Rrc, Rrc, Rrc, Rrc, Rrc, Cski, Kski, Cski, Kski, Cski, Kski, Cski, Rrc, Rrc, Rrc, Rrc, Rrc, Rrc, Wwb, Kski, Dd, Hd, Hd, Hd, Dd, Dd, Dd, Dd, Dd^Esd, Rd, Dd, Dd, Dd, Dd, Dd, Dd^Esd, Dd, Dd, Dd, Dd, Ds, Ds, Wwg, Wwg, Wwg, Wog, Wwrg, Wwrg, Wog, Wog, Wot
Hd, Hd, Hd, Dd, Dd, Dd, Dd^Esd, Dd^Esd, Dd^Esd, Dd, Dd, Dd, Dd^Esd, Dd, Dd^Esd, Dd^Esd, Dd, Dd^Esd, Dd^Esd, Dd, Dd, Dd, Cski, Dd^Esd, Dd, Dd^Esd, Dd^Esd, Dd, Dd, Dd^Esd, Wwb, Wwb, Rd, Rrc, Kski, Cski, Cski, Rrc, Rrc, Rrc, Rd, Hd, Hd, Hd, Dd, Rrc, Rrc, Rrc, Cski, Cski, Kski, Rrc, Rd, Wwb, Wwb, Hd, Hd, Dd, Dd, Dd, Dd, Dd, Dd, Dd, Dd, Dd, Dd, Dd, Dd, Dd, Dd, Dd, Ds, Ds, Ds, Wwg, Wwg, Wwg, Wog, Wog, Wog, Wog, Wog, Wog, Wot
Hd, Hd, Hd, Hd, Hd, Dd, Dd^Esd, Dd^Esd, Dd^Esd, Dd, Dd, Dd^Esd, Dd, Dd, Dd^Esd, Dd^Esd, Dd, Dd, Dd, Dd, Cski, Cski, Wwb, Cski, Wwb, Dd, Wwb, Dd^Esd, Wwb, Wwb, Dd, Rd, Dd, Rd, Hd, Hd, Hd, Kski, Rd, Rd, Rd, Dd, Dd, Dd, Dd, Dd, Dd, Kski, Hd, Hd, Hd, Rd, Rd, Dd, Wwb, Dd, Dd, Dd, Cski, Dd, Dd, Dd, Dd, Dd, Dd^Esd, Dd, Dd, Dd, Dd, Hd, Hd, Ds, Ds, Ds, Wwg, Wwg, Wwg, Wwg, Wog, Wwrg, Wog, Wog, Wog, Wot, Wot
Hd, Hd, Hd, Hd, Hd, Hd, Dd, Dd, Dd^Esd, Dd^Esd, Dd^Esd, Dd, Dd, Dd^Esd, Dd, Dd^Esd, Dd^Esd, Dd, Dd, Dd^Esd, Cski, Kski, Wwb, Wwb, Dd, Wwb, Dd^Esd, Wwb, Dd^Esd, Dd^Esd, Dd, Rd, Dd, Dd, Dd, Hd, Hd, Dd, Dd, Rd, Dd, Rd, Dd, Dd, Dd, Dd, Dd, Dd, Hd, Hd, Hd, Dd, Dd, Dd, Dd, Wwb, Wwb, Cski, Wwb, Cski, Cski, Dd, Dd, Dd, Dd^Esd, Dd, Dd, Dd, Hd, Hd, Hd, Ds, Wwg, Wwg, Wwg, Wwg, Wwg, Wwg, Wwrg, Wog, Wog, Wog, Wot, Wot, Wot
Hd, Hd, Hd, Hd, Hd, Hd, Dd, Dd^Esd, Dd, Dd^Esd, Dd, Dd, Dd^Esd, Dd^Esd, Dd, Dd^Esd, Dd^Esd, Dd^Esd, Dd^Esd, Dd, Dd, Cski, Cski, Cski, Rd, Dd, Dd^Esd, Dd^Esd, Dd, Dd, Rd, Rd, Dd, Dd^Esd, Dd, Dd, Dd, Dd, Dd, Dd, Dd^Esd, Rd, Dd, Dd, Dd, Dd, Dd, Hd, Hd, Hd, Hd, Dd, Dd, Dd, Dd, Dd, Rd, Wwb, Wwb, Kski, Cski, Dd, Dd, Dd^Esd, Dd, Dd, Dd, Dd, Hd, Hd, Hd, Ds, Wwg, Wwg, Wwg, Wwg, Wwg, Wwrg, Wog, Wog, Wog, Wot, Wot, Wot, Wot
Hd, Hd, Hd, Hd, Hd, Hd, Dd, Dd^Esd, Dd, Dd, Dd, Dd^Esd, Dd^Esd, Dd, Rd, Dd, Dd^Esd, Dd, Dd^Esd, Dd, Dd^Esd, Dd^Esd, Rd, Rd, Dd, Rd, Rd, Dd^Esd, Dd^Esd, Rd, Dd, Dd, Dd, Dd^Esd, Dd^Esd, Dd, Dd, Dd, Dd, Dd, Dd, Rd, Dd^Esd, Dd, Dd, Dd, Dd, Dd, Dd, Hd, Dd, Dd, Dd, Dd^Esd, Dd, Rd, Dd^Esd, Cski, Cski, Cski, Dd, Dd, Dd^Esd, Dd^Esd, Dd, Dd, Dd, Dd, Hd, Hd, Hd, Ds, Ds, Wwg, Wwg, Wwg, Wwg, Wog, Wwrg, Wog, Wot, Wot, Wot, Wot, Wot
Hd, Hd, Hd, Hd, Hd, Hd, Dd, Dd^Esd, Dd^Esd, Dd^Esd, Dd^Esd, Dd, Dd^Esd, Dd, Dd, Rd, Dd^Esd, Dd, Dd, Dd^Esd, Dd, Dd, Rd, Dd, Dd^Esd, Dd, Dd, Dd, Dd, Dd, Dd, Dd, Dd, Dd^Esd, Dd^Esd, Dd, Dd, Dd, Dd^Esd, Dd^Esd, Dd, Rd, Dd^Esd, Dd, Dd, Dd, Dd, Dd, Dd, Dd, Dd, Dd, Dd, Dd^Esd, Dd, Rd, Dd, Dd, Dd, Dd, Dd, Dd, Dd^Esd, Dd, Dd, Dd, Dd, Dd, Dd, Hd, Hd, Hd, Hd, Ds, Ds, Wwg, Wwg, Wwg, Wwt, Wwrg, Wwrt, Wot, Wot, Wot, Wot
Hd, Hd, Hd, Hd, Hd, Hd, Hd, Dd, Dd, Dd, Dd, Dd, Dd^Esd, Dd, Dd^Esd, Dd^Esd, Dd, Rd, Dd, Dd, Dd, Rd, Dd, Dd, Dd, Dd^Esd, Dd, Dd^Esd, Dd, Rd, Dd, Dd, Dd, Dd, Dd^Esd, Dd^Esd, Dd^Esd, Dd^Esd, Dd, Dd, Dd, Rd, Rd, Dd, Dd, Dd, Dd^Esd, Dd, Dd, Dd, Dd^Edp, Dd, Dd, Dd, Dd, Dd, Dd, Rd, Dd^Esd, Dd^Esd, Dd^Esd, Dd, Rd, Dd, Dd, Dd, Dd, Dd, Dd, Hd, Hd, Hd, Hd, Hd, Ds, Wwt, Wwt, Wwt, Wwt, Wwt, Wot, Wot, Wot, Wot, Wot
Hd, Hd, Hd, Hd, Hd, Hd, Hd, Hd, Hd, Hd, Hd, Dd, Dd, Dd^Esd, Dd^Esd, Dd^Esd, Dd^Esd, Dd, Dd, Dd^Esd, Dd, Dd, Dd, Dd, Dd, Dd^Esd, Dd^Esd, Dd, Dd, Dd, Dd, Rd, Rd, Dd, Dd, Dd^Esd, Dd^Esd, Dd, Dd, Dd, Dd, Dd, Dd^Esd, Dd, Rd, Dd, Dd^Esd, Dd, Dd, Dd, Dd, Dd, Dd, Dd, Dd^Esd, Dd, Dd^Esd, Dd, Dd, Rd, Dd, Dd, Dd, Rd, Dd, Dd, Dd, Dd, Dd, Dd, Dd, Hd, Hd, Hd, Ds, Ds, Ds, Wwt, Wwt, Wwt, Wwt, Wwrt, Wot, Wot, Wot
Hd, Hd, Hd, Hd, Hd, Hd, Hd, Hd, Hd, Hd, Hd, Dd, Dd, Dd^Esd, Dd, Dd^Esd, Dd^Esd, Dd, Dd^Esd, Dd, Dd^Esd, Dd, Dd^Esd, Dd^Esd, Dd, Dd, Dd, Dd^Esd, Dd^Esd, Dd, Dd, Dd, Rd, Dd, Dd, Dd, Dd, Dd, Dd, Dd, Dd, Dd, Dd, Dd^Esd, Dd, Rd, Dd, Dd^Esd, Dd, Dd, Dd, Dd, Dd, Dd, Dd, Dd, Dd, Dd^Esd, Dd^Esd, Dd, Dd, Dd, Dd, Rd, Dd, Dd, Dd, Dd, Dd, Dd, Dd, Dd, Hd, Hd, Hd, Ds, Ds, Wwt, Wwt, Wwt, Wwt, Wot, Wwrt, Wot, Wot
Hd, Hd, Hd, Hd, Hd, Hd, Hd, Hd, Hd, Hd, Hd, Hd, Dd, Dd^Esd, Dd^Esd, Dd^Esd, Dd^Esd, Dd, Dd^Esd, Dd, Dd, Dd, Dd^Esd, Dd^Esd, Dd, Dd^Esd, Dd, Dd, Dd, Dd, Dd, Rd, Dd, Dd, Dd^Esd, Dd^Esd, Dd, Dd, Dd, Dd, Dd, Dd^Esd, Dd, Dd, Dd, Rd, Dd, Dd^Esd, Dd, Dd, Dd, Dd, Dd, Dd, Dd, Dd, Dd, Dd, Dd, Dd^Esd, Dd^Esd, Dd, Dd, Rd, Dd, Dd, Dd, Dd, Dd, Dd, Dd, Dd, Dd, Hd, Hd, Ds, Ds, Wwt, Wwt, Wwt, Wwt, Wot, Wwrt, Wot, Wot
Hd, Hd, Hd, Hd, Hd, Hd, Hd, Hd, Hd, Hd, Hd, Hd, Dd, Dd, Dd, Dd, Dd, Dd, Dd, Dd, Dd, Dd^Esd, Dd, Dd, Dd, Dd, Dd, Dd^Esd, Dd^Esd, Dd^Esd, Dd, Rd, Dd, Dd, Dd, Dd^Esd, Dd, Dd, Dd, Dd, Dd, Dd^Esd, Dd, Dd, Dd, Rd, Dd, Dd, Dd, Dd, Dd, Dd, Dd, Dd, Dd, Dd, Dd, Dd, Dd, Dd, Dd^Esd, Dd, Dd, Rd, Dd, Dd, Dd, Dd, Dd, Dd, Dd, Dd, Dd, Hd, Hd, Hd, Ds, Ds, Ds, Wwt, Ds, Wwt, Wwt, Wwrt, Wot
