border_size=1
usage=map

Ms, Ms, Ms, Aa, Tyb, Tyb, Aa, Ms, Ms, Ms, Ms^Xm, Ms, Ms, Aa, Aa, Aa, Ms, Ms, Ms^Xm, Ms, Aa, Aa, Aa, Tyb, Aa, Aa, Aa, Aa, Ms, Ms, Ms, Aa, Qxua, Aa, Aa, Aa, Aa, Aa, Aa, Aa, Aa, Aa, Aa, Aa, Aa, Aa, Ms, Aa, Aa, Aa, Aa, Aa, Aa, Ms, Ms, Ms, Ms, Ms, Tyb, Aa, Aa, Aa, Aa, Ms, Ms, Ms, Ms, Aa, Aa, Qxua, Aa, Aa
Ms, Ms^Xm, Ms, Tyb, Aa, Aa, Tyb, Ms, Ms, Ms, Ms, Ms, Aa, Aa, Aa, Ms, Ms^Xm, Ms^Xm, Ms, Ms, Tyb, Tyb, Aa, Aa, Aa, Aa, Ms, Ms, Ms, Ms, Ms, Aa, Qxua, Aa, Ms, Aa, Aa, Tyb, Tyb, Aa, Aa, Tyb, Tyb, Aa, Aa, Aa, Ms, Ms, Ms^Xm, Aa, Aa, Aa, Tyb, Ms, Ms, Ms, Ms, Ms, Tyb, Tyb, Aa, Aa, Aa, Ms, Ms, Ms, Ms, Aa, Aa, Qxua, Aa, Aa
Ms, Ms^Xm, Ms, Aa, Aa, Aa, Tyb, Tyb, Aa, Ms, Ms, Ms, Aa, Aa, Ms, Ms, Ms^Xm, Ms, Tyb, Tyb, Aa, Aa, Aa, Aa, Tyb, Ms, Ms, Ms, Ms, Ms, Aa, Qxua, Aa, Aa, Ms, Aa, Aa, Aa, Tyb, Aa, Aa, Aa, Aa, Aa, Aa, Aa, Aa, Ms, Ms, Ms, Aa, Aa, Tyb, Tyb, Ms, Ms^Xm, Ms, Tyb, Aa, Aa, Aa, Aa, Ms, Ms, Ms, Ms, Tyb, Aa, Qxua, Qxua, Aa, Aa
Ms, Ms, Ms, Aa, Aa, Ms, Ms, Tyb, Aa, Aa, Aa, Aa, Aa, Aa, Ms, Ms^Xm, Ms, Ms, Tyb, Tyb, Aa, Aa, Aa, Tyb, Ms, Ms, Ms, Ms, Ms, Ms, Qxua, Qxua, Aa, Aa, Ms, Ms, Aa, Tyb, Aa, Tyb, Aa^Vaa, Tyb, Tyb, Tyb, Aa, Aa, Ms, Ms^Xm, Ms, Ms, Aa, Aa, Ms, Ms, Ms, Ms, Ms, Tyb, Aa, Aa, Aa, Ms, Ms, Ms, Ms, Ms, Ms, Aa, Qxua, Qxua, Ms, Aa
Ms, Ms, Ms, Aa, Aa, Ms, Aa, Aa, Aa, Aa, Aa, Aa, Aa, Aa, Ms, Ms, Ms, Tyb, Aa, Aa, Aa, Aa, Ms, Tyb, Ms^Xm, Ms, Ms, Ms, Aa, Aa, Qxua, Aa, Ms, Ms, Ms, Aa, Aa, Tyb, Aa, Aa, Aa, Aa, Aa, Aa, Aa, Ms, Ms^Xm, Ms, Ms, Tyb, Aa, Aa, Ms, Ms^Xm, Ms, Ms, Aa, Aa, Aa, Aa, Ms^Xm, Ms, Ms, Ms^Xm, Ms, Ms, Ms, Aa, Qxua, Ms, Ms, Ms
Ms^Xm, Ms, Aa, Aa, Tyb, Aa, Aa, Aa, Ms, Ms, Ms, Aa, Aa, Aa, Aa, Ms, Aa, Aa, Aa, Aa, Aa, Ms, Ms^Xm, Ms, Ms, Ms, Ms, Aa, Aa, Qxua, Aa, Aa, Ms, Ms, Ms, Aa, Aa^Vaa, Aa, Aa, Aa, Aa, Aa, Aa, Aa, Aa^Vaa, Ms, Ms, Ms, Tyb, Tyb, Aa, Aa, Ms, Ms, Ms^Xm, Ms, Aa, Aa, Tyb, Ms, Ms, Ms, Ms, Ms, Ms, Ms, Aa, Qxua, Aa, Ms, Ms, Ms
Ms^Xm, Ms, Aa, Tyb, Aa, Aa, Aa, Ms, Ms, Ms^Xm, Ms^Xm, Ms, Ms, Aa, Aa, Aa, Aa, Aa, Ms, Aa, Aa, Ms, Ms^Xm, Ms, Ms, Ms^Xm, Ms, Aa, Qxua, Aa, Ms, Ms, Ms, Ms^Xm, Ms, Aa, Aa, Aa, Cea, Cea, Cea, Cea, Cea, Aa, Aa, Aa, Ms, Ms, Aa, Aa, Aa, Aa, Ms, Ms, Ms, Ms, Aa, Aa, Tyb, Ms, Ms, Ms, Ms, Ms^Xm, Ms, Ms, Aa, Qxua, Ms, Ms, Ms, Ms
Ms^Xm, Ms, Aa, Tyb, Tyb, Aa, Aa, Ms, Ms, Ms, Ms, Ms^Xm, Ms, Ms, Aa, Aa, Ms, Ms, Aa, Aa, Ms, Ms^Xm, Ms, Ms, Ms, Ms, Aa, Aa, Qxua, Aa, Ms, Ms, Ms, Ms, Aa, Aa, Aa, Aa, Cea, Aa^Vaa, Kea, Aa^Vaa, Cea, Aa, Aa, Aa, Ms, Ms, Aa, Aa, Aa, Aa, Aa, Ms, Ms, Ms, Ms, Aa, Aa, Tyb, Tyb, Ms, Ms, Ms, Aa, Aa, Qxua, Qxua, Ms, Ms, Ms, Ms
Ms, Ms^Xm, Ms, Aa, Aa, Tyb, Tyb, Tyb, Tyb, Aa, Aa, Ms^Xm, Ms^Xm, Ms, Aa, Aa, Aa, Ms, Aa, Aa, Ms, Ms, Ms, Ms, Tyb, Tyb, Aa, Aa, Qxua, Aa, Aa, Ms, Ms, Aa, Aa^Vaa, Aa, Aa, Cea, Aa^Vaa, Kea, 2 Kea, Kea, Aa^Vaa, Cea, Aa, Aa, Aa, Aa, Aa, Aa, Aa, Aa, Aa, Ms, Ms, Ms, Ms, Aa, Aa, Aa, Aa, Aa, Aa, Aa, Qxua, Aa, Qxua, Aa, Aa, Ms, Ms, Ms
Ms, Ms^Xm, Ms, Ms, Ms, Aa, Aa, Aa, Tyb, Aa, Aa, Ms, Ms, Ms, Ms, Aa, Aa, Aa, Aa, Aa, Aa, Ms, Aa, Aa, Aa, Aa, Aa, Aa, Aa, Qxua, Qxua, Aa, Aa, Aa, Aa, Aa, Aa, Cea, Cea, Kea, Kea, Kea, Cea, Cea, Aa, Aa, Tyb, Aa, Tyb, Aa, Tyb, Aa, Aa, Aa, Aa, Ms, Aa, Aa, Aa, Aa, Qxua, Qxua, Aa, Qxua, Aa, Qxua, Aa, Qxua, Qxua, Aa, Qxua, Aa
Ms, Ms, Tyb, Ms^Xm, Ms, Aa, Aa, Tyb, Ms, Aa, Aa, Ms, Ms, Ms, Ms^Xm, Aa, Aa, Aa, Ms, Aa, Aa, Aa, Tyb, Aa, Aa, Aa, Aa, Aa, Ms^Xm, Aa, Aa, Aa, Aa, Aa, Aa, Aa, Aa, Aa, Cea, Aa^Vaa, Cea, Aa^Vaa, Cea, Aa, Aa, Aa^Vaa, Tyb, Tyb, Aa, Aa, Aa, Tyb, Tyb, Aa, Aa, Aa, Aa, Aa, Qxua, Qxua, Aa, Aa, Ms, Aa, Ms, Ms^Xm, Ms, Ms, Ms, Qxua, Aa, Qxua
Tyb, Tyb, Ms, Ms, Ms, Aa, Tyb, Ms, Ms, Ms, Aa, Aa, Ms, Ms, Ms^Xm, Ms, Ms, Ms^Xm, Ms, Ms, Aa, Tyb, Aa, Tyb, Aa, Aa, Ms, Ms, Ms^Xm, Ms, Aa, Aa, Qxua, Qxua, Aa, Aa, Aa, Aa, Aa, Cea, Aa, Cea, Aa, Aa, Aa, Tyb, Tyb, Aa, Aa, Aa, Aa, Aa, Tyb, Aa, Tyb, Aa, Aa, Aa, Aa, Aa, Ms, Ms, Ms, Ms, Ms, Ms, Ms, Ms^Xm, Ms, Ms, Ms, Aa
Aa, Tyb, Aa, Ms, Aa, Aa, Tyb, Ms, Ms^Xm, Ms, Ms, Aa, Aa, Ms, Ms, Ms, Ms^Xm, Ms, Ms, Ms, Aa, Tyb, Aa, Aa, Aa, Aa, Ms, Ms^Xm, Ms, Ms, Aa, Aa, Qxua, Aa, Aa, Aa, Tyb, Aa, Aa, Aa, Tyb, Aa, Aa, Aa, Aa, Aa, Aa, Tyb, Aa, Aa, Aa, Tyb, Aa, Aa, Tyb, Aa, Qxua, Aa, Aa, Aa, Ms, Ms, Ms, Ms, Ms, Ms, Ms, Ms, Ms^Xm, Ms, Ms, Aa
Aa, Tyb, Tyb, Aa, Aa, Aa, Tyb, Ms, Ms^Xm, Ms, Ms, Aa, Aa, Aa, Aa, Ms, Ms, Ms, Ms, Ms, Aa, Tyb, Aa, Aa, Aa, Aa, Ms, Ms, Aa, Aa, Aa, Aa, Qxua, Aa, Aa, Aa^Vaa, Tyb, Aa, Aa, Tyb, Aa, Aa, Aa, Aa, Tyb, Aa, Tyb, Aa, Tyb, Aa, Aa, Tyb, Aa, Tyb, Aa, Aa, Qxua, Aa, Aa, Aa, Aa, Ms, Ms, Ms, Aa, Aa, Aa, Ms, Ms, Ms, Ms, Ms
Aa, Aa, Aa, Aa, Aa, Aa, Ms, Ms, Ms, Ms, Ms, Aa, Tyb, Aa, Aa, Aa, Aa, Aa, Tyb, Aa, Aa, Aa, Aa, Aa, Aa, Aa, Ms, Ms, Aa, Aa, Aa, Qxua, Aa, Aa, Tyb, Tyb, Tyb, Tyb, Aa, Tyb, Tyb, Aa, Aa, Tyb, Aa, Aa, Aa, Aa, Aa, Tyb, Aa, Aa, Aa, Aa, Aa, Aa, Qxua, Aa, Aa, Aa, Aa, Aa, Aa, Aa, Aa, Aa, Tyb, Aa, Aa, Ms, Ms, Ms
Ms, Ms, Ms, Aa, Ms, Ms, Ms, Ms^Xm, Ms, Ms, Aa, Aa, Tyb, Aa, Ms, Aa, Aa, Aa, Tyb, Tyb, Aa, Aa, Aa, Aa, Tyb, Aa, Aa, Aa, Aa, Aa, Aa, Qxua, Qxua, Aa, Aa, Aa, Aa, Aa, Tyb, Tyb, Aa, Aa, Aa, Aa^Vaa, Tyb, Tyb, Aa, Aa, Aa, Aa, Aa, Aa, Tyb, Aa, Aa, Qxua, Aa, Aa, Aa, Aa, Aa, Aa, Aa, Aa, Aa, Tyb, Tyb, Aa, Aa, Ms, Ms, Ms
Ms, Ms, Ms, Aa, Ms, Ms, Ms^Xm, Ms^Xm, Ms, Ms, Aa, Aa, Aa, Tyb, Tyb, Ms, Aa, Aa, Aa, Aa, Aa, Aa, Aa, Tyb, Aa, Aa, Tyb, Aa, Aa, Aa, Aa, Aa, Aa, Aa, Qxua, Aa, Aa, Aa, Aa, Aa, Tyb, Aa, Tyb, Aa, Aa, Aa, Aa, Aa, Aa, Aa, Aa, Tyb, Tyb, Aa, Aa, Aa, Aa, Tyb, Aa, Aa, Ms, Ms, Ms, Ms, Ms, Aa, Aa, Tyb, Aa, Ms, Ms, Ms
Ms, Ms, Aa, Aa, Aa, Ms, Ms^Xm, Ms, Ms, Aa, Aa, Tyb, Aa, Ms, Ms, Ms, Aa, Aa, Aa, Aa, Tyb, Aa, Aa, Aa, Aa, Tyb, Aa, Aa, Aa, Tyb, Aa, Aa, Aa, Aa, Aa, Qxua, Qxua, Aa, Aa, Aa, Tyb, Tyb, Aa, Tyb, Aa, Aa, Aa, Aa, Tyb, Tyb, Aa, Aa, Aa, Aa, Qxua, Aa, Aa, Tyb, Tyb, Aa, Ms, Ms, Ms^Xm, Ms, Ms, Ms, Ms, Aa, Aa, Aa, Aa, Aa
Ms, Ms, Aa, Aa, Ms, Ms, Ms, Ms, Ms, Aa, Aa, Tyb, Aa, Aa, Ms, Ms, Aa, Tyb, Aa, Aa, Aa, Tyb, Tyb, Aa, Aa, Tyb, Tyb, Aa, Aa, Tyb, Aa, Aa, Aa, Aa, Aa, Aa, Qxua, Aa, Aa^Vaa, Aa, Aa, Aa, Aa, Aa, Aa, Aa, Aa, Aa, Aa, Tyb, Tyb, Aa, Aa, Qxua, Aa, Aa, Aa, Aa, Aa, Tyb, Ms, Ms, Ms^Xm, Ms^Xm, Ms^Xm, Ms, Ms, Ms, Aa, Aa, Aa, Aa
Ms, Ms, Ms, Ms, Ms, Ms, Ms, Ms, Aa, Aa, Tyb, Aa, Aa, Aa, Ms, Ms, Aa, Tyb, Tyb, Tyb, Aa, Aa, Aa, Tyb, Aa, Aa, Aa, Aa, Aa, Aa, Aa, Aa^Vaa, Aa, Aa, Qxua, Qxua, Aa, Aa, Aa, Aa, Aa, Aa, Aa, Tyb, Tyb, Aa, Aa, Aa, Aa, Aa, Tyb, Tyb, Aa, Qxua, Aa, Aa, Tyb, Aa, Aa, Tyb, Tyb, Ms, Ms, Ms, Ms, Ms, Ms, Ms, Aa, Aa, Tyb, Aa
Ms, Ms, Ms, Ms, Ms, Ms, Ms, Aa, Tyb, Tyb, Aa, Aa, Aa, Ms, Ms, Ms, Aa, Aa, Aa, Aa, Aa, Aa, Tyb, Tyb, Aa, Aa, Aa, Aa, Tyb, Aa, Aa, Aa, Aa, Aa, Qxua, Aa, Aa, Aa, Aa, Qxu, Qxu, Aa, Aa, Aa, Aa, Tyb, Aa, Aa, Tyb, Tyb, Aa, Aa, Aa, Aa, Aa, Aa, Aa, Aa, Tyb, Aa, Aa, Aa, Aa, Ms, Aa, Ms, Aa, Aa, Aa, Aa, Tyb, Aa
Ms, Ms, Ms, Ms, Ms, Ms, Aa, Aa, Tyb, Tyb, Aa, Aa, Ms, Ms, Ms, Aa, Aa, Aa, Aa, Aa, Aa, Aa, Aa, Aa^Vaa, Aa, Aa, Tyb, Tyb, Aa, Aa, Qxua, Qxua, Aa, Aa, Aa, Aa, Aa, Aa, Aa, Qxu, Aa, Aa, Qxu, Aa, Aa, Tyb, Aa, Aa^Vaa, Aa, Aa, Aa, Aa, Qxua, Aa, Aa, Aa, Aa, Aa, Tyb, Aa, Aa, Aa, Tyb, Aa, Aa, Aa, Aa, Aa, Tyb, Aa, Aa, Aa
Aa, Aa, Tyb, Ms, Tyb, Tyb, Aa, Aa, Aa, Tyb, Aa, Ms, Aa, Aa, Aa, Aa, Aa, Qxua, Qxua, Aa, Qxua, Aa, Aa, Aa, Aa, Aa, Aa, Aa, Qxua, Aa, Aa, Aa, Aa, Tyb, Tyb, Tyb, Aa, Aa, Aa, Aa, Tyb, Aa, Qxu, Aa, Aa, Aa, Aa, Aa, Aa, Aa, Aa, Aa, Qxua, Aa, Aa, Aa, Aa, Aa, Tyb, Aa, Aa, Tyb, Aa, Tyb, Tyb, Aa, Aa, Tyb, Tyb, Aa, Aa, Aa
Aa, Aa, Aa, Tyb, Aa, Aa, Aa, Aa, Aa, Aa, Qxua, Aa, Qxua, Aa, Aa, Aa, Qxua, Qxua, Aa, Aa, Aa, Qxua, Aa, Aa, Aa, Aa, Aa, Aa, Qxua, Aa, Aa, Aa, Tyb, Aa, Aa, Aa, Aa, Aa, Aa, Tyb, Aa, Aa, Aa, Qxu, Qxu, Aa, Aa, Aa, Qxua, Qxua, Qxua, Qxua, Aa, Aa, Qxua, Aa, Aa, Tyb, Aa, Aa, Aa, Aa, Aa, Aa, Aa, Aa, Aa, Aa, Aa, Aa, Aa, Aa
Qxua, Aa, Aa, Aa, Aa, Aa, Qxua, Qxua, Qxua, Aa, Aa, Qxua, Aa, Qxua, Aa, Aa, Aa, Aa, Aa, Aa, Aa, Aa, Aa^Vaa, Qxua, Qxua, Aa, Aa, Qxua, Aa, Aa, Tyb, Aa, Aa, Aa, Aa, Aa, Aa, Aa, Aa, Tyb, Tyb, Tyb, Tyb, Aa, Aa, Aa, Aa, Aa, Aa, Aa, Aa, Aa, Aa, Qxua, Qxua, Qxua, Qxua, Aa, Aa, Aa, Aa, Qxua, Qxua, Aa, Qxua, Qxua, Aa, Aa, Qxua, Aa, Qxua, Qxua
Aa, Qxua, Qxua, Qxua, Aa, Qxua, Aa, Aa, Aa, Aa, Aa, Aa, Ms, Ms^Xm, Ms, Aa, Aa, Aa, Aa, Aa, Aa, Aa, Aa, Aa, Aa, Aa, Qxua, Qxua, Aa, Tyb, Aa, Aa, Tyb, Tyb, Aa, Aa, Aa, Aa, Aa, Aa, Aa, Tyb, Aa, Aa, Aa, Tyb, Aa, Aa, Aa, Aa, Ai, Aa, Aa, Aa, Aa, Aa, Aa, Aa, Qxua, Qxua, Aa, Aa, Aa, Qxua, Aa, Aa, Aa, Qxua, Aa, Qxua, Aa, Aa
Aa, Aa, Aa, Aa, Aa, Aa, Aa, Aa, Aa, Aa, Ms, Ms^Xm, Ms, Ms, Ms, Aa, Tyb, Tyb, Aa, Qxua, Aa, Aa, Aa, Aa, Aa, Aa, Aa, Aa, Aa, Aa, Aa, Aa, Aa, Aa, Cw, Kw, Rrc, Aa, Rrc, Kw, Cw, Aa, Aa, Aa, Aa, Aa, Aa, Aa, Aa, Aa, Ai, Ai, Ai, Aa, Aa, Aa, Qxua, Qxua, Aa, Aa, Aa, Aa, Aa, Aa, Aa, Aa, Aa, Aa, Tyb, Aa, Aa, Aa
Ms, Aa, Aa, Tyb, Aa, Tyb, Tyb, Aa, Aa, Aa, Ms, Ms, Ms, Ms, Tyb, Aa, Tyb, Aa, Qxua, Qxua, Aa, Aa, Ai, Ai, Ai^Ii, Ai, Ai, Aa, Aa, Aa, Cw, Aa, Cw, Aa, Cw, Rrc, Rrc, Rrc, Rrc, Rrc, Cw, Aa, Cw, Aa, Cw, Aa, Aa, Aa, Aa, Ai, Wwg^Ii, Wwg^Ii, Ai^Ii, Ai, Aa, Aa, Qxua, Aa, Aa, Aa, Tyb, Aa, Tyb, Aa, Aa, Aa, Aa, Aa, Tyb, Aa, Aa, Aa
Ms, Ms, Ms, Tyb, Tyb, Aa, Tyb, Aa, Aa, Ms, Ms, Ms^Xm, Ms, Tyb, Aa, Aa, Aa, Aa, Aa, Qxua, Aa, Aa, Ai, Wwg^Ii, Wwg^Ii, Wwg^Ii, Wwg, Wwg, Wwg, Cw, Rrc, Cw, Rrc, Cw, Rrc, Rrc, Rrc^Vhca, Rrc, Rrc^Vhca, Rrc, Rrc, Cw, Rrc, Cw, Rrc, Cw, Wwg, Wwg, Wwg, Ai, Wwg^Ii, Wwg^Ii, Ai^Ii, Ai, Aa, Aa, Aa, Aa, Tyb, Tyb, Aa, Aa, Aa, Tyb, Aa, Aa, Aa, Tyb, Tyb, Aa, Aa, Aa
Ms, Ms, Ms, Aa, Aa, Aa, Tyb, Aa, Aa, Ms, Ms, Ms, Ms, Tyb, Aa, Aa, Tyb, Tyb, Aa, Aa, Aa, Ai, Ai, Wwg^Ii, Wwg^Ii, Ai^Ii, Aa, Aa, Kw, Wwg, Wwg, Rrc, Wwg^Ii, Rrc, Rrc, Rrc, Rrc, Rrc, Rrc, Rrc, Rrc, Rrc, Wwg^Ii, Rrc, Wwg, Wwg, Kw, Aa, Aa, Wwg, Ai, Ai^Ii, Aa^Vaa, Aa, Aa, Aa, Aa, Aa, Aa, Aa, Aa, Aa, Aa, Aa, Aa, Aa, Tyb, Tyb, Aa, Aa, Aa, Aa
Ms, Ms, Ms, Aa, Aa, Tyb, Tyb, Aa, Aa, Ms, Ms, Ms, Ms, Aa, Aa, Tyb, Aa, Aa, Aa, Aa, Aa, Aa, Aa, Ai, Ai, Ai, Aa, Aa, Cw, Rrc, Rrc, Cw^Gvs, Kw, Cw^Gvs, Rrc, Rrc, Rrc, Rrc, Rrc, Rrc, Rrc, Cw^Gvs, Kw, Cw^Gvs, Rrc, Rrc, Cw, Aa, Aa, Aa, Aa, Ai, Aa, Aa, Qxua, Aa, Aa, Aa, Aa, Aa, Aa, Tyb, Tyb, Tyb, Aa, Aa, Aa, Aa, Aa, Aa, Ms, Ms
Ms, Ms, Ms, Ms, Ms, Aa, Aa, Aa, Aa, Tyb, Ms, Ms, Ms, Tyb, Aa, Aa, Aa, Aa, Qxua, Qxua, Aa, Aa^Vaa, Aa, Aa, Tyb, Aa, Aa, Aa, Cw, Rrc, Rrc, Wwg^Ii, Cw^Gvs, Wwg^Ii, Rrc, Rrc, Cw, Kw, Cw, Rrc, Rrc, Wwg^Ii, Cw^Gvs, Wwg^Ii, Rrc, Rrc, Cw, Aa, Aa, Aa, Tyb, Tyb, Aa, Aa, Aa, Qxua, Aa, Aa, Aa, Aa, Tyb, Tyb, Aa, Aa, Aa, Aa, Aa, Aa, Aa, Ms, Ms, Ms
Ms, Ms, Ms, Ms, Ms, Ms, Aa, Aa, Aa, Tyb, Tyb, Ms, Tyb, Aa, Qxua, Qxua, Aa, Aa, Qxua, Aa, Aa, Aa, Aa, Aa, Aa, Aa, Aa, Aa, Cw, Rrc, Rrc^Vhca, Rrc, Rrc, Rrc, Kw, Cw, Rrc^Vhca, Rrc^Vhca, Rrc^Vhca, Cw, Kw, Rrc, Rrc, Rrc, Rrc^Vhca, Rrc, Cw, Aa, Aa, Aa, Tyb, Aa, Aa, Aa, Aa, Qxua, Aa, Aa, Aa, Aa, Aa, Aa, Aa, Aa, Aa, Aa, Ms, Aa, Ms, Ms, Ms, Ms
Ms, Ms, Ms, Ms, Ms, Ms, Aa, Aa, Qxua, Aa, Aa, Tyb, Aa, Aa, Aa, Aa, Aa, Aa, Qxua, Aa, Aa, Aa, Tyb, Tyb, Aa, Aa, Aa, Cw, Rrc, Rrc, Rrc, Rrc, Rrc, Rrc, Cw, Rrc^Cov, Rrc^Cov, Rrc, Rrc^Cov, Rrc^Cov, Cw, Rrc, Rrc, Rrc, Rrc, Rrc, Rrc, Cw, Aa, Aa, Aa, Tyb, Tyb, Aa, Aa, Qxua, Qxua, Aa, Aa, Aa, Aa, Tyb, Aa, Aa, Aa, Ms, Ms, Ms, Ms, Ms, Ms, Ms
Ms, Ms, Aa, Ms, Qxua, Aa, Qxua, Qxua, Aa, Aa, Qxua, Aa, Qxua, Qxua, Qxua, Aa, Aa, Aa, Aa, Qxua, Qxua, Aa, Tyb, Aa, Aa, Aa, Aa, Cw, Rrc, Rrc, Rrc, Rrc, Rrc^Vhca, Rrc, Cw, Rrc^Vhca, Rrc, 3 Kw, Rrc, Rrc^Vhca, Cw, Rrc, Rrc^Vhca, Rrc, Rrc^Vhca, Rrc, Rrc, Cw, Aa, Aa, Aa, Aa, Aa, Aa, Aa, Aa, Aa, Qxua, Aa, Aa, Aa, Aa, Aa, Aa, Ms, Ms, Ms^Xm, Ms^Xm, Ms^Xm, Ms^Xm, Ms, Ms
Aa, Aa, Qxua, Qxua, Aa, Aa, Aa, Aa, Aa, Aa, Aa, Qxua, Aa, Aa, Aa, Aa, Aa, Aa, Aa, Aa, Aa, Aa, Aa, Tyb, Tyb, Aa, Aa, Cw, Cw, Rrc, Rrc^Vhca, Rrc, Rrc, Rrc, Kw, Rrc^Vhca, Rrc^Vhca, Rrc^Cov, Rrc^Vhca, Rrc^Vhca, Kw, Rrc, Rrc, Rrc, Rrc, Rrc, Cw, Cw, Aa, Aa, Aa, Aa, Aa^Vaa, Aa, Aa, Aa, Aa, Qxua, Aa, Aa, Tyb, Tyb, Aa, Aa, Ms, Ms, Ms, Ms^Xm, Ms^Xm, Ms, Ms, Ms
Qxua, Qxua, Aa, Aa, Ms, Ms, Ms, Aa, Qxua, Qxua, Aa, Aa, Tyb, Aa, Aa, Aa, Tyb, Aa, Tyb, Aa, Aa, Aa, Aa, Aa, Aa^Vaa, Aa, Aa, Aa, Cw, Rrc, Rrc, Rrc, Wwg^Ii, Rrc, Rrc, Cw, Cw, Rrc^Cov, Cw, Cw, Rrc, Rrc, Wwg^Ii, Rrc, Rrc, Rrc, Cw, Aa, Aa, Aa, Tyb, Tyb, Aa, Aa, Aa, Aa, Aa, Aa, Aa, Tyb, Aa, Aa, Aa, Aa, Ms, Ms, Ms, Ms, Ms, Ms^Xm, Ms, Ms
Aa, Aa, Aa, Aa, Ms, Ms, Ms, Aa, Aa, Aa, Aa, Aa, Aa, Tyb, Aa, Aa, Aa, Tyb, Tyb, Aa, Aa, Aa, Qxua, Aa, Aa, Aa, Aa, Aa, Cw, Rrc, Rrc, Cw^Gvs, Kw^Gvs, Cw^Gvs, Rrc, Rrc, Rrc, Kw, Rrc, Rrc, Rrc, Cw^Gvs, Kw, Cw^Gvs, Rrc, Rrc, Cw, Aa, Aa, Aa, Tyb, Aa, Aa, Aa, Aa, Aa, Qxua, Aa, Aa, Tyb, Tyb, Aa, Aa, Aa, Tyb, Ms, Ms, Ms, Ms, Ms^Xm, Ms, Ms
Aa, Qxua, Qxua, Aa, Aa, Ms, Qxua, Qxua, Ms, Ms, Ms, Tyb, Tyb, Aa, Tyb, Tyb, Aa, Aa, Tyb, Aa, Aa, Aa, Qxua, Aa, Aa, Aa, Aa, Aa, Kw, Rrc, Rrc, Wwg^Ii, Cw^Gvs, Wwg^Ii, Rrc^Vhca, Rrc, Rrc, Rrc, Rrc, Rrc, Rrc, Wwg^Ii, Cw^Gvs, Wwg^Ii, Rrc, Rrc, Kw, Aa, Aa, Tyb, Aa, Aa, Aa, Aa, Aa, Aa, Qxua, Aa, Aa, Aa, Aa, Aa, Aa, Aa, Aa, Tyb, Tyb, Ms, Ms, Ms, Ms, Ms
Aa, Aa, Ms, Qxua, Qxua, Qxua, Aa, Aa, Ms, Ms, Ms^Xm, Ms, Ms, Tyb, Aa, Tyb, Tyb, Tyb, Aa, Aa, Aa, Aa, Qxua, Aa, Aa, Aa, Aa, Aa, Aa, Cw, Cw, Rrc, Wwg, Rrc, Rrc, Rrc, Rrc, Rrc, Rrc, Rrc^Vhca, Rrc, Rrc, Wwg, Rrc, Cw, Cw, Aa, Aa, Aa, Aa, Tyb, Aa, Aa, Aa, Qxua, Qxua, Aa, Aa, Aa, Aa, Aa, Aa, Aa, Aa, Tyb, Aa, Aa, Tyb, Ms, Ms, Ms, Ms
Ms, Ms, Ms, Ms, Ms, Aa, Aa, Aa, Aa, Ms, Ms, Ms^Xm, Ms, Ms, Aa, Aa, Aa, Aa, Aa, Aa, Aa, Aa, Qxua, Aa, Aa, Aa, Aa, Aa, Aa, Aa, Wwg, Wwg, Cw, Rrc, Cw, Rrc, Rrc, Rrc, Rrc, Rrc, Cw, Rrc, Cw, Wwg, Cw, Aa, Aa, Aa, Aa, Aa, Tyb, Aa, Aa, Aa, Qxua, Aa, Aa, Aa, Aa, Aa, Tyb, Aa, Tyb, Aa, Tyb, Aa, Aa, Tyb, Tyb, Ms, Ms, Ms
Ms, Ms, Ms, Ms, Ms, Aa, Aa, Aa, Aa, Ms, Ms, Ms^Xm, Ms^Xm, Ms, Ms, Aa, Aa, Aa, Aa, Qxua, Qxua, Qxua, Aa, Aa, Aa, Aa, Aa, Aa, Aa, Wwg, Aa, Cw, Aa, Cw, Aa, Cw, Rrc, Rrc, Rrc, Cw, Aa, Cw, Aa, Wwg, Aa, Aa, Aa, Aa, Aa, Tyb, Aa, Aa, Aa, Aa, Aa, Aa, Aa, Aa, Aa, Aa, Tyb, Aa, Aa, Tyb, Aa, Aa, Aa, Tyb, Tyb, Ms, Ms, Ms
Ms^Xm, Ms, Ms^Xm, Ms, Ms, Ms, Aa, Aa, Aa, Aa, Aa, Ms, Ms, Ms, Ms, Aa, Aa, Aa, Aa, Aa, Aa, Aa, Aa, Aa, Ai, Ai, Ai, Ai, Wwg, Wwg, Aa, Aa, Aa, Aa, Aa, Kw, Aa, Aa, Aa, Kw, Aa, Aa, Aa, Wwg, Wwg, Aa, Aa, Aa, Aa, Aa, Aa, Aa, Qxua, Aa, Aa, Aa, Aa, Aa, Tyb, Aa, Aa, Tyb, Aa, Tyb, Tyb, Aa, Aa, Tyb, Aa, Ms, Ms, Ms
Ms^Xm, Ms, Ms, Ms^Xm, Ms, Ms, Aa, Aa, Aa, Aa, Aa, Ms, Ms, Ms, Aa, Tyb, Tyb, Aa, Aa, Aa, Aa, Aa, Aa, Aa, Ai, Ai, Wwg^Ii, Wwg, Ai, Aa, Aa, Aa, Tyb, Aa, Aa, Aa, Aa, Aa, Aa, Aa, Aa, Aa, Aa, Aa, Wwg, Aa, Ai, Aa, Aa, Aa, Aa, Aa, Qxua, Aa, Aa, Aa, Aa, Tyb, Aa, Aa, Aa, Aa, Aa, Aa, Tyb, Aa, Aa, Aa, Ms, Ms, Ms, Ms
Ms^Xm, Ms, Ms, Ms, Ms, Ms, Aa, Aa, Aa, Aa, Aa, Ms, Ms, Ms, Aa, Aa, Aa, Aa, Aa, Qxua, Aa, Aa, Aa, Ai, Ai, Wwg^Ii, Wwg^Ii, Ai^Ii, Ai, Aa^Vaa, Aa, Tyb, Aa, Aa, Aa, Aa, Aa, Aa, Tyb, Aa, Aa, Aa, Aa^Vaa, Ai, Wwg^Ii, Wwg^Ii, Wwg^Ii, Ai, Aa, Aa, Aa, Aa, Qxua, Aa, Aa, Aa, Aa, Tyb, Aa, Tyb, Aa, Aa, Tyb, Aa, Aa, Aa, Aa, Ms, Ms, Ms, Ms, Ms
Ms^Xm, Ms^Xm, Ms, Ms, Aa, Aa, Aa, Aa, Aa, Aa, Aa, Aa, Tyb, Tyb, Tyb, Aa, Tyb, Tyb, Aa, Qxua, Aa, Aa, Aa, Aa, Ai, Wwg^Ii, Ai^Ii, Ai^Ii, Ai, Ai, Aa, Tyb, Aa, Aa, Aa, Aa, Tyb, Aa, Aa, Tyb, Aa, Aa, Ai, Ai, Wwg^Ii, Ai^Ii, Ai^Ii, Ai, Aa, Aa, Aa, Aa, Aa, Qxua, Qxua, Aa, Aa, Aa, Aa, Tyb, Aa, Aa, Tyb, Aa, Aa, Aa, Tyb, Ms, Ms, Ms, Ms, Ms
Ms^Xm, Ms, Ms, Aa, Aa, Aa, Ms, Ms, Ms, Aa, Aa, Tyb, Aa, Tyb, Aa, Aa, Tyb, Aa, Aa, Qxua, Aa, Aa, Aa, Aa, Aa, Ai, Ai, Ai, Ai, Aa, Tyb, Tyb, Aa, Tyb, Tyb, Tyb, Tyb, Aa, Aa, Tyb, Aa, Aa, Aa, Ai, Wwg, Ai^Ii, Ai, Aa, Aa, Aa, Aa, Aa, Aa, Aa, Aa, Qxua, Qxua, Aa, Aa, Aa, Aa, Aa, Aa, Tyb, Tyb, Aa, Tyb, Ms, Ms, Ms, Ms, Ms
Ms, Ms, Tyb, Aa, Aa, Aa, Ms, Ms, Ms^Xm, Ms, Aa, Aa, Aa, Tyb, Aa, Tyb, Aa, Aa, Aa, Qxua, Qxua, Aa, Aa, Aa, Aa, Ai, Aa, Aa, Aa, Aa, Aa, Aa, Aa, Aa, Aa, Aa, Aa, Aa, Tyb, Tyb, Aa, Aa, Aa, Ai, Ai, Ai, Aa, Aa, Qxu, Qxu, Aa, Aa, Aa, Aa, Aa, Aa, Aa, Aa, Aa, Qxua, Qxua, Qxua, Aa, Aa, Aa, Aa, Aa, Ms, Ms, Ms, Ms, Ms
Ms, Ms, Tyb, Tyb, Aa, Aa, Ms, Ms, Ms^Xm, Ms, Tyb, Tyb, Tyb, Aa, Aa, Aa, Aa, Aa, Aa, Aa, Aa, Qxua, Aa, Aa, Aa, Aa, Aa, Aa, Aa, Aa, Qxua, Aa, Tyb, Aa, Aa, Aa, Aa, Aa, Aa, Aa, Aa, Aa, Aa, Aa, Aa, Aa, Qxu, Qxu, Aa, Aa, Aa, Aa, Aa, Aa, Aa, Aa, Aa, Aa^Vaa, Aa, Aa, Aa, Qxua, Qxua, Aa, Aa, Aa, Tyb, Aa, Ms, Ms, Ms, Ms
Ms, Ms, Tyb, Aa, Tyb, Aa, Ms, Ms^Xm, Ms, Aa, Aa, Aa, Aa, Ms, Ms, Aa, Tyb, Tyb, Aa, Aa, Aa, Aa, Aa, Aa, Qxua, Qxua, Qxua, Qxua, Qxua, Qxua, Aa, Aa, Tyb, Aa, Qxu, Qxu, Qxu, Aa, Aa, Aa, Qxu, Qxu, Aa, Qxu, Qxu, Qxu, Aa, Aa, Aa, Aa, Aa, Aa, Tyb, Tyb, Aa, Aa, Aa, Aa, Aa, Aa, Aa, Aa, Qxua, Aa, Aa, Aa, Tyb, Aa, Ms, Ms, Ms, Ms
Ms, Ms, Tyb, Aa, Tyb, Aa, Aa, Ms, Aa, Aa, Aa, Aa, Aa, Ms, Ms, Ms, Tyb, Tyb, Tyb, Aa, Aa, Aa^Vaa, Aa, Aa, Aa, Aa, Aa, Aa, Aa, Aa, Aa, Aa, Aa, Aa, Aa, Aa, Aa, Qxu, Qxu, Qxu, Aa, Aa, Aa, Aa, Aa, Aa, Aa, Aa, Aa, Aa, Aa, Aa, Aa, Aa, Aa, Tyb, Aa, Aa, Tyb, Aa, Aa, Aa, Aa, Aa, Aa, Aa, Aa, Aa, Aa, Ms, Ms, Ms
Tyb, Tyb, Aa, Aa, Aa, Aa, Tyb, Aa, Aa, Tyb, Aa, Aa, Aa, Aa, Ms, Ms, Ms^Xm, Aa, Aa, Aa, Aa, Aa, Aa, Aa, Aa, Aa, Aa, Aa, Aa, Aa, Tyb, Aa, Aa, Tyb, Tyb, Aa, Aa, Aa, Aa, Aa, Aa, Aa, Aa, Aa, Aa, Aa, Aa, Aa, Aa, Aa, Tyb, Tyb, Aa, Tyb, Tyb, Aa, Aa, Aa, Aa, Tyb, Aa, Aa, Aa, Aa, Qxua, Aa, Aa, Aa, Aa, Aa, Aa, Ms
Aa, Aa, Tyb, Aa, Aa, Aa, Aa, Aa, Tyb, Tyb, Aa, Aa^Vaa, Aa, Aa, Ms, Ms, Ms, Ms, Ms, Aa, Aa, Aa, Aa, Qxua, Aa, Aa, Tyb, Aa, Tyb, Tyb, Aa, Tyb, Aa, Aa, Tyb, Aa, Tyb, Aa, Aa, Aa, Tyb, Aa, Aa, Aa, Aa, Aa^Vaa, Aa, Aa, Aa, Aa, Aa, Aa, Aa, Tyb, Aa, Tyb, Tyb, Aa, Aa, Tyb, Aa, Aa, Aa, Aa, Aa, Qxua, Qxua, Aa, Aa, Aa, Aa, Aa
Tyb, Tyb, Aa, Aa, Aa, Aa, Aa, Aa, Aa, Tyb, Aa, Aa, Aa, Aa, Aa, Ms, Aa, Aa, Aa, Aa, Aa, Aa, Qxua, Qxua, Aa, Aa, Tyb, Aa, Aa, Aa, Tyb, Tyb, Aa, Aa, Aa, Aa, Tyb, Aa, Tyb, Tyb, Aa, Tyb, Aa, Aa, Aa, Aa, Aa, Aa, Aa, Aa, Tyb, Aa, Aa, Aa, Aa, Aa, Aa, Aa, Tyb, Tyb, Aa, Aa, Aa, Aa, Aa, Aa, Aa, Qxua, Qxua, Aa, Qxua, Aa
Tyb, Aa, Aa, Aa, Ms, Ms, Ms, Aa, Aa, Aa, Aa, Aa, Ms, Aa, Aa, Aa, Aa, Aa, Aa, Aa, Aa, Aa, Qxua, Aa, Aa, Aa, Aa, Tyb, Aa, Tyb, Tyb, Aa, Aa, Aa, Tyb, Aa, Aa, Aa, Aa, Aa, Aa, Aa, Aa, Aa, Aa, Aa, Aa, Aa, Aa, Aa, Aa, Aa, Tyb, Aa, Tyb, Aa, Tyb, Tyb, Aa, Aa, Aa, Tyb, Tyb, Aa, Aa, Aa, Aa, Aa, Aa, Qxua, Qxua, Qxua
Aa, Aa, Tyb, Aa, Ms, Ms, Ms, Aa, Aa, Aa, Tyb, Aa, Aa, Ms, Ms, Aa, Aa, Aa, Ms, Aa, Aa, Aa, Aa, Aa, Aa, Aa, Ms, Aa, Aa, Aa, Ms, Aa, Aa, Aa, Tyb, Aa^Vaa, Aa, Aa, Tyb, Aa, Aa, Aa, Ms, Aa, Aa, Aa, Aa, Aa, Ms, Aa, Aa, Aa, Aa, Tyb, Aa, Aa, Aa, Aa, Aa, Aa, Aa, Aa, Aa, Tyb, Tyb, Aa, Aa, Aa, Aa, Aa, Aa, Aa
Aa, Tyb, Aa, Aa, Ms, Ms, Ms, Ms^Xm, Ms^Xm, Aa, Aa, Aa, Tyb, Ms, Ms, Ms, Ms, Ms, Ms, Ms, Ms, Aa, Qxua, Aa, Aa, Ms, Ms, Tyb, Aa, Tyb, Ms, Ms, Aa, Aa, Aa, Tyb, Aa, Aa^Vaa, Tyb, Aa, Ms, Ms, Ms, Ms, Ms, Aa, Ms, Ms, Ms, Ms, Aa, Aa, Aa, Aa, Aa, Tyb, Aa, Aa, Aa, Aa, Aa, Aa, Aa, Aa, Tyb, Aa, Aa, Aa, Aa, Aa, Aa, Aa
Aa, Tyb, Tyb, Aa, Aa, Ms, Ms, Ms, Ms^Xm, Ms, Ms, Aa, Tyb, Aa, Ms, Ms, Ms, Ms, Aa, Aa, Aa, Aa, Qxua, Aa, Ms, Ms, Tyb, Tyb, Aa, Tyb, Tyb, Ms, Aa, Aa^Vaa, Aa, Aa, Aa, Aa, Aa, Tyb, Ms, Ms, Ms, Ms, Ms, Ms, Ms, Ms, Ms, Ms, Aa, Aa, Aa, Aa, Aa, Tyb, Tyb, Aa, Aa, Tyb, Tyb, Aa, Tyb, Aa, Aa, Aa, Aa, Aa, Ms, Ms, Ms, Aa
Aa, Aa, Aa, Aa, Aa, Aa, Aa, Ms, Ms, Ms, Ms, Aa, Tyb, Aa, Tyb, Aa, Aa, Aa, Aa, Aa, Aa, Qxua, Aa, Aa, Ms, Ms, Ms, Tyb, Tyb, Tyb, Ms, Ms, Aa, Aa, Cea, Cea, Cea, Aa, Aa, Ms, Ms, Ms, Ms, Ms, Ms, Ms, Ms, Ms, Aa, Aa, Aa, Aa, Ms, Aa, Aa, Aa, Aa, Aa, Aa, Tyb, Aa, Tyb, Aa, Tyb, Aa, Aa, Aa, Aa, Ms, Ms, Ms, Ms
Ms, Aa, Aa, Aa, Tyb, Aa, Aa, Aa, Ms, Ms, Ms, Aa, Tyb, Aa, Aa, Tyb, Tyb, Aa, Aa, Aa, Aa, Qxua, Aa, Aa, Aa, Ms, Ms, Ms, Ms, Ms, Ms, Aa, Aa, Aa, Cea, Cea, Cea, Aa, Aa, Ms, Ms, Ms, Aa, Aa, Aa, Ms, Aa, Aa, Aa, Aa, Ms, Ms, Ms, Ms, Ms, Ms, Ms, Tyb, Tyb, Aa, Aa, Aa, Aa, Aa, Tyb, Aa, Ms, Ms, Ms, Ms, Ms^Xm, Ms
Ms, Ms, Aa, Aa, Aa, Tyb, Aa, Aa, Ms, Ms^Xm, Ms, Ms, Ms, Aa, Ms, Aa, Aa, Tyb, Tyb, Ms, Ms^Xm, Aa, Aa, Qxua, Qxua, Aa, Aa, Ms, Aa, Ms, Aa, Aa, Aa, Aa, Cea, 1 Kea, Cea, Aa, Aa, Aa, Aa, Aa, Aa, Aa, Aa, Aa, Aa, Aa, Aa, Aa, Ms, Ms, Ms, Ms, Ms, Ms, Ms, Tyb, Ms, Ms, Ms, Aa, Aa, Aa, Tyb, Ms, Ms, Ms, Ms, Ms, Ms^Xm, Ms
Ms^Xm, Ms, Ms, Aa, Aa, Tyb, Aa, Aa, Aa, Ms, Ms, Ms^Xm, Ms, Ms, Ms, Ms, Aa, Tyb, Ms, Ms, Ms, Ms, Ms^Xm, Aa, Aa, Qxua, Qxua, Aa, Aa, Tyb, Tyb, Aa, Aa, Aa, Aa, Cea, Aa, Aa, Aa, Aa, Aa, Aa, Aa, Aa, Aa, Aa, Ms, Ms, Ms, Ms, Ms, Ms, Ms, Ms, Ms, Ms, Ms, Ms, Ms, Ms, Ms, Aa, Tyb, Tyb, Aa, Ms, Ms, Ms, Ms, Ms^Xm, Ms^Xm, Ms
Ms^Xm, Ms, Ms, Aa, Aa, Aa, Aa, Aa, Tyb, Aa, Tyb, Ms, Ms, Ms, Ms, Ms, Tyb, Aa, Aa, Ms, Ms, Ms, Ms^Xm, Ms, Aa, Aa, Qxua, Aa, Aa, Aa, Tyb, Tyb, Aa, Aa, Aa, Aa, Aa, Aa^Vaa, Aa, Aa, Ms, Aa, Aa, Aa, Ms, Ms, Ms, Ms, Ms, Ms, Ms, Ms, Aa, Aa, Aa, Ms, Ms, Ms, Ms, Ms, Tyb, Tyb, Aa, Aa, Aa, Ms, Ms, Ms, Ms, Ms^Xm, Ms^Xm, Ms
Ms, Ms^Xm, Ms, Ms, Aa, Tyb, Aa, Aa, Ms, Aa, Aa, Tyb, Tyb, Ms, Tyb, Tyb, Aa, Aa, Aa, Aa, Ms, Ms^Xm, Ms, Ms, Aa, Qxua, Aa, Aa, Ms, Tyb, Ms, Aa, Aa, Aa^Vaa, Aa, Aa, Aa, Aa, Aa, Aa, Ms, Ms, Aa, Aa, Ms, Ms, Ms, Ms, Ms, Ms, Tyb, Tyb, Tyb, Aa, Aa, Ms, Ms, Ms, Aa, Aa, Tyb, Tyb, Aa, Aa, Aa, Aa, Ms, Ms, Ms^Xm, Ms^Xm, Ms, Ms
Ms, Ms^Xm, Ms, Ms, Tyb, Tyb, Aa, Ms, Ms, Ms, Ms, Aa, Tyb, Aa, Aa, Aa, Aa, Tyb, Tyb, Aa, Ms, Ms^Xm, Ms, Ms, Aa, Qxua, Aa, Aa, Ms, Ms, Ms, Aa, Aa, Aa, Aa, Aa, Aa, Aa, Aa, Aa, Ms, Ms, Ms, Aa, Aa, Ms, Aa, Aa, Aa, Aa, Aa, Aa, Tyb, Tyb, Tyb, Aa, Aa, Aa, Aa, Aa, Tyb, Aa, Aa, Aa, Ms, Ms, Ms^Xm, Ms^Xm, Ms, Ms, Ms, Ms
Ms, Ms, Ms, Ms, Tyb, Aa, Aa, Ms, Ms, Ms, Ms, Aa, Aa, Tyb, Aa, Aa, Tyb, Tyb, Aa, Ms, Ms, Ms, Ms, Aa, Aa, Qxua, Aa, Ms, Ms, Ms, Ms, Ms, Aa, Aa, Aa, Aa, Aa, Aa, Aa, Ms, Ms, Ms, Gg, Ms, Aa, Aa, Aa, Aa, Aa, Aa, Tyb, Tyb, Aa, Aa, Aa, Tyb, Aa, Aa, Aa, Aa, Aa, Aa, Aa, Ms, Ms, Ms^Xm, Ms^Xm, Ms, Ms, Ms, Ms, Ms
