Wot, Wot, Wot, Wot, Wot, Wot, Wot, Wot, Wwrt, Wot, Wot, Wot, Wot, Wot, Wot, Wot, Wot, Wot, Wot, Wot, Wot, Wot, Wot, Wot, Wot, Wot, Wot, Wot, Wwrt, Wot, Wot, Wwrt, Wwrt, Wot, Wot, Wot, Wot, Wot, Wot, Wot, Wwrt, Wot, Wot, Wot, Wot, Wwrt, Wot, Wot, Wot, Wot, Wwrt, Wot, Wwrt, Wot, Wwrt, Wot, Wwrt, Wot, Wot
Wwrt, Wot, Wwrt, Wot, Wot, Wwrt, Wot, Wwrt, Wot, Wwrt, Wot, Wot, Wot, Wot, Wot, Wot, Wwrt, Wwrt, Wwrt, Wot, Wot, Wot, Wot, Wot, Wot, Wot, Wwrt, Wot, Wot, Wwrt, Wot, Wot, Wot, Wwrt, Wot, Wwrt, Wot, Wot, Wwrt, Wot, Wot, Wot, Wot, Wot, Wot, Wot, Wot, Wwrt, Wot, Wot, Wot, Wot, Wot, Wwrt, Wot, Wot, Wot, Wwrt, Wot
Wot, Wot, Wot, Wot, Wot, Wot, Wot, Wot, Wot, Wot, Wot, Wot, Wot, Wot, Wwrt, Wot, Wot, Wot, Wot, Wot, Wwrt, Wot, Wot, Wot, Wot, Wot, Wwt, Wot, Wot, Wot, Wot, Wot, Wot, Wot, Wot, Wot, Wwrt, Wwrt, Wot, Wot, Wot, Wot, Wot, Wot, Wot, Wot, Wot, Wot, Wot, Wot, Wwt, Wot, Wot, Wot, Wot, Wot, Wot, Wwrt, Wot
Wot, Wot, Wot, Wot, Wot, Wot, Wot, Wot, Wot, Wot, Wot, Wwrt, Wwrt, Wot, Wot, Wot, Wot, Wot, Wot, Wot, Wwrt, Wwrt, Wwt, Wot, Wwt, Wwt, Wwt, Wwt, Wwt, Wot, Wot, Wot, Wwt, Wwt, Wwt, Wwt, Wwt, Wot, Wot, Wot, Wwt, Wwt, Wwt, Wot, Wot, Wot, Wot, Wot, Wwt, Wwt, Wwt, Wwt, Wwt, Wot, Wot, Wot, Wot, Wwt, Wot
Wot, Wot, Wot, Wot, Wot, Wot, Wwt, Wot, Wwt, Wwt, Wwt, Wwt, Wwt, Wwt, Wwt, Wwt, Wot, Wot, Wot, Wwt, Wwt, Wwt, Wwt, Wwt, Ds, Wwt, Wwt, Wwt, Wwt, Wwt, Wwt, Wwt, Wwt, Wwt, Wwt, Wwt, Wwt, Wwt, Wwt, Wwt, Wwt, Wwt, Wwt, Wwt, Wwt, Wwt, Wwt, Wwt, Wwt, Wwt, Wwt, Wwt, Wwt, Wwt, Wwt, Wot, Wot, Wwrt, Wwrt
Wwt, Wwt, Wwt, Wwt, Wwt, Wwt, Wwt, Wwt, Wwt, Wwt, Wwt, Wwt, Wwt, Wwt, Wwt, Wwt, Wot, Wot, Wwt, Wwt, Wwt, Wwt, Ds, Ds, Gll^Fdf, Ds, Ds, Ds, Wwt, Wwt, Wwt, Wwt, Ds, Wwt, Wwt, Wwt, Wwt, Wwt, Wwt, Wwt, Ds, Ds, Ds, Wwt, Wwt, Wwt, Wwt, Wwt, Ds, Ds, Wwt, Wwt, Wwt, Wwt, Wwt, Wot, Wot, Wot, Wot
Wwt, Wwt, Wwt, Wwt, Wwt, Wwt, Ds, Ds, Ds, Wwt, Ds, Ds, Ds, Wwt, Wwt, Wwt, Wwt, Wot, Wwt, Wwt, Wwt, Wwt, Ds, Gll^Fdf, Gs^Fms, Gll^Fdf, Gll^Fdf, Ds, Ds, Wwt, Ds, Wwt, Ds, Ds, Ds, Wwt, Ds, Wwt, Ds, Wwt, Ds, Gll^Fdf, Ds, Wwt, Wwt, Wwt, Wwt, Wwt, Ds, Ds, Ds, Ds, Ds, Wwt, Wwt, Wwt, Wot, Wot, Wot
Wwt, Wwt, Ds, Ds, Ds, Ds, Gll^Fdf, Gll^Fdf, Gll, Ds, Gll^Fdf, Gll^Fdf, Ds, Wwt, Wwt, Wwt, Wwt, Wwt, Wwt, Wwt, Wwt, Ds, Gll^Fdf, Gll, Gs^Fms, Gll^Fdf, Gs^Fms, Gll^Fdf, Gll^Fdf, Ds, Ds, Ds, Gll^Fdf, Gll^Fdf, Gll^Fdf, Ds, Ds, Ds, Gll^Fdf, Ds, Gll^Fdf, Gll^Fdf, Gll^Fdf, Ds, Ds, Ds, Ds, Ds, Gg, Gg, Ds, Ds, Wwt, Wwt, Wwt, Wwt, Wot, Wot, Wot
Ds, Ds, Gll^Fdf, Gll^Fdf, Gll, Gll^Fdf, Gs^Fms, Gll^Fdf, Gs^Fms, Gll^Fdf, Gll^Fdf, Gll^Fdf, Gll, Ds, Ds, Wwt, Wwt, Wwt, Wwt, Wwt, Wwt, Ds, Ds, Gll^Fdf, Gll^Fdf, Gs^Fms, Gll^Fdf, Gll^Fdf, Gll^Fdf, Gll^Fdf, Gll^Fdf, Gs^Fms, Gs^Fms, Gs^Fms, Gs^Fms, Gll^Fdf, Gll^Fdf, Gll^Fdf, Gs^Fms, Gs^Fms, Gs^Fms, Gll^Fdf, Gll^Fdf, Gll^Fdf, Gg, Gg, Gg, Gg, Gg, Gg, Ds, Wwt, Wwt, Wwt, Wot, Wot, Wot, Wot, Wot
Gll^Fdf, Gll^Fdf, Gs^Fms, Gs^Fms, Gs^Fms, Gll^Fdf, Gs^Fms, Gs^Fms, Gs^Fms, Gs^Fms, Gs^Fms, Gll, Gll^Fdf, Gll^Fdf, Ds, Wwt, Wwt, Wwt, Wwt, Wwt, Wwt, Wwt, Wwt, Ds, Ds, Gs^Fms, Gs^Fms, Gs^Fms, Gs^Fms, Gs^Fms, Gs^Fms, Gll^Fdf, Gll^Fdf, Gll^Fdf, Gll^Fdf, Gs^Fms, Gll^Fdf, Gll^Fdf, Gll^Fdf, Gll^Fdf, Gll^Fdf, Gs^Fms, Gs^Fms, Gs^Fms, Gs^Fms, Gs^Fms, Gs^Fms, Gg, Gg, Gg, Ds, Wwt, Wwt, Wot, Wot, Wot, Wot, Wot, Wot
Gll^Fdf, Gll^Fdf, Gs^Fms, Gll^Fdf, Gll^Fdf, Gll^Fdf, Gll, Gll^Fdf, Gll, Gs^Fms, Gll, Gll^Fdf, Gll^Fdf, Ds, Wwt, Wwt, Wwrt, Wwt, Wwt, Wwrt, Wwrt, Wwt, Wwt, Wwt, Ds, Gll^Fdf, Gll^Fdf, Gll^Fdf, Gll, Gs^Fms, Gs^Fms, Gs^Fms, Gs^Fms, Gll^Fdf, Gll, Gs^Fms, Gs^Fms, Gs^Fms, Gs^Fms, Gll, Gll, Gll^Fdf, Gll, Gll^Fdf, Gll^Fdf, Gll, Gll, Gs^Fms, Gll, Gg, Gg, Ds, Ds, Wwt, Wot, Wot, Wot, Wot, Wot
Gll^Fdf, Gll, Gll^Fdf, Gll, Gs^Fms, Gs^Fms, Gs^Fms, Gll^Fdf, Gs^Fms, Gs^Fms, Gll, Gll, Gll^Em, Ds, Wwt, Wwt, Wwt, Wwt, Wwt, Wwt, Wwt, Wwt, Wwt, Wwt, Ds, Gll^Fdf, Gs^Fms, Gs^Fms, Gll^Fdf, Gll, Gll^Fdf, Gll, Gll^Fdf, Gs^Fms, Gs^Fms, Gs^Fms, Gs^Fms, Gs^Fms, Gll^Fdf, Gll^Fdf, Gs^Fms, Gs^Fms, Gll^Fdf, Gll^Fdf, Gll, Gll, Gs^Fms, Gs^Fms, Gs^Fms, Gll, Gg, Ds, Ds, Wwt, Wot, Wot, Wot, Wot, Wot
Gll^Fdf, Gs^Fms, Gs^Fms, Gs^Fms, Gll, Gll^Fdf, Gs^Fms, Gll, Gll^Fdf, Gll^Fdf, Gs^Fms, Gll, Gll^Fdf, Ds, Ds, Wwt, Wwt, Wwt, Wwt, Wwt, Wwt, Wwt, Wwt, Wwt, Ds, Gg, Gll^Fdf, Gll^Fdf, Gll, Gll^Fdf, Gs^Fms, Gll^Fdf, Gs^Fms, Gll^Fdf, Gll^Fdf, Gs^Fms, Gs^Fms, Gll^Fdf, Gs^Fms, Gll, Gll, Gs^Fms, Gs^Fms, Gll, Gll^Fdf, Gll^Fdf, Gs^Fms, Gll, Gs^Fms, Gll^Fdf, Gg, Ds, Wwt, Wwt, Wwt, Wot, Wot, Wot, Wot
Gll, Gs^Fms, Gs^Fms, Gll^Fdf, Gll^Fdf, Gll^Fdf, Gll^Fdf, Gs^Fms, Gll, Gs^Fms, Gll^Fdf, Gs^Fms, Gll^Fdf, Gg, Gg, Ds, Ds, Ds, Ds, Ds, Ds, Ds, Ds, Ds, Gg, Gg, Gll^Fdf, Gll, Gs^Fms, Gs^Fms, Gll, Gs^Fms, Gs^Fms, Gll, Gs^Fms, Gll^Fdf, Gll, Gs^Fms, Gs^Fms, Gs^Fms, Gs^Fms, Gll^Fdf, Gll^Fdf, Gs^Fms, Gll, Gll^Fdf, Gll^Fdf, Gll, Gll, Gs^Fms, Gg, Ds, Ds, Wwt, Wwt, Wot, Wot, Wot, Wot
Gll, Gll^Fdf, Gll^Fdf, Gs^Fms, Gll^Fdf, Gs^Fms, Gs^Fms, Gll, Gll^Fdf, Gs^Fms, Gs^Fms, Gll, Gs^Fms, Gll^Fdf, Gll, Gg, Gg, Gg, 1 Gg, Gg, Gg, Gg, Gg, Ds, Gg, Gg, Gll, Gll, Gll^Fdf, Gll^Fdf, Gs^Fms, Gll, Gll, Gs^Fms, Gs^Fms, Gs^Fms, Gs^Fms, Gll^Fdf, Gs^Fms, Gs^Fms, Gs^Fms, Gs^Fms, Gll^Fdf, Gll^Fdf, Gs^Fms, Gs^Fms, Gs^Fms, Gll^Fdf, Gll, Gll^Fdf, Gg, Ds, Ds, Wwt, Wwt, Wwt, Wwt, Wot, Wot
Gll, Gs^Fms, Gll, Gll, Gll, Gll, Gs^Fms, Gs^Fms, Gs^Fms, Gll^Fdf, Gll^Em, Gs^Fms, Gll^Fdf, Gs^Fms, Gs^Fms, Gll, Gll^Efm, Gg, Gg, Gg, Gll^Efm, Gll, Gll^Fdf, Gg, Gll, Gll, Gll^Fdf, Gll^Fdf, Gs^Fms, Gll^Fdf, Gs^Fms, Gs^Fms, Gll^Fdf, Gll, Gs^Fms, Gs^Fms, Gs^Fms, Gll, Gs^Fms, Gll, Gll^Fdf, Gll^Fdf, Gll, Gll, Gs^Fms, Gll^Fdf, Gs^Fms, Gll, Gll^Fdf, Gs^Fms, Gg, Gg, Gg, Ds, Wwt, Wwt, Wwt, Wwt, Wwt
Gll, Gs^Fms, Gll, Gs^Em, Gll^Fdf, Gs^Fms, Gll, Gll^Fdf, Gll, Gs^Fms, Gs^Fms, Gs^Fms, Gll^Fdf, Gll, Gs^Fms, Gs^Efm, Gll^Efm, Gg^Es, Gg^Es, Gg, Gll, Gll^Efm, Gll, Gll^Fdf, Gll^Fdf, Gll^Fdf, Gll^Fdf, Gs^Fms, Gs^Fms, Gll^Fdf, Gs^Fms, Gs^Fms, Gll, Gll^Fdf, Gll^Fdf, Gll^Fdf, Gs^Fms, Gll, Gll, Gll^Fdf, Gll, Gll, Gs^Fms, Gs^Fms, Gll, Gll^Fdf, Gll^Fdf, Gll, Gs^Fms, Gs^Fms, Gs^Fms, Gll^Fdf, Gg, Ds, Ds, Wwt, Wwt, Wwt, Wwt
Gs^Fms, Gll^Fdf, Gs^Fms, Gll, Gs^Fms, Gll^Fdf, Gs^Fms, Gs^Fms, Gll^Fdf, Gll, Gll^Fdf, Gll^Fdf, Gll, Gll, Gll, Gs^Fms, Gll, Gg, Gg^Es, Gg, Gll^Efm, Gll^Efm, Gs^Fms, Gs^Fms, Gll, Gll, Gs^Fms, Gll^Fdf, Gs^Fms, Gll^Fdf, Gll, Gs^Fms, Gll^Fdf, Gll, Gs^Fms, Gs^Fms, Gll^Fdf, Gs^Fms, Gll^Fdf, Gs^Fms, Gs^Fms, Gll^Fdf, Gs^Fms, Gll^Fdf, Gll, Gs^Fms, Gll^Fdf, Gll, Gll^Fdf, Gll, Gs^Fms, Gll^Fdf, Gg, Gg, Ds, Wwt, Wwt, Wwt, Wwt
Gll^Fdf, Gs^Fms, Gll, Gs^Fms, Gs^Fms, Gs^Fms, Gll^Fdf, Gs^Fms, Gll, Gll^Em, Gll^Fdf, Gs^Fms, Gll, Gs^Fms, Gs^Fms, Gs^Fms, Gll^Es, Gg, Gg^Es, Gg, Gg^Em, Gs^Fms, Gll, Gll^Fdf, Gll, Gll^Fdf, Gll^Fdf, Gs^Fms, Gs^Fms, Gs^Fms, Gll^Fdf, Gs^Fms, Gs^Fms, Gll, Gll, Gll, Gs^Fms, Gll^Fdf, Gll^Fdf, Gs^Fms, Gll, Gll^Fdf, Gs^Fms, Gll^Fdf, Gs^Fms, Gs^Fms, Gll, Re^Vct, Gs^Fms, Gll^Fdf, Gs^Fms, Gs^Fms, Gll^Fdf, Gg, Gg, Ds, Ds, Ds, Ds
Gll, Gll^Fdf, Gs^Fms, Gll^Fdf, Gll, Gll, Gs^Fms, Gll^Fdf, Gll^Fdf, Gll, Gll, Gll^Em, Gs^Fms, Gs^Fms, Gll^Fdf, Gll^Fdf, Gll^Fdf, Gg, Gg^Es, Gg^Es, Gg, Gs^Fms, Gs^Fms, Gll^Fdf, Gs^Fms, Gll^Fdf, Gs^Fms, Gll, Gll, Gs^Fms, Gs^Fms, Gll^Fdf, Gs^Fms, Gll, Gll^Fdf, Gs^Fms, Gll, Gs^Fms, Gs^Fms, Gs^Fms, Gll^Fdf, Gll, Re^Vct, Gs^Fms, Gs^Fms, Gll, Gs^Fms, Gs^Fms, Gll^Fdf, Gll, Gs^Fms, Gs^Fms, Gs^Fms, Gs^Fms, Gs^Fms, Gg, Gg, Gg, Gg
Gll^Fdf, Gll^Fdf, Gll^Fdf, Gll, Gs^Fms, Gll^Fdf, Gll, Gll, Gll^Em, Gll^Fdf, Gll^Fdf, Gll^Fdf, Gll^Fdf, Gll, Gll, Gs^Fms, Gs^Fms, Gg, Gg, Gg^Es, Gg, Gg, Gs^Fms, Gs^Fms, Gll^Fdf, Gs^Fms, Gll, Gll^Fdf, Gll^Fdf, Gll, Gs^Fms, Gll, Gs^Fms, Gs^Fms, Gll^Fdf, Gll^Fdf, Gs^Fms, Gs^Fms, Gs^Fms, Gs^Fms, Gs^Fms, Gs^Fms, Gll, Gll, Ket, Gs^Fms, Ket, Gs^Fms, Gs^Fms, Gs^Fms, Gll^Fdf, Gs^Fms, Gll, Gs^Fms, Gll, Gll^Fdf, Gll^Fdf, Gg, Gg
Gll^Fdf, Gll, Gll^Fdf, Gll, Gll^Em, Gs^Fms, Gll^Fdf, Gll, Gll, Gll^Fdf, Gs^Fms, Gs^Fms, Gs^Fms, Gll^Em, Gll^Fdf, Gll^Fdf, Gs^Fms, Gs^Fms, Gg^Efm, Gg^Es, Gg, Gg, Gs^Fms, Gll^Fdf, Gll^Fdf, Gll^Fdf, Gll^Fdf, Gll, Gs^Fms, Gs^Fms, Gs^Fms, Gs^Fms, Gll^Fdf, Gll, Gll^Fdf, Gs^Fms, Gs^Fms, Gs^Fms, Gs^Fms, Gll, Gs^Fms, Gll^Fdf, Gll^Fdf, Gs^Fms, Gs^Cov, Gs^Cov, Gs^Cov, Gs^Cov, Gs^Fms, Gll^Fdf, Gs^Fms, Gll, Gll^Fdf, Gll, Gll, Gs^Fms, Gs^Fms, Gll^Fdf, Gll^Fdf
Gll^Fdf, Gs^Fms, Gll^Fdf, Gs^Fms, Gll^Fdf, Gs^Fms, Gll^Fdf, Gs^Fms, Gll^Fdf, Gs^Fms, Gll^Fdf, Gll^Fdf, Gll, Gs^Fms, Gll^Fdf, Gll, Gs^Fms, Gll^Efm, Gg^Efm, Gg^Es, Gg, Gg, Gll^Efm, Gs^Fms, Gll, Gll, Gs^Fms, Gll, Gs^Fms, Gs^Fms, Gll^Fdf, Gs^Fms, Gll^Fdf, Gs^Fms, Gs^Fms, Gs^Fms, Gll^Fdf, Gs^Fms, Gll^Fdf, Gll^Fdf, Gll, Gll, Gll^Fdf, Gs^Cov, Gll^Cov, Ket, Gs^Cov, Gll, Gll, Gll^Fdf, Re^Vct, Gll^Fdf, Gs^Fms, Gll, Gll^Fdf, Gll, Gs^Fms, Gs^Fms, Gll^Fdf
Gll^Fdf, Gll, Gll^Fdf, Gll, Gs^Fms, Gll, Gs^Fms, Gs^Fms, Gs^Fms, Gll, Gll^Fdf, Gs^Fms, Gll, Gs^Fms, Gll, Gll, Gs^Fms, Gll^Fdf, Gg^Es, Gg, Gg^Es, Gg^Es, Gg, Gll^Efm, Gll^Fdf, Gs^Fms, Gs^Fms, Gs^Fms, Gll^Fdf, Gll^Fdf, Gll^Fdf, Gs^Fms, Gll^Efm, Gll^Fdf, Gs^Fms, Gll, Gll, Gll^Fdf, Gll^Efm, Gll^Fdf, Gg, Gg, Gg, Gll, Gs^Fds, Gll^Cov, Gs^Cov, Gll, Gs^Fms, Gs^Fms, Gs^Fms, Gll^Fdf, Gll^Fdf, Gs^Fds, Gll^Fdf, Gs^Fms, Gs^Fms, Gs^Fms, Gll^Fdf
Gll, Gll, Gll, Gs^Fms, Gll^Fdf, Gll^Fdf, Gll^Fdf, Gs^Fms, Gll^Fdf, Gll^Fdf, Gll^Fdf, Gll^Fdf, Gs^Fms, Gs^Fms, Gll, Gll^Fdf, Gll, Gs^Fms, Gll, Gg, Gg, Gg^Em, Gg, Gll, Gll, Gs^Fms, Gll^Fdf, Gll^Efm, Gll^Efm, Gll^Efm, Gs^Fms, Gll^Fdf, Gg, Gll^Efm, Gs^Fms, Gll^Fdf, Gs^Fms, Gll^Fdf, Gg, Gg, Gg^Es, Gg^Em, Gg^Es, Gg, Gs^Fds, Gll, Gll, Gll^Fdf, Gs^Fms, Gll, Gs^Fms, Gs^Fms, Gll^Fdf, Gs^Fds, Gll, Gll, Gll^Fdf, Gll^Fdf, Gll^Fdf
Gll, Gs^Fms, Gs^Fms, Gs^Fms, Gll^Fdf, Gs^Fms, Gll^Fdf, Gs^Fms, Gs^Fms, Gs^Fms, Gll^Fdf, Gs^Fms, Gll^Fdf, Gll, Gll^Fdf, Gll^Fdf, Gll^Fdf, Gll^Fdf, Gs^Fms, Gll^Es, Gg, Gg, Gg^Es, Gg, Gg, Gll^Es, Gg, Gg^Es, Gg, Gg, Gg^Es, Gs^Fms, Gg, Gg, Gg^Es, Gll^Efm, Gg, Gg, Gg, Gg^Efm, Gg^Efm, Gg, Gg, Gg, Gll, Gs^Fds, Re^Vct, Gs^Fds, Gll, Gs^Fms, Gll^Fdf, Gll^Fdf, Gll, Gs^Fds, Gs^Fds, Gll^Fdf, Gs^Fds, Gll, Gll
Gll^Fdf, Gs^Fms, Gll^Fdf, Gs^Fms, Gll^Fdf, Gll^Fdf, Gs^Fms, Gs^Fms, Gll^Fdf, Gll, Gll^Fdf, Gll, Gll^Fdf, Gll^Fdf, Gll^Fdf, Gs^Fms, Gll^Fdf, Gll, Gll, Gs^Fms, Gs^Fms, Gg^Em, Gg, Gg, Gg^Es, Gg, Gg^Es, Gg^Em, Gg, Gg, Gg, Gg^Es, Gg^Es, Gg^Es, Gg, Gg^Es, Gg^Efm, Gg, Gg, Gg^Es, Gg^Efm, Gg, Gg, Gg, Gll, Gs^Fds, Gs^Fds, Gll, Gll^Fdf, Gll^Fdf, Gll^Fdf, Gs^Fds, Gs^Fds, Gll, Gll, Gs^Fds, Gll, Gs^Fds, Gll
Gs^Fms, Gll^Fdf, Gll, Gll, Gs^Fms, Gs^Fms, Gll, Gll^Fdf, Gll^Fdf, Gs^Fms, Gs^Fms, Gs^Fms, Gs^Fms, Gll^Fdf, Gs^Fms, Gll^Fdf, Gs^Fms, Gs^Fms, Gs^Fms, Gll^Fdf, Gll, Gll^Efm, Gs^Fms, Gg^Es, Gg, Gg, Gg^Es, Gg^Es, Gg, Gg^Es, Gg, Gg, Gg, Gg, Gg^Es, Rb, Gg, Gg^Efm, Gg^Es, Gg, Gg, Gg, Gg, Gg^Efm, Gll^Fdf, Gs^Fds, Gll^Fdf, Gll^Fdf, Gll^Fdf, Gll^Fdf, Gll^Fdf, Gll^Fdf, Gs^Fds, Gll^Fdf, Gs^Fds, Gs^Fds, Gll, Gs^Fds, Gs^Fds
Gs^Fms, Gll^Fdf, Gll, Gll^Fdf, Gll^Fdf, Gs^Fms, Gs^Fms, Gs^Fms, Gll, Gs^Fms, Gs^Fms, Gll^Fdf, Gll^Fdf, Gll, Gs^Fms, Gs^Fms, Gll, Gll^Fdf, Gll^Fdf, Gs^Fms, Gll, Gll^Efm, Gll^Fdf, Gs^Fms, Gll^Efm, Gll^Efm, Gll, Gg, Gll, Gg, Gs^Fms, Gg^Es, Gs^Fms, Gg, Gll^Em, Gll, Gg, Gg^Efm, Gg^Efm, Gg, Gg^Em, Gg, Gg^Es, Gg^Efm, Gll^Fdf, Gll^Fdf, Hhd^Fdf, Hhd^Fdf, Hhd^Fdf, Gll^Fdf, Hhd^Fdf, Gll^Fdf, Gll^Fdf, Gs^Fds, Gs^Fds, Gs^Fds, Gll^Fdf, Gll, Gs^Fds
Gll^Fdf, Gs^Fms, Gs^Fms, Gs^Fms, Gll^Fdf, Gll, Gll, Gll^Fdf, Gll^Fdf, Gll^Fdf, Gll^Fdf, Gll^Fdf, Gs^Fms, Gll^Fdf, Gll^Fdf, Gll^Fdf, Gll^Fdf, Gll^Fdf, Gll^Fdf, Gll^Fdf, Gll^Fdf, Gll^Fdf, Gll^Fdf, Gll^Fdf, Gs^Fms, Gs^Fms, Gs^Fms, Gll^Fdf, Gs^Fms, Gs^Fms, Gll^Fdf, Gll^Efm, Gll^Fdf, Gll^Fdf, Gs^Fds, Gll^Fdf, Gll^Fdf, Gg, Gll, Gg, Gg, Gg, Gg, Gg, Hhd^Fdf, Hhd^Fdf, Mm, Hhd^Fdf, Mm, Hhd^Fdf, Mm, Hhd^Fdf, Hhd^Fdf, Gll^Fdf, Gll^Fdf, Gll^Fdf, Gll^Fdf, Gs^Fds, Gs^Fds
Gll^Fdf, Gll^Fdf, Gll^Fdf, Gll, Gll^Fdf, Gll^Fdf, Gll^Fdf, Gll^Fdf, Gll^Fdf, Gll^Fdf, Gll^Fdf, Gll^Fdf, Gll^Fdf, Gll^Fdf, Gll^Fdf, Gll^Fdf, Gll^Fdf, Hhd^Fdf, Hhd^Fdf, Hhd^Fdf, Hhd^Fdf, Hhd^Fdf, Hhd^Fdf, Gll^Fdf, Gll^Fdf, Gll^Fdf, Gll^Fdf, Gs^Fms, Gs^Fms, Gll^Fdf, Gs^Fms, Gll^Fdf, Gs^Fms, Gs^Fms, Gs^Fms, Gs^Fds, Gll^Fdf, Gs^Fds, Gll^Fdf, Gll^Fdf, Gs^Fds, Gg^Es, Gg, Gg, Hhd^Fdf, Mm, Mm^Xm, Mm, Mm, Mm, Mm, Hhd^Fdf, Hhd^Fdf, Hhd^Fdf, Hhd^Fdf, Hhd^Fdf, Hhd^Fdf, Gll^Fdf, Gll^Fdf
Hhd^Fdf, Gll^Fdf, Hhd^Fdf, Gll^Fdf, Hhd^Fdf, Hhd^Fdf, Hhd^Fdf, Hhd^Fdf, Hhd^Fdf, Hhd^Fdf, Hhd^Fdf, Hhd^Fdf, Hhd^Fdf, Gll^Fdf, Hhd^Fdf, Gll^Fdf, Hhd^Fdf, Hhd^Fdf, Hhd^Fdf, Hhd^Fdf, Hhd^Fdf, Hhd^Fdf, Hhd^Fdf, Hhd^Fdf, Hhd^Fdf, Hhd^Fdf, Hhd^Fdf, Gs^Fms, Hhd^Fdf, Gll^Fdf, Gs^Fms, Gs^Fms, Gs^Fms, Gs^Fms, Hhd^Fdf, Gll^Fdf, Hhd^Fdf, Hhd^Fdf, Hhd^Fdf, Hhd^Fdf, Hhd^Fdf, Gs^Fds, Gg^Es, Gll^Fdf, Hhd^Fdf, Mm, Mm, Mm^Xm, Mm^Xm, Mm, Mm, Mm, Mm, Hhd^Fdf, Hhd^Fdf, Hhd^Fdf, Hhd^Fdf, Hhd^Fdf, Gll^Fdf
Hhd^Fdf, Hhd^Fdf, Hhd^Fdf, Hhd^Fdf, Hhd^Fdf, Hhd^Fdf, Hhd^Fdf, Hhd^Fdf, Hhd^Fdf, Hhd^Fdf, Hhd^Fdf, Hhd^Fdf, Hhd^Fdf, Hhd^Fdf, Hhd^Fdf, Hhd^Fdf, Hhd^Fdf, Hhd^Fdf, Hhd^Fdf, Hhd^Fdf, Hhd^Fdf, Hhd^Fdf, Hhd^Fdf, Hhd^Fdf, Hhd^Fdf, Hhd^Fdf, Hhd^Fdf, Hhd^Fdf, Hhd^Fdf, Hhd^Fdf, Hhd^Fdf, Hhd^Fdf, Hhd^Fdf, Hhd^Fdf, Hhd^Fdf, Hhd^Fdf, Hhd^Fdf, Hhd^Fdf, Mm, Hhd^Fdf, Hhd^Fdf, Gs^Fds, Gg^Es, Gll^Fdf, Gll^Fdf, Hhd^Fdf, Hhd^Fdf, Mm, Mm, Mm^Xm, Mm^Xm, Mm, Mm, Mm, Mm, Hhd^Fdf, Hhd^Fdf, Hhd^Fdf, Hhd^Fdf
Hhd^Fdf, Hhd^Fdf, Hhd^Fdf, Hhd^Fdf, Mm, Hhd^Fdf, Mm, Hhd^Fdf, Mm, Hhd^Fdf, Mm, Hhd^Fdf, Mm, Hhd^Fdf, Mm, Mm, Mm, Hhd^Fdf, Mm, Hhd^Fdf, Hhd^Fdf, Hhd^Fdf, Mm, Hhd^Fdf, Mm, Mm, Mm, Hhd^Fdf, Hhd^Fdf, Hhd^Fdf, Hhd^Fdf, Hhd^Fdf, Mm, Hhd^Fdf, Mm, Hhd^Fdf, Mm, Mm, Mm, Mm, Hhd^Fdf, Gll^Fdf, Gg^Efm, Re, Re, Gll^Fdf, Hhd^Fdf, Mm, Mm, Mm, Mm^Xm, Mm^Xm, Mm^Xm, Mm, Mm, Mm, Mm, Hhd^Fdf, Hhd^Fdf
Mm, Mm, Mm, Mm, Mm, Mm, Mm, Mm, Mm, Mm, Mm, Mm, Mm^Xm, Mm, Mm^Xm, Mm, Mm, Mm, Mm, Mm, Mm, Mm, Mm^Xm, Mm, Mm^Xm, Mm, Mm, Mm, Mm, Mm, Mm, Mm, Mm, Mm, Mm, Mm, Mm^Xm, Mm, Mm, Mm, Mm, Hhd^Fdf, Gs^Fds, Gg^Efm, Gg^Es, Gll, Hhd^Fdf, Hhd^Fdf, Mm, Mm, Mm^Xm, Mm, Mm, Mm^Xm, Mm^Xm, Mm, Mm, Mm, Hhd^Fdf
Mm, Mm, Mm, Mm, Mm^Xm, Mm, Mm^Xm, Mm, Mm, Mm, Mm^Xm, Mm^Xm, Mm, Mm^Xm, Mm, Mm^Xm, Mm^Xm, Mm^Xm, Mm, Mm, Mm^Xm, Mm^Xm, Wwt, Mm^Xm, Mm^Xm, Mm^Xm, Mm^Xm, Mm, Mm^Xm, Mm, Mm, Mm, Mm^Xm, Mm^Xm, Mm, Mm, Mm^Xm, Mm^Xm, Mm^Xm, Mm, Mm, Hhd^Fdf, Hhd^Fdf, Gs^Fds, Gg^Efm, Re, Gg^Efm, Hhd^Fdf, Hhd^Fdf, Mm, Mm, Mm, Mm, Mm^Xm, Mm^Xm, Mm, Mm, Mm, Mm
Mm^Xm, Mm, Mm^Xm, Mm^Xm, Mm, Mm^Xm, Mm, Mm^Xm, Mm^Xm, Mm^Xm, Mm^Xm, Mm, Mm, Mm, Mm, Mm, Mm, Mm^Xm, Mm^Xm, Mm^Xm, Mm^Xm, Mm^Xm, Wwt, Mm, Mm, Mm^Xm, Mm, Mm^Xm, Mm^Xm, Mm^Xm, Mm^Xm, Mm^Xm, Mm^Xm, Mm, Mm^Xm, Mm^Xm, Mm, Mm, Mm, Mm^Xm, Mm^Xm, Mm, Hhd^Fdf, Hhd^Fdf, Gll^Fdf, Re, Re, Gll^Fdf, Gs^Fds, Hhd^Fdf, Mm, Mm^Xm, Mm^Xm, Mm^Xm, Mm, Mm^Xm, Mm^Xm, Mm, Mm
Mm, Mm^Xm, Mm, Mm, Mm, Mm, Mm, Mm, Mm, Mm, Mm, Mm, Hhd^Fdf, Mm, Mm, Mm, Mm, Mm, Mm, Mm^Xm, Mm, Mm, Wwt, Mm, Mm, Mm^Xm, Mm, Mm, Mm, Mm, Mm, Mm, Mm, Mm^Xm, Mm, Mm, Mm, Mm, Mm, Mm, Mm^Xm, Mm^Xm, Mm, Hhd^Fdf, Gll^Fdf, Gll, Re, Gg^Efm, Gs^Fds, Hhd^Fdf, Mm, Mm, Mm, Mm, Mm, Mm, Mm, Mm^Xm, Mm
Mm, Mm, Mm, Mm, Mm, Mm, Mm, Mm, Mm, Mm, Hhd^Fdf, Hhd^Fdf, Hhd^Fdf, Hhd^Fdf, Hhd^Fdf, Hhd^Fdf, Hhd^Fdf, Mm, Mm, Mm, Hhd^Fdf, Mm, Wwt, Mm, Hhd^Fdf, Mm, Mm, Mm, Mm, Mm, Mm, Mm, Mm, Mm, Hhd^Fdf, Mm, Hhd^Fdf, Mm, Mm, Mm, Mm, Mm^Xm, Mm, Hhd^Fdf, Gs^Fds, Gg^Efm, Gg^Es, Gg^Efm, Gll^Fdf, Hhd^Fdf, Mm, Mm, Mm, Mm, Mm, Mm, Mm, Mm, Mm
Mm, Mm, Mm, Mm, Hhd^Fdf, Mm, Hhd^Fdf, Mm, Hhd^Fdf, Hhd^Fdf, Hhd^Fdf, Hhd^Fdf, Hhd^Fdf, Hhd^Fdf, Hhd^Fdf, Hhd^Fdf, Hhd^Fdf, Hhd^Fdf, Hhd^Fdf, Hhd^Fdf, Hhd^Fdf, Hhd^Fdf, Wwt, Hhd^Fdf, Hhd^Fdf, Hhd^Fdf, Hhd^Fdf, Mm, Hhd^Fdf, Mm, Hhd^Fdf, Hhd^Fdf, Hhd^Fdf, Hhd^Fdf, Hhd^Fdf, Hhd^Fdf, Hhd^Fdf, Hhd^Fdf, Hhd^Fdf, Hhd^Fdf, Hhd^Fdf, Mm, Hhd^Fdf, Hhd^Fdf, Ket, Gg^Es, Re, Gll, Gs^Fds, Hhd^Fdf, Mm, Mm, Mm, Mm, Hhd^Fdf, Mm, Hhd^Fdf, Hhd^Fdf, Hhd^Fdf
Hhd^Fdf, Hhd^Fdf, Hhd^Fdf, Hhd^Fdf, Hhd^Fdf, Hhd^Fdf, Hhd^Fdf, Hhd^Fdf, Hhd^Fdf, Hhd^Fdf, Gs^Fds, Hhd^Fdf, Gs^Fds, Hhd^Fdf, Gs^Fds, Gs^Fds, Gs^Fds, Hhd^Fdf, Hhd^Fdf, Hhd^Fdf, Gs^Fds, Gs^Fds, Wwt, Hhd^Fdf, Gs^Fds, Hhd^Fdf, Hhd^Fdf, Hhd^Fdf, Hhd^Fdf, Hhd^Fdf, Gs^Fds, Hhd^Fdf, Gs^Fds, Hhd^Fdf, Gll^Fdf, Hhd^Fdf, Hhd^Fdf, Hhd^Fdf, Hhd^Fdf, Hhd^Fdf, Hhd^Fdf, Hhd^Fdf, Gll^Fdf, Gs^Fds, Gll, Re, Gg, Ket, Gs^Fds, Hhd^Fdf, Hhd^Fdf, Hhd^Fdf, Hhd^Fdf, Hhd^Fdf, Hhd^Fdf, Hhd^Fdf, Hhd^Fdf, Hhd^Fdf, Hhd^Fdf
Hhd^Fdf, Hhd^Fdf, Gll^Fdf, Hhd^Fdf, Gll^Fdf, Gll^Fdf, Gll^Fdf, Gll^Fdf, Gll^Fdf, Gs^Fds, Gll^Fdf, Gll^Fdf, Gll^Fdf, Gs^Fds, Gll^Fdf, Gll, Gs^Fds, Gs^Fds, Gs^Fds, Gs^Fds, Ww^Ewf, Ww^Ewf, Wwt, Gs^Fds, Gll^Fdf, Gll^Fdf, Gll^Fdf, Gs^Fds, Gs^Fds, Gs^Fds, Gll, Gs^Fds, Gll^Fdf, Gs^Fds, Gs^Fds, Gs^Fds, Gs^Fds, Gs^Fds, Gs^Fds, Gs^Fds, Gs^Fds, Gs^Fds, Gll^Fdf, Gs^Fds, Gs^Fds, Re, Re, Gg, Gs^Fds, Gs^Fds, Gs^Fds, Hhd^Fdf, Gs^Fds, Hhd^Fdf, Hhd^Fdf, Hhd^Fdf, Hhd^Fdf, Hhd^Fdf, Hhd^Fdf
Gs^Fds, Gll^Fdf, Gs^Fds, Gll^Fdf, Gs^Fds, Gll^Fdf, Gs^Fds, Gs^Fds, Gll^Fdf, Gs^Fds, Gll^Fdf, Gll^Fdf, Gll^Fdf, Gs^Fds, Gll, Gll^Fdf, Gll, Gll^Fdf, Gs^Fds, Gs^Fds, Ww^Ewf, Wwt, Gs^Fds, Gll^Fdf, Gs^Fds, Gs^Fds, Gll, Gll^Fdf, Gll^Fdf, Gs^Fds, Gll^Fdf, Gll^Fdf, Gs^Fds, Gll^Fdf, Gll^Fdf, Gll^Fdf, Gg, Gll^Fdf, Gll, Gll^Fdf, Gll, Gll^Fdf, Ce, Gs^Fds, Ce, Gg^Efm, Re, Gg^Es, Ce, Gll, Ce, Gll^Fdf, Gll^Fdf, Gs^Fds, Gll^Fdf, Hhd^Fdf, Hhd^Fdf, Hhd^Fdf, Hhd^Fdf
Gll^Fdf, Gll^Fdf, Gs^Fds, Gs^Fds, Gll, Gs^Fds, Gs^Fds, Gs^Fds, Gll^Fdf, Gll^Fdf, Gll^Fdf, Gs^Fds, Gll, Gs^Fds, Gll^Fdf, Gll^Fdf, Gs^Fds, Ww^Ewf, Wwt, Wwt, Gll^Fdf, Gll, Gll^Fdf, Gll^Fdf, Gll, Gll, Gll^Fdf, Gs^Fds, Gll^Fdf, Gll^Fdf, Gll, Gll^Fdf, Gg, Gg, Gg^Efm, Gs^Fds, Gg, Gll^Fdf, Gs^Fds, Gs^Fds, Gs^Fds, Ce, Gg, Ce, Gg^Efm, Gg^Efm, Re, Gg, Gll^Fdf, Ce, Gs^Fds, Ce, Gll, Gll^Fdf, Gll^Fdf, Gs^Fds, Gs^Fds, Hhd^Fdf, Hhd^Fdf
Gs^Fds, Gll, Gll^Fdf, Gs^Fds, Gll, Gs^Fds, Gll^Fdf, Gll, Gll, Gll^Fdf, Gll, Gll, Gll^Fdf, Gll, Gll^Fdf, Gs^Fds, Ww^Ewf, Wwt, Gs^Fds, Gll^Fdf, Gs^Fds, Gll^Fdf, Gll^Fdf, Gll^Fdf, Gll, Gs^Fds, Gll, Gs^Fds, Gll^Fdf, Gs^Fds, Gs^Fds, Gll^Fdf, Gll^Fdf, Gll^Fdf, Gg, Gg^Efm, Re, Gll^Fdf, Re, Gg^Es, Re, Gg, Gg, Gg, Re, Re, Gg, Gg^Efm, Gs^Fds, Gll, Gll^Fdf, Gll, Gll^Fdf, Gs^Fds, Gs^Fds, Gll^Fdf, Gs^Fds, Hhd^Fdf, Hhd^Fdf
Gll^Fdf, Gll^Fdf, Gll^Fdf, Gll^Fdf, Gll^Fdf, Gll, Gs^Fds, Gll, Gll^Fdf, Gs^Fds, Gs^Fds, Gll^Fdf, Gll^Fdf, Gs^Fds, Gll, Ww^Ewf, Wwt, Gs^Fds, Gs^Fds, Gll, Gs^Fds, Gll, Gll^Fdf, Gll^Fdf, Gs^Fds, Gll^Fdf, Gll, Gll^Fdf, Gll^Fdf, Gll, Gs^Fds, Gll^Fdf, Gg, Gll^Fdf, Gg^Es, Gg^Efm, Re, Re, Gs^Fds, Re, Re, Gs^Vc, Re, Re, Gg, Gg, Gs^Fds, Gg^Efm, Gg^Efm, Gs^Fds, Gll^Fdf, Gs^Fds, Gll, Gs^Fds, Gll^Fdf, Gll^Fdf, Hhd^Fdf, Hhd^Fdf, Hhd^Fdf
Gll^Fdf, Gs^Fds, Gs^Fds, Gll^Fdf, Gs^Fds, Gs^Fds, Gs^Fds, Gs^Fds, Gll^Em, Gll^Fdf, Gll^Fdf, Gs^Fds, Gll^Fdf, Gs^Fds, Wwt, Wwt, Wwt, Gll, Gll, Gs^Fds, Gll, Gll, Gs^Fds, Gll, Gll^Fdf, Gs^Fds, Gs^Fds, Gs^Fds, Gs^Fds, Gll^Fdf, Gll^Fdf, Gll^Fdf, Gs^Fds, Gs^Vc, Gg, Re, Gg^Es, Gs^Fds, Gll^Fdf, Gg^Efm, Gg^Efm, Re, Re, Re, Gg, Gs^Fds, Gs^Fds, Gg^Es, Gg, Gs^Fds, Gs^Fds, Gs^Fds, Gll^Fdf, Gs^Fds, Gs^Fds, Gs^Fds, Hhd^Fdf, Hhd^Fdf, Hhd^Fdf
Gll, Gll, Gll^Fdf, Gll^Fdf, Gs^Fds, Gll^Fdf, Gs^Em, Gll, Gs^Fds, Gll^Fdf, Gs^Fds, Gs^Fds, Ww^Ewf, Wwt, Gll^Fdf, Gll^Fdf, Ww^Ewf, Gs^Fds, Gll, Gs^Fds, Gs^Fds, Gll, Gll, Gs^Fds, Gll, Gll^Fdf, Gll^Fdf, Gll^Fdf, Gs^Fds, Gg, Gs^Fds, Gll^Fdf, Gs^Fds, Gg, Gg^Es, Re, Gg^Efm, Gg^Es, Gs^Vc, Re, Re, Re, Ket, Re, Re, Gs^Vc, Gg, Gg, Gg^Es, Gll^Fdf, Gll, Gll^Fdf, Gll^Fdf, Gll^Fdf, Gll^Fdf, Gs^Fds, Hhd^Fdf, Hhd^Fdf, Hhd^Fdf
Gll, Gll, Gs^Fds, Gll^Fdf, Gs^Em, Gs^Fds, Gll^Fdf, Gll^Fdf, Gll^Fdf, Gll^Fdf, Gll^Fdf, Gll^Fdf, Ww^Ewf, Gll^Fdf, Gs^Fds, Gll^Efm, Ww^Ewf, Gg^Es, Gg^Efm, Gs^Fds, Gll, Gll, Gs^Fds, Gll, Gs^Fds, Gll^Fdf, Gll^Fdf, Gg, Gs^Fds, Gg, Gs^Fds, Gll^Fdf, Re, Re, Re, Re, Re, Re, Re, Re, Ket, Ket, Ce, Ket, Ket, Re, Gg^Es, Gg^Efm, Gg^Efm, Gll^Fdf, Gs^Fds, Gll, Gll, Gll^Fdf, Gs^Fds, Gll^Fdf, Gs^Fds, Hhd^Fdf, Hhd^Fdf
Gs^Fds, Gll, Gll^Fdf, Gll, Gll^Fdf, Gll, Gll^Fdf, Gll^Fdf, Gll, Gs^Fds, Gll^Fdf, Gll^Em, Wwt, Gll^Fdf, Wwt, Wwt, Gs^Fds, Wwt, Wwt, Gs^Fds, Sm, Sm, Wwt, Gg, Gg, Gll^Fdf, Gs^Fds, Gs^Fds, Ce, Gs^Fds, Gg^Es, Gg^Efm, Re, Gg, Ce, Ket, Ce, Re, Re, Re, Ket, Ce, Ket, Ce, Ket, Re, Gg, Gg^Efm, Ce, Gs^Fds, Gll^Fdf, Gll^Fdf, Gll^Fdf, Gll^Fdf, Gs^Fds, Gll^Fdf, Gs^Fds, Hhd^Fdf, Gs^Fds
Gs^Fds, Gll^Fdf, Gll^Fdf, Gs^Fds, Gll^Em, Gll^Fdf, Gll^Fdf, Gs^Fds, Gs^Fds, Gll^Fdf, Wwt, Wwt, Ww^Ewf, Wwt, Gs^Fds, Gs^Fds, Gg^Efm, Ss, Ss, Wwt, Wwt, Wwt, Gg^Gvs, Gg, Gg^Es, Gg, Gs^Fds, Ce, Re, Gg, Gg^Es, Gg^Efm, Re, Gg^Es, Re, Ce, Gg^Efm, Gg^Efm, Gg, Re, Ket, Ce, Ce, Ce, Ket, Re, Re, Gg^Efm, Re, Ce, Gg, Gll^Fdf, Gg^Es, Gll^Fdf, Gg, Gs^Fds, Gs^Fds, Gll^Fdf, Gs^Fds
Gs^Fds, Gs^Fds, Gs^Fds, Gs^Fds, Ss, Gs^Fds, Ss, Ss, Ww^Ewf, Ww^Ewf, Gll^Fdf, Gll^Fdf, Ww^Ewf, Gs^Fds, Gll^Efm, Gg^Efm, Sm, Ss, Wwt, Wwt, Gs^Vc, Gg^Gvs, Gg^Gvs, Gg^Gvs, Gg^Gvs, Gg, Gg, Ce, Ce, Re, Re, Re, Re, Re, Re, Gg^Es, Gg^Es, Gg^Efm, Gs^Fds, Re, Re, Ket, Ket, Ket, Re, Re, Re, Re, Gg, Ce, Gg^Es, Gg^Es, Gg, Gg, Gg, Gs^Fds, Gg, Gg, Gs^Fds
Gll^Fdf, Gll^Fdf, Ww^Ewf, Ww^Ewf, Ww^Ewf, Ss, Ss, Wwt, Ww^Ewf, Wwt, Ww^Ewf, Ww^Ewf, Gs^Fds, Gll, Gs^Fds, Sm, Wwt, Wwt, Gs^Vc, Re, Re, Gg^Gvs, Gg^Gvs, Gg^Gvs, Re, Re, Re, Re, Gg, Gg, Gg^Efm, Re, Gg^Es, Re, Gll^Fdf, Gg, Gg^Es, Gll^Fdf, Gs^Fds, Gs^Vc, Gg, Re, Re, Re, Gg, Gs^Fds, Re, Re, Gg^Es, Gg^Es, Gs^Fds, Gg, Gs^Fds, Gg, Gs^Fds, Gg, Gg, Gg, Gg
Gs^Fds, Ww^Ewf, Wwt, Wwt, Wwt, Ww^Ewf, Wwt, Wwt, Ww^Ewf, Ss, Ss, Gs^Fds, Gll, Gll, Gg, Gs^Fds, Gg^Gvs, Gg^Gvs, Gg^Gvs, Gg^Gvs, Gg^Gvs, Re, Re, Re, Gg^Gvs, Gg^Gvs, Gg^Gvs, Gg, Re, Gg, Ce, Gg^Efm, Re, Re, Gs^Fds, Gs^Vc, Gg^Es, Gg, Gg, Gg, Ce, Re, Gg^Es, Gg, Gll^Fdf, Gs^Fds, Gg^Efm, Re, Gg, Gg, Gs^Fds, Gs^Vc, Gg^Es, Gs^Fds, Gg, Gg^Es, Gg^Es, Re, Re
Ww^Ewf, Ww^Ewf, Ss, Ss, Ss, Ww^Ewf, Ww^Ewf, Ww^Ewf, Ss, Ss, Gll^Fdf, Gll, Gll, Gll, Gs^Fds, Gg, Gg, Gg^Gvs, Gg^Gvs, Gg^Gvs, Re, Re, Re, Gs^Vc, Gg^Gvs, Gg^Gvs, Gll^Gvs, Gg^Gvs, Re, Gg, Ce, Gg^Efm, Re, Re, Re, Gg^Efm, Gg^Efm, Gg, Re, Ce, Ket, Re, Gg^Es, Gg^Es, Gll^Fdf, Gll^Fdf, Gg^Efm, Re, Re, Gg, Gg, Gs^Fds, Gg^Es, Gg, Re, Re, Gg^Es, Gg, Gg
Wwt, Wwt, Ss, Gll^Fdf, Gs^Fds, Gll^Fdf, Gll^Fdf, Gll^Fdf, Gs^Fds, Gs^Fds, Gll^Fdf, Gs^Fds, Gg^Em, Gs^Fds, Gs^Fds, Gg, Gg, Re, Re, Re, Gg^Efm, Gg^Efm, Gg^Efm, Re, Re, Gg^Gvs, Gg, Gg, Re, Re, Ce, Re, Gg, Re, Re, Re, Re, Re, Re, Ce, Ce, Re, Re, Gs^Vc, Gg, Gs^Fds, Re, Re, Gg, Re, Gg, Gg, Re, Gg, Re, Gg, Gg, Gg, Gs^Fds
Gll^Fdf, Gs^Fds, Gs^Fds, Gs^Fds, Gll^Fdf, Gs^Fds, Gll^Fdf, Gs^Fds, Gll^Fdf, Gs^Fds, Gll^Fdf, Gs^Fds, Gll, Gs^Fds, Gll, Gs^Fds, Gg, Re, Gg, Gg, Gg^Es, Gg^Es, Gg, Gg^Efm, Gg^Efm, Gll^Fdf, Gs^Vc, Re, Re, Gg, Gs^Fds, Ce, Ce, Gg, Re, Re, Ce, Gg, Re, Gg^Efm, Gg^Efm, Gg, Gg^Es, Re, Re, Re, Re, Re, Re, Ce, Gg^Es, Re^Es, Gll, Re, Gg, Gg, Gs^Fds, Gs^Fds, Gll
Gll^Fdf, Gll^Fdf, Gs^Fds, Gs^Fds, Gll^Fdf, Gs^Cov, Gs^Fds, Gs^Fds, Gs^Fds, Gll^Fdf, Gs^Fds, Gs^Fds, Gs^Fds, Gll^Fdf, Gs^Vc, Gs^Fds, Gs^Fds, Gg, Gll^Fdf, Gg, Gs^Fds, Gg, Gg, Gg^Es, Gg^Efm, Gg, Gll^Fdf, Gg, Re, Gg, Gg^Es, Gs^Fds, Gg, Re, Gg^Es, Gg, Gg, Ce, Gs^Fds, Gg, Gs^Fds, Gg, Gll^Fdf, Gg^Es, Gs^Vc, Gg, Gg, Gg, Ce, Ce, Gs^Fds, Gg^Es, Gs^Fds, Gs^Fds, Gll^Fdf, Gs^Fds, Gll^Fdf, Gll^Fdf, Gll
Gs^Fds, Gll^Fdf, Gll^Fdf, Gll^Cov, Gs^Cov, Gs^Cov, Gll^Cov, Gll^Cov, Gs^Fds, Gll^Fdf, Gll^Fdf, Gs^Fds, Gs^Fds, Gll, Gll, Gll^Fdf, Gs^Fds, Gll^Fdf, Gs^Fds, Gll^Fdf, Gs^Vc, Gs^Fds, Gs^Fds, Gg, Gg^Es, Gg, Gg, Gg, Re, Re, Gll^Fdf, Gg, Gg, Re, Gg^Es, Gg, Gs^Fds, Ce, Gll^Fdf, Gs^Fds, Gs^Fds, Gs^Fds, Gs^Fds, Gll^Fdf, Gll^Fdf, Gs^Fds, Gs^Fds, Gs^Fds, Gll, Gs^Fds, Gll^Fdf, Gll^Fdf, Gs^Fds, Gs^Fds, Gll^Fdf, Gll^Fdf, Gll, Gll, Gll
Gll^Fdf, Gll^Fdf, Gll^Fdf, Gs^Fds, Gs^Cov, Gll^Kov, Gs^Cov, Gll^Fdf, Gs^Fds, Gs^Fds, Gll^Fdf, Gs^Fds, Gs^Fds, Gs^Fds, Gll^Em, Gs^Fds, Gll^Fdf, Gll^Fdf, Gs^Fds, Gs^Fds, Gs^Fds, Gll, Gll^Fdf, Gs^Fds, Gll, Gg^Es, Gg^Efm, Re, Re, Gs^Fds, Gs^Vc, Gs^Fds, Gg, Re, Gg, Gg, Gll^Fdf, Gll^Fdf, Gs^Fds, Gll^Fdf, Gll^Fdf, Gll, Gll, Gll^Fdf, Gs^Fds, Gll^Fdf, Gs^Fds, Gll, Gll^Fdf, Gs^Fds, Gs^Fds, Gll, Gs^Fds, Gll, Gs^Fds, Gs^Fds, Gll^Fdf, Gll^Fdf, Gs^Fds
Gs^Fds, Gll^Fdf, Gll^Fdf, Gs^Cov, Gs^Fds, Gs^Cov, Gs^Fds, Gs^Cov, Gs^Fds, Gs^Fds, Gll^Fdf, Gs^Fds, Gs^Fds, Gs^Fds, Gll, Gll^Fdf, Gll^Fdf, Gll, Gll^Fdf, Gll^Fdf, Gll, Gs^Fds, Gs^Fds, Gll, Gs^Fds, Gg^Es, Gg^Es, Gg, Re, Gg, Gg, Gll^Fdf, Gg, Re, Gg, Gs^Fds, Gll^Fdf, Gll, Gs^Fds, Gll^Fdf, Gs^Fds, Gs^Fds, Gs^Fds, Gs^Fds, Gll^Fdf, Gs^Fds, Gll^Fdf, Gll^Fdf, Gll^Fdf, Gs^Fds, Gs^Fds, Gs^Fds, Gll^Fdf, Gll^Fdf, Gll, Gs^Fds, Gll, Gll, Gll
Gll^Fdf, Gll^Fdf, Gll^Fdf, Gs^Fds, Gs^Fds, Gs^Cov, Gs^Fds, Gs^Fds, Gll^Fdf, Gll^Fdf, Gs^Fds, Gs^Fds, Gll^Fdf, Gll, Gs^Fds, Gll, Gll^Fdf, Gs^Fds, Gll, Gll^Fdf, Gll^Fdf, Gs^Fds, Gll^Fdf, Gs^Fds, Gs^Fds, Gg, Gg, Gg^Efm, Re, Gg, Gg^Es, Gg^Es, Gg^Es, Re, Gg, Gs^Fds, Gll, Gll^Fdf, Gll^Fdf, Gll^Fdf, Gll, Gll^Fdf, Gll^Fdf, Gs^Fds, Gll^Fdf, Gs^Fds, Gs^Fds, Gll^Fdf, Gll^Fdf, Gs^Fds, Gll^Fdf, Gll^Fdf, Gll, Gll^Fdf, Gll, Gs^Fds, Gs^Fds, Gs^Fds, Gll
Gs^Fds, Gll^Fdf, Gs^Fds, Gll^Fdf, Gll^Fdf, Gll^Fdf, Gs^Fds, Gll^Fdf, Gs^Fds, Gll^Fdf, Gll^Fdf, Gs^Fds, Gll, Gs^Fds, Gs^Fds, Gs^Fds, Gll, Gll^Fdf, Gs^Fds, Gll^Fdf, Gll, Gs^Fds, Gll^Fdf, Gll^Fdf, Gs^Fds, Gs^Fds, Gs^Fds, Gg, Gg, Re, Re, Gg, Re, Re, Gg, Gs^Fds, Gs^Fds, Gs^Fds, Gll, Gs^Fds, Gll^Fdf, Gll, Gll^Fdf, Gll, Gll^Fdf, Gll, Gs^Fds, Gs^Fds, Gs^Fds, Gll^Fdf, Gll^Fdf, Gs^Fds, Gs^Fds, Gll^Fdf, Gs^Fds, Gll^Fdf, Gll^Fdf, Gs^Fds, Gll
Gs^Fds, Gs^Fds, Gll, Gs^Fds, Gll, Gs^Fds, Gll^Fdf, Gs^Fds, Gs^Fds, Gs^Fds, Gs^Fds, Gs^Fds, Gs^Fds, Gs^Fds, Gg, Gll^Fdf, Gll, Gll, Gll, Gll^Fdf, Gll, Gll^Fdf, Gg, Gll^Fdf, Gs^Fds, Gs^Fds, Gs^Fds, Gg, Gg, Gg, Re, Re, Re, Gg, Gg, Gg, Gg, Gs^Fds, Gll, Gs^Fds, Gg, Gll^Fdf, Gll^Fdf, Gs^Fds, Gg, Gll^Fdf, Gll, Gll, Gll, Gll^Fdf, Gll^Fdf, Gll, Gll^Fdf, Gll^Fdf, Gs^Fds, Gs^Fds, Gll, Gll, Gll
