border_size=1
usage=map

Hh^Fds, Hh^Fds, Hh^Fds, Hh^Fds, Hh^Fds, Hh^Fds, Hhd^Fdf, Hh^Fds, Hhd^Fdf, Hh^Fds, Hh^Fds, Hh^Fds, Hh^Fds, Hh^Fds, Gs^Fds, Gs^Fds, Gs^Fds, Gll^Fdf, Gs^Fds, Gs^Fds, Gs^Fds, Gll^Fdf, Gll^Fdf, Gs^Fds, Gs^Fds, Gs^Fds, Gll^Fdf, Gs^Fds, Gs^Fds, Gs^Fds, Gs^Fds, Gs^Fds, Gll^Fdf, Gs^Fds, Gll^Fdf, Gll^Fdf, Gs^Fds, Gs^Fds, Gs^Fds, Gs^Fds, Gll, Gg, Gg, Gg, Gg^Es, Gg, Gs, Gs, Gd, Ds, Ds, Ds, Ds, Ds, Hd, Hd, Ds, Ds^Edpp, Ds, Ds, Wwt, Wwt, Wwt, Wot, Wot, Wwrt, Wot, Wot, Wot, Wot
Hh^Fds, Hhd^Fdf, Hh^Fds, Hh^Fds, Hh^Fds, Hh^Fds, Hhd^Fdf, Hh^Fds, Hh^Fds, Hhd^Fdf, Hhd^Fdf, Hhd^Fdf, Hhd^Fdf, Hh^Fds, Gll^Fdf, Gs^Fds, Gll^Fdf, Gll^Fdf, Gs^Fds, Gs^Fds, Gs^Fds, Gll^Fdf, Gs^Fds, Gll^Fdf, Gll^Fdf, Gll^Fdf, Gs^Fds, Gll^Fdf, Gll^Fdf, Gs^Fds, Gs^Fds, Gs^Fds, Gll^Fdf, Gs^Fds, Gll^Fdf, Gs^Fds, Gll^Fdf, Gs^Fds, Gs^Fds, Gll, Gg^Efm, Gg^Efm, Gg, Gg^Es, Gg, Gs, Gd, Gd, Ds, Ds, Ds^Edpp, Ds, Hd, Hd, Hd, Hd, Ds, Ds^Edpp, Ds, Ds, Wwt, Wwt, Wwt, Wwt, Wot, Wot, Wwrt, Wot, Wot, Wot
Hh^Fds, Hhd^Fdf, Hhd^Fdf, Hh^Fds, Hhd^Fdf, Hhd^Fdf, Hh^Fds, Hhd^Fdf, Hhd^Fdf, Hhd^Fdf, Hh^Fds, Hh^Fds, Hhd^Fdf, Gs^Fds, Gs^Fds, Gll^Fdf, Gll^Fdf, Gll^Fdf, Gll^Fdf, Gll^Fdf, Gs^Fds, Gs^Fds, Gll^Fdf, Gll^Fdf, Gs^Fds, Gll^Fdf, Gll^Fdf, Gll^Fdf, Gll^Fdf, Gs^Fds, Gll^Fdf, Gll^Fdf, Gll^Fdf, Gs^Fds, Gll^Fdf, Gs^Fds, Gll^Fdf, Gs^Fds, Gs^Fds, Gg^Efm, Gg, Gg, Gs, Gs, Gs, Gs, Gd, Ds, Ds, Ds, Ds, Hd, Hd, Hd, Hd, Ds, Ds, Ds, Ds, Ds, Wwt, Wwt, Wwt, Wwt, Wot, Wot, Wwrt, Wot, Wot, Wot
Hh^Fds, Hhd^Fdf, Hhd^Fdf, Hh^Fds, Hh^Fds, Hhd^Fdf, Hh^Fds, Hh^Fds, Gs^Fds, Gll^Fdf, Gll^Fdf, Gll^Fdf, Gll^Fdf, Gs^Fds, Gs^Fds, Gs^Fds, Gs^Fds, Gll^Fdf, Gs^Fds, Gll^Fdf, Gll^Fdf, Gs^Fds, Gs^Fds, Gll^Fdf, Gll^Fdf, Gs^Fds, Gs^Fds, Gs^Fds, Gll^Fdf, Gll^Fdf, Gll^Fdf, Gll^Fdf, Gll^Fdf, Gs^Fds, Gll^Fdf, Gs^Fds, Gs^Fds, Gs^Fds, Gg, Gg^Efm, Gs^Efm, Gs, Gd^Es, Gs, Gd, Gd, Ds, Ds, Hd, Hd, Hd, Hd, Ds, Ds, Ds, Ds, Wwt, Wwt, Wwt, Wwt, Wwt, Wwt, Wwt, Wot, Wot, Wot, Wot, Wwrt, Wot, Wot
Hh^Fds, Hhd^Fdf, Hhd^Fdf, Hh^Fds, Hhd^Fdf, Hhd^Fdf, Gll, Gs^Fds, Gs^Fds, Gll^Fdf, Gs^Fds, Gs^Fds, Gs^Fds, Gs^Fds, Gll^Fdf, Gs^Fds, Gs^Fds, Gll, Gs^Fds, Gs^Fds, Gll^Fdf, Gs^Fds, Gs^Fds, Gll^Fdf, Gll^Fdf, Gs^Fds, Gll, Gs^Fds, Gll, Gs^Fds, Gs^Fds, Gs^Fds, Gs^Fds, Gs^Fds, Gs^Fds, Gs^Fds, Gll, Gs^Fds, Gg^Efm, Gg^Efm, Gs, Gd, Ds, Gd, Ds, Ds, Ds, Hd, Hd, Ds, Ds, Ds, Ds, Ds, Ds, Ds, Wwt, Wwt, Wwt, Wwt, Wwt, Wwt, Wot, Wot, Wot, Wot, Wwrt, Wwrt, Wot, Wot
Hh^Fds, Hh^Fds, Hh^Fds, Hhd^Fdf, Hh^Fds, Hh^Fds, Gll^Fdf, Gll, Gll, Gll, Gs^Fds, Gll^Em, Gll^Fdf, Gll^Fdf, Gs^Fds, Gs^Fds, Gll^Fdf, Gs^Fds, Gll^Fdf, Gll^Fdf, Gll, Gll, Gll, Gs^Fds, Gg, Gs^Fds, Gs^Fds, Gs^Fds, Gs^Fds, Gs^Fds, Gs^Fds, Gs^Fds, Gs^Fds, Gs^Fds, Gs^Fds, Gll, Gg^Efm, Gg, Gg, Gs^Efm, Gd, Gd, Ds, Ds, Ds, Ds, Hd, Hd, Ds^Edpp, Ds, Ds, Ds, Wwt, Wwt, Wwt, Wwt, Wwt, Wwt, Wwt, Wwt, Wot, Wot, Wot, Wot, Wwrt, Wwrt, Wwrt, Wot, Wot, Wot
Gll^Fdf, Hh^Fds, Hh^Fds, Hh^Fds, Gs^Fds, Gll^Fdf, Gll, Gs^Fds, Gll^Fdf, Gll^Fdf, Gs^Fds, Gll^Fdf, Gs^Fds, Gll^Fdf, Gll^Fdf, Gs^Fds, Gll, Gll^Fdf, Gs^Fds, Gs^Fds, Gs^Fds, Gs^Fds, Gg, Gg, Gg^Es, Gg, Gg, Gll, Gg, Gll, Gg, Gs^Fds, Gs^Fds, Gll, Gg, Gg, Gg^Efm, Gg, Gs, Gs, Gd, Ds, Ds, Ds, Hd, Hd, Hd, Hd, Ds, Ds, Wwt, Wwt, Wwt, Wwt, Wwt, Wwt, Wwt, Wwt, Wot, Wot, Wot, Wot, Wwrt, Wot, Wot, Wwrt, Wot, Wot, Wot, Wot
Gll^Fdf, Gs^Fds, Gll, Gs^Fds, Gll^Fdf, Gs^Fds, Gll^Fdf, Gll^Em, Gll, Gll^Fdf, Gll^Fdf, Gll^Fdf, Gll, Gll, Gg, Gs^Fds, Gg, Gll, Gg, Gg, Gg, Gg^Es, Gg, Gg, Gg, Gg^Es, Gg^Es, Gg, Gg, Gg, Gg^Efm, Gg, Gg, Gg, Gg, Gg^Efm, Gs, Gs, Gd, Gd, Ds, Ds, Hd, Hd, Ds, Ds, Ds, Ds, Ds, Ds, Wwt, Wwt, Wwt, Wwt, Wwt, Wwt, Wot, Wot, Wot, Wot, Wot, Wot, Wot, Wot, Wot, Wot, Wot, Wot, Wot, Wot
Gll, Gs^Fds, Gll^Fdf, Gs^Fds, Gs^Fds, Gll^Fdf, Gll^Fdf, Gs^Fds, Gs^Fds, Gll^Fdf, Gs^Fds, Gs^Fds, Gg, Gg^Efm, Gg^Efm, Gg, Gg, Gg^Es, Gg, Gg, Ds, Gg^Es, Gg, Gg, Ds, Ds, Ss, Gg, Gg, Gg^Efm, Gg^Efm, Gg^Efm, Gg^Efm, Gg, Gg, Gg, Gs, Gs^Es, Gd, Ds, Ds^Edpp, Ds, Hd, Hd, Ds, Ds, Wwt, Ds, Wwt, Ds, Wwt, Wwt, Wwt, Wot, Wot, Wot, Wot, Wot, Wot, Wwrt, Wot, Wot, Wot, Wot, Wot, Wot, Wot, Wot, Wot, Wot
Gs^Fds, Gs^Fds, Gs^Fds, Gll^Fdf, Gs^Fds, Gll^Fdf, Gll, Gs^Fds, Gs^Fds, Gll^Fdf, Gs^Fds, Gs^Fds, Gg^Efm, Gg^Efm, Gg^Efm, Gg, Gg, Gg, Wwt, Ds, Wwf, Ss, Ss, Ss, Wwt, Wwt, Ss, Ss, Ss, Gg, Gg, Gg, Gg, Gg, Gg^Es, Gg, Gs, Gd, Ds, Ds, Ds, Ds, Hd, Hd, Ds, Wwt, Wwt, Wwt, Wwt, Wwt, Wwt, Wwt, Wwt, Wot, Wot, Wot, Wot, Wot, Wwrt, Wwrt, Wot, Wot, Wot, Wot, Wot, Wot, Wot, Wot, Wot, Wot
Gll, Gll^Fdf, Gll^Fdf, Gll^Fdf, Gll^Fdf, Gs^Fds, Gs^Fds, Gs^Fds, Gll, Gll, Gs^Fds, Gll, Gg, Gg^Efm, Gg, Gs^Vc, Wwt, Wwt, Wwt, Wwf, Wwf, Wwt, Wwt, Wwt, Wwt, Wwt, Wwt, Wwt, Wwt, Ss, Ss, Ss, Ss, Gg, Gg, Gs^Vc, Gs, Gd, Ds, Ds^Edpp, Ds, Hd, Hd, Ds, Ds, Wwt, Wwt, Wwt, Wwt, Wwt, Wwt, Wwt, Wot, Wot, Wot, Wot, Wwrt, Wwrt, Wot, Wot, Wot, Wot, Wot, Wot, Wot, Wot, Wot, Wot, Wot, Wot
Gll, Gll^Fdf, Gs^Fds, Gll, Gll^Fdf, Gs^Fds, Gll, Gll^Fdf, Gll^Em, Gs^Fds, Gll, Gll, Gg^Es, Gg, Wwt, Wwt, Wwt, Wwt, Wwt, Wwf, Wwf, Wwf, Wwt, Wwt, Wwt, Wwt, Wwt, Wwt, Wwt, Wwt, Ss, Ss, Ss, Ss, Ss, Gg, Gs^Es, Gd, Gd, Ds, Ds, Hd, Hd, Ds, Ds, Ds, Wwt, Wwt, Wot, Wwt, Wot, Wot, Wot, Wot, Wot, Wwrt, Wot, Wot, Wot, Wot, Wot, Wot, Wot, Wot, Wot, Wot, Wot, Wot, Wot, Wot
Gll, Gll, Gll^Em, Gll^Fdf, Gll, Gll^Fdf, Gll, Gll^Fdf, Gll, Gs^Fds, Gg, Gg^Es, Gg, Wwt, Wwt, Wwt, Wwt, Wwt, Ss, Wwt, Ss, Wwf, Ss, Ss, Ss, Ss, Ss, Wwt, Wwt, Wwt, Wwt, Ss, Ds, Ss, Ss, Gg, Gs^Es, Gd, Ds, Ds, Ds, Ds, Hd, Hd, Ds, Ds, Wwt, Wwt, Wwt, Wot, Wot, Wot, Wot, Wot, Wot, Wwrt, Wot, Wot, Wot, Wot, Wot, Wot, Wot, Wot, Wot, Wot, Wot, Wot, Wot, Wot
Gll, Gll, Gs^Fds, Gll, Gll^Fdf, Gll^Fdf, Gll^Fdf, Gll^Fdf, Gs^Fds, Gs^Fds, Gg, Gg^Es, Gg, Wwt, Wwt, Wwt, Ss, Ss, Ss, Ss, Gll, Gll, Gll, Gll, Gs^Fds, Gll, Gll, Ss, Ds, Wwt, Wwt, Wwt, Wwt, Ds, Ss, Gg, Gs, Gd, Ds, Ds, Hd, Hd, Ds^Edpp, Ds^Edpp, Ds, Ds, Wwt, Wwt, Wwt, Wot, Wot, Wot, Wwrt, Wot, Wot, Wwrt, Wwrt, Wot, Wot, Wot, Wot, Wot, Wot, Wot, Wot, Wot, Wot, Wot, Wot, Wot
Gs^Fds, Gs^Fds, Gll, Gll, Gll, Gll^Fdf, Gll^Fdf, Gll^Fdf, Gll, Gll^Fdf, Gll, Gg^Es, Gg, Wwt, Wwt, Wwt, Ss, Ss, Ss, Ss, Gll, Gll, Gll^Fdf, Gs^Fds, Gll^Fdf, Gs^Fds, Gll, Ss, Ss, Wwt, Wwt, Wwt, Wwt, Wwt, Wwt, Ss, Gs, Gd, Ds, Ds, Ds, Ds, Ds, Ds, Wwt, Wwt, Wwt, Wwt, Wwt, Wot, Wot, Wwrt, Wwrt, Wot, Wot, Wot, Wot, Wwrt, Wot, Wot, Wot, Wot, Wot, Wot, Wot, Wot, Wot, Wot, Wot, Wot
Gll, Gs^Fds, Gll^Fdf, Gll^Fdf, Gll^Fdf, Gll^Em, Gll^Fdf, Gs^Fds, Gll, Gll, Gs^Fds, Gg^Es, Gg^Es, Wwt, Wwt, Wwt, Wwt, Ss, Ss, Gll, Gll^Fdf, Gs^Fds, Gll^Fdf, Gll^Fdf, Gs^Fds, Gll^Fdf, Gll, Gll, Gll, Ss, Ss, Wwt, Wwt, Wwt, Wwt, Ss, Ss, Gd, Ds, Ds, Ds, Ds, Wwt, Wwt, Wwt, Wwt, Wwt, Wwt, Wwt, Wot, Wot, Wot, Wot, Wwrt, Wwrt, Wot, Wot, Wot, Wot, Wot, Wot, Wot, Wot, Wot, Wot, Wot, Wot, Wot, Wot, Wot
Gll, Gll, Gll^Fdf, Gll, Gs^Fds, Gll, Gs^Fds, Gll^Fdf, Gll, Gs^Fds, Gll, Gll, Gg, Ds, Wwt, Wwt, Wwt, Wwt, Ds, Gll, Gs^Fds, Gs^Fds, Gll^Fdf, Gll^Fdf, Gs^Fds, Gs^Fds, Gs^Fds, Gll, Gll, Gll, Ss, Ss, Ds, Wwt, Wwt, Wwt, Wwt, Ss, Ss, Ds, Wwt, Wwt, Wwt, Wwt, Wwt, Wwt, Wwt, Wwt, Wwt, Wot, Wot, Wot, Wot, Wwrt, Wwrt, Wot, Wot, Wot, Wot, Wwrt, Wot, Wwrt, Wwrt, Wot, Wot, Wot, Wot, Wot, Wot, Wot
Gll, Gll, Gll^Fdf, Gs^Fds, Gll, Gll, Gs^Fds, Gll^Fdf, Gll, Gs^Fds, Gs^Fds, Gg, Gg, Ss, Ss, Wwt, Wwt, Wwt, Ds, Gll, Gs^Fds, Gll, Gll^Fdf, Gs^Fds, Gs^Fds, Gs^Fds, Gs^Fds, Gs^Fds, Gs^Fds, Gll, Gll, Ss, Ss, Ds, Wwt, Wwt, Wwt, Wwt, Wwt, Wwt, Wwt, Wwt, Wwt, Wwt, Ds, Ds, Ds, Wwt, Wwt, Wwt, Wwt, Wwt, Wwt, Wot, Wwrt, Wot, Wot, Wot, Wot, Wot, Wot, Wot, Wot, Wwrt, Wwrt, Wot, Wot, Wot, Wot, Wot
Gs^Fds, Gs^Fds, Gll, Gll^Fdf, Gll, Gll^Fdf, Gll^Fdf, Gs^Fds, Gs^Fds, Gll, Gll, Gs^Fds, Gg^Es, Gg, Ss, Wwt, Wwt, Wwt, Ds, Gll, Gll, Gs^Fds, Gll^Fdf, Gs^Vc, Gs^Fds, Gs^Vc, Gs^Fds, Gll, Gs^Fds, Gs^Fds, Hh^Fds, Hh^Fds, Hhd^Fdf, Ss, Ss, Wwt, Wwt, Wwt, Wwt, Wwt, Wwt, Wwt, Wwt, Ds, Ds^Edpp, Ds^Edpp, Ds, Wwt, Wwt, Wwt, Wwt, Wwt, Wwt, Wot, Wot, Wot, Wot, Wot, Wwt, Wot, Wot, Wot, Wot, Wot, Wot, Wwrt, Wot, Wot, Wot, Wot
Gll, Gs^Fds, Gll, Gs^Fds, Gs^Fds, Gll, Gs^Fds, Gll^Fdf, Gll, Gll^Fdf, Gs^Fds, Gs^Fds, Gg^Es, Gg^Es, Ss, Wwt, Wwt, Wwt, Ss, Ss, Gll, Gs^Fds, Gs^Fds, Gll^Fdf, Ce, Gs^Fds, Ce, Gs^Fds, Gg^Efm, Gs^Fds, Hhd^Fdf, Hh^Fds, Hhd^Fdf, Hh^Fds, Ss, Ss, Ss, Wwt, Wwt, Wwt, Wwt, Wwt, Ds, Ds, Hd, Hd, Hd, Ds, Ds, Wwt, Wwt, Wwt, Wwt, Wwt, Wot, Wot, Wwt, Wwt, Wwt, Wwt, Wwt, Wot, Wot, Wot, Wwrt, Wwrt, Wot, Wot, Wot, Wot
Gg, Gg^Es, Gg, Gll, Gs^Fds, Gll, Gll, Gll^Fdf, Gll, Gs^Fds, Gg, Gg, Gg, Gg^Es, Ss, Ss, Wwt, Wwt, Wwt, Ss, Gll, Gs^Fds, Gg^Efm, Ce, Gs^Vc, Ce, Gll^Fdf, Ce, Gg^Efm, Gg^Efm, Gs^Fds, Hh^Fds, Hh^Fds, Hhd^Fdf, Ss, Ss, Ss, Ss, Ss, Ss, Ss, Ss, Ds, Ds, Ds, Hd, Hd, Hd, Ds, Ds, Ds, Wwt, Wwt, Wwt, Wwt, Wwt, Wwt, Ww^Vm, Wwt, Wwt, Wwt, Wot, Wot, Wot, Wot, Wot, Wot, Wot, Wot, Wot
Rb, Gg, Gg^Cov, Gg^Cov, Gg^Cov, Gll, Gs^Fds, Gll^Fdf, Gs^Fds, Gll, Gg^Efm, Gg^Efm, Gg, Gg, Ss, Ss, Wwt, Wwt, Wwt, Ss, Gs^Fds, Gs^Fds, Gg^Efm, Gs^Fds, Gll^Fdf, Gs^Fds, Gll^Fdf, Gll^Fdf, Gll^Fdf, Gs^Fds, Gll^Fdf, Gs^Fds, Ss, Ce, Gll, Ss, Ss, Ss, Ss, Ss, Gs, Gd, Gd, Ds, Ds, Ds, Ds, Hd, Hd, Ds, Ds, Wwt, Wwt, Wwt, Wwt, Wwt, Wwt, Wwt, Ce, Wwt, Wwt, Ww^Vm, Wot, Wot, Wot, Wot, Wot, Wot, Wot, Wot
Gg, Rb, Rb^Cov, 1 Gg^Kov, Gg^Cov, Re^Vct, Gg, Gll, Gg^Es, Gg, Gg^Efm, Gg, Gg, Ds, Ds, Wwt, Wwt, Wwt, Wwt, Ss, Gll, Gs^Fds, Gs^Vc, Gll^Fdf, Ce, Gg^Efm, Ket, Gs^Fds, Gg^Efm, Ce, Ce, Ss, Ss, Gs^Fds, Gll, Gll, Ss, Hhd^Fdf, Hh^Fds, Gg, Gs, Gs, Gd, Ds, Ds, Ds, Ds, Hd, Hd, Ds, Ds, Wwt, Wwt, Wwt, Wwt, Wwt, Ce, Ce, 3 Ke, Ce, Wwt, Wwt, Wot, Wot, Wot, Wwrt, Wwrt, Wot, Wot, Wot
Gg, Gg^Es, Gg, Rb^Cov, Rb, Gg, Gg, Gg^Es, Rb, Gg, Rb, Gg, Rb^Es, Gg, Wwt, Wwt, Wwt, Wwt, Ss, Ds, Gll, Gs^Fds, Gs^Fds, Gll^Fdf, Ce, Ce, 2 Ket, Ket, Gll^Fdf, Gg^Efm, Ce, Ss, Ss, Gs^Fds, Gll, Gs^Fds, Gs^Fds, Hhd^Fdf, Hhd^Fdf, Hh^Fds, Gg, Gs, Gs, Gd, Gd, Ds, Ds, Hd, Hd, Hd, Hd, Hd, Hd, Dd^Vdt, Ds^Edpp, Ds, Ds, Ce, Ce, Ce, Wwt, Wwt, Wwt, Wot, Wot, Wot, Wwrt, Wot, Wot, Wot
Gg, Gg, Re^Vct, Gg, Gg, Rb, Rb, Rb, Gg, Rb, Gg^Es, Rb, Gg, Rb, Wwt^Bw\, Wwt, Wwt, Ss, Gll, Gll, Gll, Gll, Gs^Fds, Gll^Fdf, Ce, Ce, Ce, Ce, Gg^Efm, Gs^Fds, Gll^Fdf, Ce, Gll^Fdf, Gll, Ce, Gs^Fds, Gll, Hh^Fds, Hh^Fds, Hh^Fds, Gd, Gs, Gg, Gs, Gs, Gd, Ds, Ds, Ds, Hd, Hd, Hd, Hd, Ds, Ds, Ds, Ds, Ce, Ds, Wwt, Wwt, Ww^Vm, Wwt, Wot, Wot, Wwrt, Wwrt, Wot, Wot, Wot
Gg, Gg, Gg, Gg, Gg^Es, Gg^Es, Gg, Gg, Gg^Efm, Gg^Efm, Gg, Gg, Ss, Ds, Wwt, Wwt^Bw\, Ss^Bw\, Ss, Ce, Gll, Gs^Fds, Gs^Fds, Rb, Rb, Gll^Fdf, Ce, Ce, Ce, Gs^Fds, Gs^Vc, Gll^Fdf, Ce, Gll, Gll, Gll, Gs^Fds, Gll, Gll, Gs^Fds, Hh^Fds, Gd^Xfw, Gd, Gd, Gs, Gs, Gd, Gd, Ds, Ds^Edpp, Ds, Ds, Hd, Ds, Ds^Edpp, Dd^Vdt, Ds, Ds, Ds^Edpp, Ds, Wwt, Wwt, Wwt, Wwt, Wot, Wot, Wot, Wwrt, Wot, Wot, Wot
Gll, Gll, Gll^Fdf, Gs^Fds, Gs^Fds, Gg^Es, Gg, Gg^Efm, Gg^Efm, Gg^Efm, Gg, Gg, Ss, Wwt, Wwt, Wwt, Ss, Rb, Rb, Gs^Fds, Rb, Rb, Hh^Fds, Gs^Fds, Hh^Fds, Gll^Fdf, Gll^Fdf, Gs^Fds, Gll^Fdf, Gs^Fds, Ce, Ce, Gll^Fdf, Gs^Fds, Gll^Fdf, Gll^Fdf, Gll^Fdf, Gll, Gs^Fds, Gs^Fds, Gs^Fds, Gd^Xfw, Gd, Gg, Gs^Vc, Gs, Gd, Ds, Ds, Ds, Ds, Ds, Ds, Ds, Ds, Ds^Edpp, Dd^Vdt, Ds, Wwt, Wwt, Wwt, Wwt, Wwt, Wot, Wwrt, Wwrt, Wot, Wot, Wot, Wot
Gs^Fds, Gll^Fdf, Gll^Fdf, Gll^Fdf, Gll^Fdf, Gs^Fds, Gs^Fds, Gg, Gg, Gg, Ss, Ss, Wwt, Wwt, Wwt, Ss, Ds, Ce, Gs^Fds, Rb, Gll^Fdf, Gs^Fds, Hh^Fds, Hh^Fds, Hh^Fds, Hh^Fds, Gs^Vc, Gll^Fdf, Gs^Fds, Gs^Fds, Ss, Ss, Ss, Ce, Gll, Gs^Fds, Gs^Fds, Gll^Fdf, Gs^Fds, Gd, Gd^Xfw, Gd^Xfw, Gd, Gg, Gg, Gs, Gs, Gd, Gd, Ds, Ds, Ds^Edpp, Ds, Hd, Ds, Ds, Ds, Ds, Wwt, Wwt, Wwt, Wwt, Wot, Wot, Wwrt, Wot, Wot, Wot, Wot, Wot
Gll, Gll, Gll^Fdf, Gs^Fds, Gs^Fds, Gll^Fdf, Gll, Gs^Fds, Gll, Gg, Gg, Ss, Wwt, Wwt, Wwt, Ss, Ss, Gll, Gs^Fds, Gll^Fdf, Gll^Fdf, Gll^Fdf, Gll^Fdf, Hh^Fds, Hh^Fds, Hh^Fds, Gll^Fdf, Gs^Fds, Ce, Ce, Ss, Ss^Vhs, Ss, Gll, Gll, Hh^Fds, Hhd^Fdf, Gll, Gs^Fds, Gd, Gd^Xfw, Gd, Gg, Gg, Gg, Gg, Gs, Gs, Gd, Ds, Ds, Ds, Hd, Hd, Ds, Ds, Ds, Wwt, Wwt, Wwt, Wwt, Wwt, Wot, Wot, Wot, Wot, Wwrt, Wot, Wot, Wot
Gll, Gll, Gll^Fdf, Gll^Fdf, Gll^Em, Gll^Fdf, Gs^Fds, Gs^Fds, Gs^Fds, Gg, Gg^Es, Ss, Ds, Wwt, Wwf, Wwf, Wwf, Gll, Gll, Gs^Fds, Gs^Fds, Gs^Fds, Gll, Hh^Fds, Hh^Fds, Hh^Fds, Gll, Ce, Gll, Ss, Ss, Ss, Gll^Fdf, Gs^Fds, Gs^Fds, Hh^Fds, Hhd^Fdf, Gll, Gs^Fds, Gll^Fdf, Gs^Fds, Gd, Gg, Gg, Gg, Gg, Gs, Gs, Gd, Ds, Ds, Ds, Hd, Ds, Ds, Ds, Wwt, Wwt, Wwt, Wwt, Wot, Wot, Wot, Wwrt, Wot, Wot, Wwrt, Wot, Wot, Wot
Gs^Fds, Gll^Fdf, Gll^Fdf, Gs^Fds, Gll, Gll^Fdf, Gll, Gs^Fds, Gll, Gg, Gg, Gg, Gg, Ds, Wwt, Wwt, Wwt, Ss, Gll, Gll, Gs^Fds, Gll^Fdf, Gll^Fdf, Hh^Fds, Gs^Fds, Gll^Fdf, Gs^Fds, Gs^Fds, Gll^Fdf, Gll, Gs^Fds, Gs^Fds, Gll, Gll^Fdf, Hh^Fds, Hh^Fds, Hhd^Fdf, Gs^Fds, Gs^Fds, Gll^Fdf, Gs^Fds, Gg, Gg, Gg, Gg, Gg, Gs, Gd, Ds, Ds, Ds, Hd, Hd, Ds, Ds, Wwt, Wwt, Wwt, Wwt, Wwt, Wot, Wwrt, Wot, Wot, Wot, Wot, Wot, Wwrt, Wot, Wot
Gll^Fdf, Gll, Gll, Gll^Fdf, Gll^Fdf, Gs^Fds, Gs^Fds, Gs^Fds, Gll, Gg^Efm, Gg^Efm, Gg^Efm, Gg, Ss, Ss, Wwt, Wwt, Ss, Ss, Gll, Gs^Fds, Gs^Fds, Gll, Gll, Gll, Gs^Fds, Gll, Gll, Gll^Fdf, Gs^Fds, Gll^Fdf, Gll^Fdf, Hh^Fds, Hh^Fds, Hhd^Fdf, Hhd^Fdf, Hh^Fds, Gll^Fdf, Gd, Gll^Fdf, Gs^Fds, Gg, Gg, Gg, Gg, Gs, Gd, Gd, Ds, Ds^Edpp, Ds, Hd, Hd, Ds, Ds, Wwt, Wwt, Wwt, Wot, Wot, Wwrt, Wwrt, Wot, Wot, Wot, Wot, Wot, Wwrt, Wot, Wot
Gs^Fds, Gll^Fdf, Gll, Gll^Fdf, Gll, Gll^Fdf, Gll^Fdf, Gs^Fds, Gs^Fds, Gg, Gg, Gg^Efm, Gg, Gg, Ss, Wwt, Wwt, Wwt, Wwt, Ss, Ss, Gll, Ss, Ss, Ss, Gll, Ss, Gll, Gll, Gll, Gs^Fds, Gs^Fds, Gll^Fdf, Hh^Fds, Hhd^Fdf, Hh^Fds, Gll, Gs^Fds, Gd, Gd^Xfw, Gs^Fds, Gd, Gg, Gg, Gg, Gs, Gd, Ds, Ds, Ds, Ds, Ds, Hd, Ds^Edpp, Ds, Wwt, Wwt, Wot, Wot, Wot, Wwrt, Wot, Wot, Wot, Wot, Wot, Wot, Wwrt, Wot, Wot
Gll^Fdf, Gs^Fds, Gll^Fdf, Gll^Fdf, Gll^Fdf, Gll^Fdf, Gs^Fds, Gll^Fdf, Gs^Fds, Gll, Gg, Gg^Efm, Gg^Efm, Gg, Gg, Ss, Wwt, Wwt, Wwt, Wwt, Wwt, Ss, Wwt, Wwt, Wwt, Ss, Wwt, Ss, Gll, Gll^Fdf, Gll^Fdf, Gs^Fds, Gll, Gll^Fdf, Gll^Fdf, Gll^Fdf, Gs^Vc, Gs^Fds, Gs^Fds, Gd^Xfw, Gd^Xfw, Gd, Gd, Gg, Gg, Gs, Gd, Ds, Ds, Ds, Ds^Edpp, Ds, Ds, Ds, Wwt, Wwt, Wwt, Wot, Wot, Wot, Wwrt, Wot, Wot, Wot, Wot, Wot, Wwrt, Wwrt, Wot, Wot
Gll^Fdf, Gs^Fds, Gs^Fds, Gs^Fds, Gs^Fds, Gll^Fdf, Gll^Fdf, Gs^Fds, Gll^Fdf, Gs^Fds, Gs^Fds, Gg, Gg, Gg, Gg^Es, Gg, Gg, Wwt, Wwt, Wwt, Wwt, Wwt, Wwt, Wwt, Wwt, Wwt, Wwt, Ss, Ss, Gll, Gll, Gll^Fdf, Gll^Fdf, Gll, Gs^Fds, Gll, Gs^Fds, Gs^Fds, Gs^Fds, Gd, Gd^Xfw, Gd, Gd, Gg, Gg, Gs, Gd, Gd, Ds, Ds, Hd, Hd, Ds, Ds, Wwt, Wwt, Wwt, Wot, Wot, Wot, Wot, Wwrt, Wwrt, Wot, Wot, Wot, Wwrt, Wot, Wot, Wot
Gs^Fds, Gll^Fdf, Gll^Fdf, Gs^Fds, Gll^Em, Gs^Fds, Gs^Fds, Gll^Fdf, Gs^Fds, Gs^Fds, Gll, Gs^Fds, Gs^Fds, Gg^Es, Gll, Gg, Gg^Es, Gg, Gg, Wwt, Wwt, Wwt, Ds, Wwt, Wwt, Wwt, Wwt, Wwt, Wwt, Ss, Gll, Re^Vct, Gll, Gll^Fdf, Gll^Fdf, Gs^Fds, Gs^Fds, Gs^Fds, Gs^Fds, Gs^Fds, Gd, Gd^Xfw, Gd^Xfw, Gd, Gg, Gs, Gd, Ds, Ds, Ds, Hd, Ds, Ds, Ds, Wwt, Wwt, Wwt, Wot, Wot, Wot, Wot, Wot, Wwrt, Wot, Wot, Wot, Wot, Wwrt, Wot, Wot
Gs^Fds, Gs^Fds, Gs^Fds, Gll^Fdf, Gs^Fds, Gll^Fdf, Gs^Fds, Gs^Fds, Gs^Fds, Gll^Fdf, Gs^Fds, Gll, Gs^Fds, Gs^Fds, Gll, Gs^Fds, Gs^Fds, Gg^Es, Gg^Es, Gg, Gg, Ds, Gg, Ss, Ss, Ss, Wwt, Wwt, Wwt, Ss, Gll, Gll, Gs^Fds, Gll^Fdf, Gll^Fdf, Re^Vct, Gs^Fds, Gll^Fdf, Gll, Gll^Fdf, Gd, Gd^Xfw, Gd, Gd, Gg, Gs, Gd, Ds, Ds, Ds, Hd, Hd, Hd, Ds, Ds, Wwt, Wwt, Wwt, Wwt, Wwt, Wwt, Wot, Wot, Wwrt, Wot, Wot, Wot, Wwrt, Wot, Wot
Gs^Fds, Gs^Fds, Gll^Fdf, Gll^Fdf, Gs^Fds, Gll^Fdf, Gs^Fds, Gll^Fdf, Gs^Fds, Gll^Fdf, Gs^Fds, Gll^Fdf, Gll^Fdf, Gll, Gll^Fdf, Gs^Fds, Gll, Gs^Fds, Gs^Fds, Gg, Gg, Gg^Es, Gg, Ss, Ss, Ss, Wwt, Wwt, Wwt, Ss, Gll, Gs^Fds, Ke, Ce, Gll, Gs^Fds, Hh^Fds, Gll, Gs^Fds, Gs^Fds, Gg, Gll^Fdf, Gg, Gg, Gg, Gs, Gd, Ds, Ds, Ds^Edpp, Hd, Hd, Hd, Ds, Ds, Wwt, Wwt, Wwt, Wwt, Wwt, Wwt, Wwt, Wot, Wot, Wot, Wot, Wot, Wot, Wot, Wot
Gll^Fdf, Gll^Fdf, Gs^Fds, Gs^Em, Gs^Fds, Gs^Fds, Gs^Fds, Gll^Em, Gll^Fdf, Gs^Fds, Gll^Fdf, Gs^Fds, Gll, Gll^Fdf, Gs^Fds, Gll^Fdf, Gll^Fdf, Gll^Fdf, Gll^Fdf, Gs^Fds, Gs^Fds, Gg, Gg^Efm, Gg, Gg, Ss, Wwf, Wwt, Ss, Ss, Gs^Fds, Gs^Fds, Ce, Ce, Hhd^Fdf, Hhd^Fdf, Hh^Fds, Hh^Fds, Hh^Fds, Gs^Vc, Gs^Fds, Gg, Gg, Gg, Gg, Gs, Gs^Vc, Gd, Ds, Ds, Ds, Hd, Hd, Hd, Ds, Wwt, Ds, Wwt, Wwt, Wwt, Wwt, Wwt, Wot, Wot, Wwrt, Wot, Wot, Wwrt, Wot, Wot
Gll^Fdf, Gll^Fdf, Gs^Fds, Gll^Fdf, Gll^Fdf, Gs^Fds, Gs^Fds, Gs^Fds, Gll^Fdf, Gs^Fds, Gs^Fds, Gs^Fds, Gs^Fds, Gll^Fdf, Gs^Fds, Gll, Gs^Fds, Gs^Fds, Gll^Fdf, Gll, Gs^Fds, Gg, Gg^Efm, Gg, Ds, Ds, Wwt, Wwf, Wwf, Gg, Gs^Fds, Gll^Fdf, Gll^Fdf, Gs^Fds, Hh^Fds, Hhd^Fdf, Hhd^Fdf, Hh^Fds, Hh^Fds, Gs^Fds, Gd, Gd, Gd, Gg, Gg, Gs, Gs, Gd, Gd, Ds, Ds, Ds, Ds, Hd, Hd, Ds, Ds, Ds, Ds, Wwt, Wwt, Wwt, Wot, Wwrt, Wot, Wot, Wwrt, Wwrt, Wot, Wot
Gs^Fds, Gs^Fds, Gs^Fds, Gll^Fdf, Gs^Fds, Gll^Fdf, Gll^Em, Gll^Fdf, Gs^Fds, Gs^Fds, Gs^Fds, Gs^Fds, Gs^Fds, Gll^Fdf, Gs^Fds, Gs^Fds, Gll^Fdf, Gll^Fdf, Gs^Fds, Gs^Fds, Gg^Es, Gg^Efm, Gg^Efm, Gg^Efm, Wwt, Wwt, Wwt, Wwt, Ss, Gg, Gs^Fds, Gll, 4 Ke, Ce, Gll, Hh^Fds, Hh^Fds, Hhd^Fdf, Hh^Fds, Gs^Fds, Gs^Fds, Gd^Xfw, Gd^Xfw, Gd, Gg, Gg, Gg, Gs, Gs, Gd, Ds, Ds, Ds, Hd, Hd, Hd, Ds^Edpp, Ds, Ds, Wwt, Wwt, Wwt, Wot, Wot, Wot, Wot, Wwrt, Wot, Wot, Wot
Gs^Fds, Gll^Fdf, Gs^Fds, Gs^Fds, Gs^Fds, Gs^Fds, Gll^Fdf, Gll^Fdf, Gs^Fds, Gll^Fdf, Gll^Fdf, Gll^Fdf, Gs^Fds, Gll^Fdf, Gll^Fdf, Gll^Fdf, Gs^Fds, Gll, Gg, Gg, Gg^Efm, Gg^Efm, Wwt, Wwt, Wwt, Wwt, Wwt, Ss, Gg, Gg, Gs^Fds, Re^Vct, Ce, Ce, Gs^Fds, Hh^Fds, Hh^Fds, Hhd^Fdf, Hh^Fds, Gs^Fds, Gll^Fdf, Gd^Xfw, Gd^Xfw, Gd, Gd, Gg, Gg, Gs, Gs, Gd, Ds, Ds^Edpp, Ds, Ds, Hd, Hd, Ds, Ds, Wwt, Wwt, Wwt, Wwt, Wot, Wwrt, Wot, Wot, Wwrt, Wot, Wot, Wot
Gll^Fdf, Gs^Fds, Gs^Fds, Gs^Fds, Gll^Fdf, Gll^Fdf, Gs^Fds, Gs^Fds, Gll^Fdf, Gll^Fdf, Gll^Fdf, Gs^Fds, Gs^Fds, Gll^Fdf, Gll^Fdf, Gll, Gs^Fds, Gg, Ss, Ss, Wwt, Wwt, Wwt, Wwt, Wwt, Wwt, Wwt, Ss, Gg, Gs^Fds, Gll, Gll, Gll, Gll, Gll^Fdf, Hhd^Fdf, Hhd^Fdf, Hhd^Fdf, Gll^Fdf, Gs^Fds, Gll^Fdf, Gd, Gs^Fds, Gd^Xfw, Gd^Xfw, Gd, Gs, Gs, Gd, Gd, Ds, Ds, Hd, Hd, Ds, Ds, Ds, Ds, Wwt, Wwt, Wwt, Wwt, Wot, Wwrt, Wot, Wot, Wot, Wwrt, Wot, Wot
Gll^Fdf, Gll^Fdf, Gll^Fdf, Gll^Fdf, Gll^Fdf, Gs^Fds, Gs^Fds, Gs^Fds, Gs^Fds, Gll^Fdf, Gll^Fdf, Gs^Fds, Gll^Fdf, Gll^Fdf, Gs^Fds, Gs^Fds, Gll, Gg^Es, Ss, Ss, Wwt, Wwt, Wwt, Wwt, Ss, Wwt, Ss, Ss, Gs^Fds, Gll^Fdf, Gs^Fds, Gs^Fds, Hh^Fds, Gll^Fdf, Gll, Gll^Fdf, Gll^Fdf, Gs^Fds, Gll, Gs^Fds, Gll, Gll^Fdf, Gs^Fds, Gs^Fds, Gd^Xfw, Gd, Gs, Gs, Gd, Ds, Ds, Ds, Hd, Ds, Ds^Edpp, Ds, Wwt, Wwt, Wwt, Wwt, Wwt, Wot, Wot, Wwrt, Wwrt, Wot, Wot, Wwrt, Wot, Wot
Gll^Fdf, Gll^Fdf, Gs^Fds, Gll^Fdf, Gll^Fdf, Gs^Fds, Gll^Fdf, Gll^Fdf, Gs^Fds, Gll^Fdf, Gll^Fdf, Gll^Fdf, Gll^Fdf, Gs^Fds, Gs^Fds, Gs^Fds, Gll, Gg, Ss, Wwt, Wwt, Wwt, Ss, Ss, Ss, Ss, Gll^Fdf, Gs^Fds, Gll^Fdf, Gll^Fdf, Gs^Fds, Hh^Fds, Hh^Fds, Gs^Fds, Gs^Fds, Gll, Gs^Fds, Gll^Fdf, Gs^Vc, Gs^Fds, Gll, Gll^Fdf, Gs^Fds, Gd^Xfw, Gd, Gd, Gg, Gs, Gd, Ds, Ds, Hd, Hd, Ds, Ds^Edpp, Ds, Wwt, Wwt, Wwt, Wwt, Wot, Wot, Wot, Wwrt, Wot, Wot, Wot, Wwrt, Wwrt, Wot
Gll^Fdf, Gs^Fds, Gs^Fds, Gs^Fds, Gll^Fdf, Gll^Fdf, Gll^Fdf, Gs^Fds, Gs^Fds, Gll^Fdf, Gs^Fds, Gs^Fds, Gll^Fdf, Gs^Fds, Gs^Fds, Gll, Gll, Ss, Ss, Wwt, Wwt, Wwt, Ss, Ss, Ss, Gll, Gll^Fdf, Gll, Gs^Fds, Gll^Fdf, Hh^Fds, Hhd^Fdf, Hhd^Fdf, Hh^Fds, Hh^Fds, Gs^Fds, Gll, Gll^Fdf, Gs^Fds, Gs^Fds, Gll, Gll^Fdf, Gd^Xfw, Gd^Xfw, Gd, Gd, Gg, Gs, Gd, Ds, Ds, Hd, Hd, Ds, Ds, Ds, Wwt, Wwt, Wwt, Wwt, Wwt, Wot, Wot, Wot, Wwrt, Wot, Wot, Wwrt, Wot, Wot
Gs^Fds, Gs^Fds, Gs^Fds, Gs^Fds, Gll^Fdf, Gll^Fdf, Gs^Fds, Gs^Fds, Gll^Fdf, Gll^Fdf, Gs^Fds, Gs^Fds, Gll^Fdf, Gs^Fds, Gll^Em, Gs^Fds, Gll^Es, Gg, Ds, Wwt, Wwt, Wwt, Wwt, Ss, Ss, Gll, Gll^Fdf, Gs^Fds, Gs^Fds, Gll, Hhd^Fdf, Hh^Fds, Hh^Fds, Hhd^Fdf, Hhd^Fdf, Hh^Fds, Hh^Fds, Gll^Fdf, Gll, Gll, Gll, Gll^Fdf, Gs^Fds, Gd^Xfw, Gg, Gg, Gg, Gs, Gd, Ds, Ds, Hd, Hd, Hd, Ds, Ds, Ds, Wwt, Wwt, Wwt, Wwt, Wwt, Wwt, Wot, Wot, Wwrt, Wwrt, Wot, Wwrt, Wot
Gs^Fds, Gll^Fdf, Gll^Fdf, Gll^Fdf, Gs^Fds, Gs^Fds, Gll^Fdf, Gll^Fdf, Gll^Fdf, Gll^Fdf, Gll^Fdf, Gll^Fdf, Gll^Fdf, Gs^Fds, Gll, Gs^Fds, Gll, Gg, Ds, Wwt, Wwt, Wwt, Wwt, Wwt, Wwt, Ss, Ss, Gll, Gs^Fds, Gll^Fdf, Gll, Hhd^Fdf, Hh^Fds, Hh^Fds, Hhd^Fdf, Hhd^Fdf, Hhd^Fdf, Hh^Fds, Gll, Gs^Fds, Gll^Fdf, Gs^Fds, Gll, Gs^Fds, Gg, Gg, Gg, Gs, Gs, Gd, Ds, Ds, Ds, Hd, Hd, Ds, Ds, Wwt, Wwt, Wwt, Wwt, Wwt, Wwt, Wot, Wot, Wot, Wwrt, Wot, Wwrt, Wot
Gs^Fds, Gs^Fds, Gs^Fds, Gs^Fds, Gll^Fdf, Gs^Fds, Gs^Fds, Gll^Fdf, Gs^Fds, Gll^Fdf, Gll^Fdf, Gs^Fds, Gll^Fdf, Gs^Fds, Gs^Fds, Gll, Gs^Fds, Gg, Gg^Es, Wwt, Wwt, Wwt, Wwt, Wwt, Wwt, Wwt, Ss, Ss, Gll, Gs^Fds, Gs^Fds, Hh^Fds, Hh^Fds, Hh^Fds, Hhd^Fdf, Hh^Fds, Hhd^Fdf, Hh^Fds, Gs^Fds, Gll^Fdf, Gll^Fdf, Gs^Fds, Gll, Gs^Fds, Gs^Fds, Gg, Gg, Gg, Gs, Gd, Gd, Ds, Ds^Edpp, Ds, Hd, Ds, Ds, Wwt, Wwt, Wwt, Wwt, Wwt, Wwt, Wwt, Wot, Wot, Wwrt, Wot, Wwrt, Wot
Gs^Fds, Gll^Fdf, Gs^Fds, Gs^Fds, Gs^Fds, Gll^Fdf, Gs^Fds, Gll^Fdf, Gll^Fdf, Gs^Fds, Gll^Fdf, Gll^Fdf, Gll^Fdf, Gs^Fds, Gs^Fds, Gs^Fds, Gs^Fds, Gg, Gg^Es, Gg^Efm, Ds, Ds, Ss, Wwt, Wwt, Wwt, Wwt, Ss, Gll, Gll, Gll, Gs^Fds, Gs^Fds, Gll^Fdf, Hh^Fds, Hhd^Fdf, Hh^Fds, Hh^Fds, Gll, Gs^Fds, Gll^Fdf, Gs^Fds, Gll, Gs^Vc, Gs^Fds, Gg, Gg, Gg, Gg, Gs, Gd, Ds, Ds^Edpp, Ds, Hd, Ds, Ds, Ds, Ds, Ds, Ds, Wwt, Wwt, Wwt, Wwt, Wot, Wwrt, Wot, Wwrt, Wot
Gs^Fds, Gll^Fdf, Gll^Fdf, Gs^Fds, Gs^Fds, Gs^Fds, Gs^Fds, Gll^Fdf, Gs^Fds, Gll^Fdf, Gll^Fdf, Gll^Fdf, Gs^Fds, Gll^Fdf, Gll^Fdf, Gs^Fds, Gs^Fds, Gs^Fds, Gg, Gg, Gg, Ss, Ss, Ss, Wwt, Wwt, Wwt, Ss, Ss, Gll, Gll, Gll, Gs^Fds, Gll^Fdf, Gs^Fds, Hh^Fds, Hh^Fds, Hh^Fds, Gs^Fds, Gs^Fds, Gll, Gll^Fdf, Gll^Fdf, Gll, Gs^Fds, Gg, Gg, Gg, Gg, Gs, Gd, Ds, Ds, Ds, Ds, Hd, Hd, Hd, Hd, Ds, Ds, Wwt, Wwt, Wwt, Wwt, Wot, Wwrt, Wot, Wot, Wwrt
Gs^Fds, Gs^Fds, Gs^Fds, Gll^Fdf, Gs^Fds, Gll^Fdf, Gll^Fdf, Gs^Fds, Gs^Fds, Gll^Fdf, Gs^Fds, Gs^Fds, Gll^Fdf, Gs^Fds, Gg, Gll^Fdf, Gs^Fds, Gs^Fds, Gg, Gg, Gg, Gg, Gg, Ss, Ss, Wwt, Wwt, Wwt, Ss, Gll, Gll, Gs^Fds, Gs^Fds, Gll^Fdf, Gg, Gs^Fds, Gg, Gs^Fds, Gll, Gll, Gll, Gs^Fds, Gg, Gll^Fdf, Gg, Gg, Gg, Gg, Gg, Gs, Gg, Gd, Ds, Ds, Ds, Hd, Ds, Hd, Hd, Ds, Ds, Wwt, Wwt, Wwt, Wwt, Wot, Wwrt, Wot, Wot, Wwrt
