border_size=1
usage=map

Gs^Fds, Gg, Gs^Fds, Gg, Gg, Rb, Rb, Gg, Gs^Fds, Gg, Gll^Fdf, Gll, Gll^Fdf, Gll^Fdf, Gll, Gll, Gll^Fdf, Gll, Gll, Gll, Gll^Fdf, Gll, Gll^Fdf, Gll, Gll, Gll, Gs^Fds, Gg, Gs^Fds, Gs^Fds, Gs^Fds, Gg, Gll^Fdf, Gg, Gs^Fds, Gll, Gll, Gll, Gll, Gll, Gll, Gs^Fds, Gs^Fds, Gll, Gll^Fdf, Gll, Gll, Gll, Gs^Fds, Gs^Fds, Gll, Gll
Gs^Fds, Gs^Fds, Gg^Efm, Gg^Efm, Gg, Rb, Rb, Gg, Gg^Es, Gll, Gg^Efm, Gll, Gg^Efm, Gll, Gs^Fds, Gll^Fdf, Gs^Fds, Gs^Fds, Gll^Fdf, Gll^Fdf, Gll, Gll, Gll^Fdf, Gll^Fdf, Gs^Fds, Gs^Fds, Gs^Fds, Gll^Fdf, Gs^Fds, Gll, Gll, Gs^Fds, Gll, Gll^Fdf, Gs^Fds, Gs^Fds, Gll^Fdf, Gll^Fdf, Gll, Gll, Gll^Fdf, Gll^Fdf, Gll^Fdf, Gs^Fds, Gll^Fdf, Gs^Fds, Gll, Gll, Gs^Fds, Gs^Fds, Gll, Gll
Gll^Fdf, Gs, Gg, Gg^Efm, Gg, Rb, Rb, Rb, Rb, Gg, Gg, Gg^Efm, Gg, Gg^Efm, Gs^Fds, Gll, Gll, Gll^Fdf, Gll^Fdf, Gs^Fds, Gll, Gll, Gll^Fdf, Gll, Gs^Fds, Gs^Fds, Gs^Fds, Gll^Fdf, Gll, Gll^Fdf, Gs^Fds, Gll^Fdf, Gs^Fds, Gll, Gs^Fds, Gll, Gll^Fdf, Gs^Fds, Gs^Fds, Gs^Fds, Gll^Fdf, Gll, Gs^Fds, Gll, Gll^Fdf, Gll^Fdf, Gll, Gll, Gs^Fds, Gs^Fds, Gll, Gll
Gll^Fdf, Gll^Fdf, Gs^Fds, Gg^Efm, Gg^Efm, Gg, Gg, Rb, Rb, Rb, Rb, Gg, Gg, Gg^Efm, Gs, Gs^Fds, Gg, Gll, Gll, Gll^Fdf, Gll^Fdf, Gll, Gll, Gll^Fdf, Gs^Fds, Gll, Gs^Fds, Gll, Gll^Fdf, Gll^Fdf, Gll, Gll^Fdf, Gll^Fdf, Gs^Fds, Gll, Gll, Gll^Fdf, Gll, Gs^Fds, Gs^Fds, Gll, Gll, Gll, Gll, Gll^Fdf, Gs^Fds, Gll^Fdf, Gs^Fds, Gll^Fdf, Gll, Gs^Fds, Gll
Gs^Fds, Gll, Gll^Fdf, Gs^Fds, Gll, Gg^Efm, Gg^Efm, Gg, Gg^Es, Rb, Rb, Rb, Rb, Gg, Gg, Gs, Gs, Gg, Gs^Fds, Gll^Fdf, Gll^Fdf, Gll, Gll, Gll^Fdf, Gll^Fdf, Gs^Fds, Gll, Gs^Fds, Gs^Fds, Gll, Gs^Fds, Gll, Gll, Gll^Fdf, Gll, Gll, Gll^Fdf, Gll, Gs^Fds, Gs^Fds, Gs^Fds, Gll, Gs^Fds, Gll^Fdf, Gs^Fds, Gll^Fdf, Gll^Fdf, Gll, Gll^Fdf, Gll^Fdf, Gll^Fdf, Gll^Fdf
Gs^Fds, Gll^Fdf, Gll^Fdf, Gll^Fdf, Gs^Fds, Gll, Gll, Gg, Gll^Fdf, Gg, Gg^Efm, Rb, Rb^Es, Rb, Rb, Gg, Gg^Es, Gg, Gs, Gs^Fds, Gs^Fds, Gll^Fdf, Gll^Fdf, Gll^Fdf, Gll, Gll^Fdf, Gll, Gll^Fdf, Gs^Fds, Gll^Fdf, Gll^Fdf, Gll, Gs^Fds, Gs^Fds, Gll, Gll^Fdf, Gll^Fdf, Gll^Fdf, Gll^Fdf, Gg, Gll^Fdf, Gll^Fdf, Gll, Gll, Gll, Gll, Gll^Fdf, Gs^Fds, Gll^Fdf, Gll, Gll, Gs^Fds
Gll, Gs^Fds, Gll, Gll, Gll^Fdf, Gs^Fds, Gll^Fdf, Gll^Fdf, Gll^Fdf, Gg^Efm, Gg^Efm, Gg, Gs, Rb, Rb, Rb, Rb, Gg^Es, Gg, Gs, Gg, Gll, Gll, Gs^Fds, Gll^Fdf, Gll^Fdf, Gll^Fdf, Gll^Fdf, Gll, Gll^Fdf, Gll^Fdf, Gs^Fds, Gll, Gs^Fds, Gs^Fds, Gs^Fds, Gll^Fdf, Gll^Fdf, Gs^Fds, Gs^Fds, Gs^Fds, Gs^Fds, Gll, Gll^Fdf, Gll^Fdf, Gll^Fdf, Gs^Fds, Gs^Fds, Gll, Gll^Fdf, Gs^Fds, Gs^Fds
Gll, Gll, Gs^Fds, Gll^Fdf, Gll, Gll^Fdf, Gll, Gll, Gll^Fdf, Gg, Gll, Gs^Fds, Gs^Fds, Gs, Gg^Efm, Rb, Rb, Gg, Gg^Efm, Gg^Efm, Gg^Efm, Gg, Gs^Fds, Gs^Fds, Gll^Fdf, Gs^Fds, Gll, Gs^Fds, Gll, Gll^Fdf, Gll, Gll^Fdf, Gll, Gll^Fdf, Gll, Gll, Gs^Fds, Gs^Fds, Gll, Gll, Gll^Fdf, Gs^Fds, Gll, Gll^Fdf, Gs^Fds, Gll, Gll, Gs^Fds, Gs^Fds, Gs^Fds, Gll^Fdf, Gs^Fds
Gll^Fdf, Gll^Fdf, Gll^Fdf, Gs^Fds, Gll, Gll^Fdf, Gll, Gs^Fds, Gll, Gll^Fdf, Gll^Fdf, Gll, Gll, Gg^Efm, Gg, Rb, Rb, Gg, Gg^Efm, Gg, Gg^Efm, Gg, Gs, Gs^Fds, Gs, Gll^Fdf, Gll^Fdf, Gs^Fds, Gll, Gll^Fdf, Gll, Gll, Gll, Gll, Gs^Fds, Gs^Fds, Gll^Fdf, Gs^Fds, Gll^Fdf, Gll^Fdf, Gll, Gll^Fdf, Gs^Fds, Gll^Fdf, Gs^Fds, Gs^Fds, Gll^Fdf, Gll, Gs^Fds, Gs^Fds, Gs^Fds, Gll
Gs^Fds, Gll, Gll, Gll, Gll^Fdf, Gll^Fdf, Gll^Fdf, Gll, Gll, Gs^Fds, Gll, Gll^Fdf, Gll^Fdf, Gg^Efm, Gg^Es, Rb, Rb, Gg, Gg, Gg^Efm, Gg^Efm, Re^Vct, Gg^Efm, Gg, Gg^Efm, Gs, Gs^Fds, Gll^Fdf, Gll^Fdf, Gll^Fdf, Gll, Gll^Fdf, Gll^Fdf, Gll^Fdf, Gs^Fds, Gll^Fdf, Gll, Gll, Gll^Fdf, Gll, Gll, Gs^Fds, Gs^Fds, Gll^Fdf, Gll^Fdf, Gll^Fdf, Gs^Fds, Gll^Fdf, Gs^Fds, Gll, Gll, Gs^Fds
Gs, Gll^Fdf, Gll, Gll^Fdf, Gll, Gs^Fds, Gll, Gll^Fdf, Gs^Fds, Gll, Gs^Fds, Gll, Gll^Fdf, Gg, Gg^Es, Rb, Rb^Es, Gg, Gs^Fds, Gg, Gs^Fds, Gg, Gg^Efm, Gg^Efm, Gg, Gs, Gs, Gs^Fds, Gs^Fds, Gll^Fdf, Gll, Gll, Gll^Fdf, Gll^Fdf, Gs^Fds, Gll^Fdf, Gs^Fds, Gs^Fds, Gs^Fds, Gll, Gll, Gs^Fds, Gs^Fds, Gs^Fds, Gll^Fdf, Gll^Fdf, Gll, Gll^Fdf, Gs^Fds, Gll, Gll, Gs^Fds
Gg, Gs, Gg^Es, Gg^Es, Gg^Es, Gs^Fds, Gg, Gll, Gll^Fdf, Gll^Fdf, Gll^Fdf, Gll^Fdf, Gll^Fdf, Gg^Es, Gg, Rb, Rb, Gg^Efm, Gs^Fds, Gll^Fdf, Gs^Fds, Gll, Gg, Gg, Gg^Es, Re^Vct, Gg, Gs^Fds, Gs^Fds, Gll, Gll, Gs^Fds, Gll^Fdf, Gll, Gs^Fds, Gll^Fdf, Gll^Fdf, Gll^Fdf, Gll^Fdf, Gll^Fdf, Gll^Fdf, Gs^Fds, Gll^Fdf, Gll^Fdf, Gll^Fdf, Gs^Fds, Gs^Fds, Gll^Fdf, Gll^Fdf, Gs^Fds, Gs^Fds, Gs^Fds
Gg, Gg, Gg^Efm, Gg, Gg^Es, Gg, Gll^Fdf, Gll^Fdf, Gll^Fdf, Gll, Gs^Fds, Gll^Fdf, Gs^Fds, Gg^Efm, Gg, Rb, Rb, Gg^Efm, Gg^Efm, Gll^Fdf, Ce, Ce, Ce, Gg^Es, Gg, Gg, Gg, Gs, Gs, Gs^Fds, Gll, Gll, Gll^Fdf, Gll, Gll, Gs^Fds, Gll, Gll^Fdf, Gll^Fdf, Gll^Fdf, Gll^Fdf, Gll^Fdf, Gll^Fdf, Gll, Gll, Gs^Fds, Gs^Fds, Gs^Fds, Gll^Fdf, Gs^Fds, Gll^Fdf, Gs^Fds
Gg, Gg^Efm, Gg, Gg^Efm, Gg^Efm, Gg, Gs, Gs^Fds, Gg, Gs, Gg, Gll, Gg^Es, Gg^Efm, Gg^Efm, Rb, Rb, Rb, Rb, Gg, Ce, 1 Ke, Ce, Gg^Es, Rb, Rb, Rb, Gg, Gg, Gg^Efm, Gg^Efm, Gg, Gll^Fdf, Gs^Fds, Gll^Fdf, Gs^Fds, Gll^Fdf, Gll, Gs^Fds, Gll^Fdf, Gs^Fds, Gs^Fds, Gs^Fds, Gs^Fds, Gs^Fds, Gs^Fds, Gs^Fds, Gll, Gll, Gs^Fds, Gs^Fds, Gll
Gg^Efm, Gg^Efm, Gg, Gg^Efm, Gg^Efm, Gg, Re^Vct, Gs, Gg^Efm, Gg, Gg^Es, Gg^Es, Gg, Gg, Gg, Gg, Gg, Rb^Es, Rb, Gg^Es, Gg^Es, Ce, Rb, Rb, Gg, Gg, Gg^Es, Rb, Rb, Gg, Gg, Gg, Gs^Fds, Gll^Fdf, Gs^Fds, Gll^Fdf, Gs^Fds, Gs^Fds, Gs^Fds, Gs^Fds, Hh^Fds, Hh^Fds, Hh^Fds, Hh^Fds, Hhd^Fdf, Hh^Fds, Hh^Fds, Gs^Fds, Gs^Fds, Gll, Gs^Fds, Gll
Gg^Efm, Gg, Gg^Efm, Gg^Efm, Gg, Gg, Gg^Es, Gg, Gg^Efm, Gg^Efm, Gs, Gs, Gs^Fds, Gg, Gll, Gg, Gg^Efm, Rb, Rb, Gg, Rb, Rb, Gg, Gg, Gll^Fdf, Gs, Gs, Gg, Gg^Es, Rb, Rb, Gg^Es, Gs^Fds, Gs^Fds, Hh^Fds, Hhd^Fdf, Hhd^Fdf, Hh^Fds, Hhd^Fdf, Hhd^Fdf, Mm, Hh^Fds, Mm, Mm, Mm, Mm, Mm, Hhd^Fdf, Gs^Fds, Gs^Fds, Gs^Fds, Gs^Fds
Gg, Gg, Re^Vct, Gg, Gll, Gg, Gg^Es, Gg, Gg, Gg, Gs, Gll^Fdf, Gs^Fds, Gs^Fds, Gll^Fdf, Gs^Fds, Gg^Efm, Rb, Rb, Rb, Gg, Gg, Gs^Fds, Gs^Fds, Gs^Fds, Gs^Fds, Gs^Fds, Gg^Es, Gs, Gg, Rb, Gg, Hhd^Fdf, Hh^Fds, Mm, Mm, Mm, Mm, Mm, Mm, Mm, Mm, Mm, Mm, Mm, Mm, Mm, Hh^Fds, Hh^Fds, Hhd^Fdf, Hh^Fds, Gg
Gg, Gg, Gll^Fdf, Gs^Fds, Ce, Ce, Ce, Gg^Es, Gg, Gg, Gg, Gll^Fdf, Gs^Fds, Gll^Fdf, Gll, Gll^Fdf, Gs^Fds, Gg^Es, Rb, Rb, Gg^Efm, Gg^Efm, Gll^Fdf, Gll^Fdf, Gll^Fdf, Gll^Fdf, Gll^Fdf, Gs, Gs, Gg, Rb, Gs, Hh^Fds, Mm, Mm, Mm, Mm, Mm, Mm, Mm, Mm, Mm^Xm, Mm^Xm, Mm^Xm, Mm^Xm, Mm, Mm, Mm, Mm, Mm, Mm, Hh^Fds
Gs^Fds, Gs^Fds, Gll^Fdf, Gll^Fdf, Ce, 4 Ke, Ce, Gs^Fds, Gs, Re^Vct, Gg^Efm, Gs^Fds, Gs^Fds, Gll^Fdf, Gs^Fds, Gs^Fds, Gs, Gg, Rb, Rb, Gg, Gg^Efm, Gll^Fdf, Gll^Fdf, Gs^Fds, Gs^Fds, Hh^Fds, Hh^Fds, Hhd^Fdf, Gg, Gg, Rb, Hh^Fds, Mm, Mm, Mm, Mm, Mm, Mm, Mm, Mm, Mm, Mm, Mm, Mm, Mm^Xm, Mm, Mm, Mm, Mm^Xm, Mm, Mm
Gg, Gs^Fds, Gs^Fds, Gll^Fdf, Gll^Fdf, Ce, Gll, Gs^Fds, Gs, Gg^Efm, Gg, Gg, Gg, Gg, Gg, Gs, Rb, Rb, Gg, Rb, Rb, Gg, Gs^Fds, Gll^Fdf, Hh^Fds, Hhd^Fdf, Mm, Mm, Mm, Hh^Fds, Hhd^Fdf, Rb, Uue, Xue, Mm, Mm^Xm, Mm^Xm, Mm, Mm, Mm, Mm, Mm, Mm, Mm, Mm, Mm, Mm, Mm, Mm, Mm^Xm, Mm^Xm, Mm
Gg, Gs, Gs, Gll^Fdf, Gll^Fdf, Gll, Gs^Fds, Gs^Fds, Gg, Gg, Gg, Gg^Efm, Rb, Rb, Rb, Rb, Gg, Gg, Gg^Es, Rb, Rb, Gg, Hhd^Fdf, Hh^Fds, Mm, Mm, Mm, Mm, Mm, Mm, Uue, Rb, Uue, Xue, Xue, Mm^Xm, Mm^Xm, Mm^Xm, Mm^Xm, Mm, Mm^Xm, Mm, Mm^Xm, Mm, Mm^Xm, Mm, Mm, Mm, Mm^Xm, Mm^Xm, Mm, Mm
Gg^Efm, Gg^Es, Gg, Gs, Gll^Fdf, Gll^Fdf, Gll, Gs, Gg^Es, Gg, Rb, Rb, Gg^Es, Gg, Gll^Fdf, Gg, Gs^Fds, Gll^Fdf, Gll^Fdf, Rb, Rb, Gg, Hhd^Fdf, Mm, Mm, Mm, Mm, Mm, Mm, Xue, Uue, Ur, Ur, Uh, Xue, Mm^Xm, Mm^Xm, Mm^Xm, Mm^Xm, Mm^Xm, Mm^Xm, Mm^Xm, Mm, Mm^Xm, Mm^Xm, Mm^Xm, Mm^Xm, Mm, Mm^Xm, Mm^Xm, Mm, Mm
Gg, Gg^Efm, Gg^Efm, Gg, Gs^Fds, Gs^Fds, Gg, Gg^Es, Rb, Rb^Es, Rb^Es, Gg, Gs, Gll^Fdf, Gs^Fds, Gs^Fds, Gll^Fdf, Gs^Fds, Gll^Fdf, Rb, Rb, Rb, Hh^Fds, Mm, Mm, Mm, Mm, Mm, Mm, Xue, Xue, Ur, Ur, Ur, Xue, Mm^Xm, Mm^Xm, Mm^Xm, Mm^Xm, Mm^Xm, Mm^Xm, Mm^Xm, Mm^Xm, Mm^Xm, Mm^Xm, Mm^Xm, Mm^Xm, Mm, Mm, Mm, Mm, Mm
Gg, Gg^Efm, Gg^Efm, Gg, Gg, Gg, Rb, Rb, Gg^Efm, Gg^Efm, Rb, Gg^Es, Gs^Fds, Gs^Fds, Gll^Fdf, Gs^Fds, Hh^Fds, Hh^Fds, Hhd^Fdf, Hh^Fds, Hhd^Fdf, Rb, Ur, Xue, Xue, Mm, Mm, Mm, Mm, Mm, Xue, Uu^Uf, Ur, Ur, Re^Vct, Xue, Mm^Xm, Mm^Xm, Mm^Xm, Mm^Xm, Xue, Xue, Xue, Xue, Xue, Xue, Xue, Mm, Mm, Mm, Mm^Xm, Mm
Gll^Fdf, Gg, Gg, Gg, Rb, Rb, Gll^Fdf, Gs^Fds, Gll^Fdf, Gg^Efm, Rb, Gg, Gll^Fdf, Gs^Fds, Hh^Fds, Hhd^Fdf, Mm, Mm, Mm, Mm, Xue, Ur, Ur, Ur, Xue, Mm, Mm, Mm, Mm, Mm, Mm, Xue, Uh, Ur, Ur, Xue, Xue, Xue, Xue, Xue, Uu^Uf, Uu^Uf, Ur, Re^Vct, Uu^Uf, Uh, Uh, Xue, Mm, Mm, Mm, Mm^Xm
Gs^Fds, Gll^Fdf, Gs, Rb, Gg^Efm, Gll^Fdf, Gs^Fds, Gs^Fds, Gll^Fdf, Gg, Rb, Gg, Hhd^Fdf, Hh^Fds, Mm, Mm, Mm, Mm, Mm, Mm, Xue, Ur, Ur, Ur, Ur, Xue, Mm, Mm, Mm, Mm, Mm^Xm, Xue, Uh, Ur, Ur, Ur, Ur, Re^Vct, Ur, Ur, Ur, Ur, Ur, Ur, Ur, Ur, Uue, Xue, Mm, Mm, Mm, Mm^Xm
Gll, Gll^Fdf, Gll^Fdf, Rb, Gg^Efm, Gll^Fdf, Hh^Fds, Hh^Fds, Hhd^Fdf, Gs, Rb, Gg^Es, Hhd^Fdf, Mm, Mm, Mm, Mm, Mm, Mm, Mm, Mm, Xue, Xue, Ur, Ur, Xue, Xue, Mm^Xm, Mm, Mm, Mm^Xm, Xue, Xue, Ur, Ur, Ur, Ur, Ur, Ur, Ur, Ur, Ur, Xue, Ur, Ur, Ur, Uue, Xue, Mm^Xm, Mm, Mm, Mm
Gs^Fds, Gs^Fds, Gg^Efm, Rb, Rb, Hhd^Fdf, Mm, Mm, Mm, Gg, Rb, Hh^Fds, Mm, Mm, Mm, Mm, Mm, Mm, Mm, Mm, Mm, Mm^Xm, Xue, Ur, Ur, Re^Vct, Xue, Mm^Xm, Mm^Xm, Mm^Xm, Xue, Xue, Ur, Ur, Ur, Ur, Rb, Xue, Xue, Xue, Xue, Xue, Mm, Xue, Ur, Ur, Re^Vct, Xue, Mm^Xm, Mm, Mm, Mm
Hh^Fds, Hh^Fds, Hh^Fds, Gg^Efm, Rb, Hh^Fds, Mm, Mm, Xue, Ur, Ur, Mm, Xue, Mm^Xm, Mm^Xm, Mm, Mm^Xm, Mm, Mm, Mm, Mm, Mm^Xm, Mm^Xm, Xue, Ur, Ur, Ur, Xue, Xue, Xue, Ur, Ur, Ur, Ur, Re^Vct, Xue, Ce, Rb, Hh^Fds, Mm, Mm, Mm, Mm, Mm, Rb, Uue, Xue, Xue, Mm^Xm, Mm, Mm, Mm
Mm, Mm, Mm, Hhd^Fdf, Rb, Rb, Xue, Xue, Ur, Ur, Ur, Xue, Uue, Xue, Xue, Xue, Xue, Mm^Xm, Mm^Xm, Mm, Mm^Xm, Mm^Xm, Xue, Xue, Ur, Ur, Ce, Ur, Ur, Ur, Ur, Ur, Xue, Xue, Xue, Xue, Gg, Rb, Gg^Es, Hhd^Fdf, Hhd^Fdf, Mm, Mm, Hhd^Fdf, Gg^Es, Rb, Hh^Fds, Mm^Xm, Mm, Mm, Hhd^Fdf, Hhd^Fdf
Mm, Mm, Mm, Mm, Re^Vct, Ur, Ur, Ur, Ur, Ur, Ur, Ur, Ur, Uue, Uue, Uue, Ur, Xue, Xue, Xue, Xue, Xue, Ur, Ur, Ur, Ce, 3 Ke, Ce, Ur, Ur, Xue, Xue, Mm^Xm, Mm^Xm, Mm, Hhd^Fdf, Hhd^Fdf, Rb, Rb, Gg^Es, Hh^Fds, Mm, Mm, Hh^Fds, Gg^Es, Rb, Hhd^Fdf, Mm, Mm, Mm, Hhd^Fdf, Gll^Fdf
Mm, Mm, Xue, Xue, Ur, Ur, Uu^Uf, Uu^Uf, Xue, Xue, Ur, Ur, Ur, Ur, Ur, Ur, Ur, Ur, Ur, Re^Vct, Ur, Ur, Ur, Ur, Ur, Ce, Ce, Ce, Ur, Re^Vct, Xue, Mm^Xm, Mm, Mm, Mm, Mm, Hh^Fds, Gg, Gg^Es, Rb, Hh^Fds, Mm, Mm, Hh^Fds, Gg^Es, Rb, Gll^Fdf, Hhd^Fdf, Hh^Fds, Hh^Fds, Gs^Fds, Gs^Fds
Mm, Mm, Xue, Ur, Xue, Ur, Ur, Xue, Ce, Ce, Ur, Ur, Re^Vct, Ur, Uu^Uf, Ur, Ur, Ur, Ur, Ur, Ur, Ur, Xue, Re^Vct, Uu^Uf, Ur, Ur, Ur, Ce, Uue, Xue, Mm^Xm, Mm, Mm, Mm^Xm, Mm, Hh^Fds, Gg, Gg^Es, Rb, Rb, Hhd^Fdf, Hhd^Fdf, Hhd^Fdf, Ce, Rb, Gs, Gll^Fdf, Gs^Fds, Gs^Fds, Gs^Fds, Gs^Fds
Mm, Mm, Xue, Ur, Xue, Ur, Ur, Ur, Ur, Ur, Ur, Xue, Xue, Xue, Xue, Xue, Xue, Uue, Xue, Xue, Xue, Xue, Uh, Xue, Xue, Ce, Ur, Ur, Xue, Xue, Mm^Xm, Mm^Xm, Mm, Mm^Xm, Mm^Xm, Mm, Mm, Hh^Fds, Hhd^Fdf, Gg^Es, Rb, Gg^Es, Gll^Fdf, Gll^Fdf, Ce, Rb, Gg, Gs, Gg^Es, Gs^Fds, Gll, Gll
Mm, Mm, Hhd^Fdf, Ur, Xue, Re^Vct, Uue, Ur, Xue, Ur, Re^Vct, Ur, Ur, Ur, Ur, Uu^Uf, Uu^Uf, Xue, Uh, Uh, Ur, Ur, Uh, Xue, Xue, Xue, Ur, Ur, Xue, Mm^Xm, Mm^Xm, Mm, Mm, Mm^Xm, Mm^Xm, Mm, Mm, Mm, Hh^Fds, Gs^Fds, Gg, Rb, Rb, Ce, Gg^Efm, Rb, Gg, Gg^Efm, Gg, Gg^Es, Gg^Es, Gll
Hh^Fds, Hhd^Fdf, Rb, Rb, Hhd^Fdf, Xue, Xue, Xue, Uue, Ur, Ur, Ur, Ur, Ur, Ur, Ur, Ur, Uh, Ur, Ur, Ur, Ur, Ur, Uh, Uu^Uf, Xue, Ur, Ur, Xue, Mm^Xm, Mm, Mm, Mm, Mm, Mm, Mm, Mm, Mm, Hhd^Fdf, Gll^Fdf, Gs^Fds, Gg, Gs, Rb, Rb, Rb, Gg, Gg^Efm, Gg^Efm, Gg, Gg^Es, Gll^Fdf
Rb, Rb, Rb, Rb, Hh^Fds, Mm, Xue, Re^Vct, Uue, Ur, Ur, Ce, Xue, Ur, Xue, Ur, Ur, Ur, Ur, Ur, Re^Vct, Ur, Ur, Ur, Uu^Uf, Xue, Ur, Ur, Xue, Mm^Xm, Mm^Xm, Mm, Mm, Mm, Mm, Mm, Mm, Mm, Hhd^Fdf, Gs^Fds, Gll^Fdf, Gll^Fdf, Gs^Fds, Gg, Gg^Es, Rb^Es, Gg, Gg, Gs, Gs, Gs^Fds, Gll
Rb, Rb, Gll^Fdf, Hh^Fds, Mm, Mm, Xue, Uh, Uh, Ce, Rb, Rb, Gg, Xue, Mm, Xue, Xue, Ur, Ur, Ur, Ur, Ur, Uh, Uh, Uu^Uf, Xue, Ur, Ur, Xue, Mm^Xm, Xue, Mm^Xm, Mm^Xm, Mm^Xm, Mm^Xm, Mm, Mm, Hhd^Fdf, Gll^Fdf, Gs^Fds, Gs^Fds, Gll, Gs^Fds, Gll^Fdf, Gs, Rb^Es, Gg^Es, Gs, Gs^Fds, Gll^Fdf, Gll, Gll^Fdf
Gg, Gg, Hhd^Fdf, Hhd^Fdf, Mm, Mm, Xue, Uh, Xue, Xue, Hh^Fds, Rb, Rb, Hhd^Fdf, Hhd^Fdf, Mm, Xue, Re^Vct, Ur, Ur, Re^Vct, Ur, Xue, Uh, Xue, Xue, Ur, Ur, Ur, Xue, Uu^Uf, Xue, Xue, Xue, Xue, Mm, Mm, Hh^Fds, Hhd^Fdf, Gll^Fdf, Gs^Fds, Gll^Fdf, Gs^Fds, Gll, Gs, Rb, Gg^Es, Gs, Gll^Fdf, Gll^Fdf, Gs^Fds, Gll^Fdf
Gg, Gg, Hh^Fds, Mm, Mm, Mm, Xue, Xue, Mm, Hhd^Fdf, Hhd^Fdf, Gg, Rb, Hh^Fds, Hhd^Fdf, Mm, Xue, Ur, Ur, Ur, Xue, Xue, Re^Vct, Xue, Ur, Ur, Ur, Ur, Ur, Ur, Ur, Uu^Uf, Ur, Re^Vct, Ur, Xue, Mm, Hhd^Fdf, Hhd^Fdf, Gll^Fdf, Gs^Fds, Gll, Gs^Fds, Gll^Fdf, Gs, Rb^Es, Rb, Gs, Gs, Gll^Fdf, Gs^Fds, Gll
Gg, Gg, Gs^Fds, Hhd^Fdf, Mm, Mm^Xm, Mm^Xm, Mm^Xm, Mm, Hhd^Fdf, Gll^Fdf, Gg, Rb, Hh^Vhh, Mm, Mm, Xue, Ur, Ur, Xue, Mm^Xm, Xue, Uh, Ur, Uu^Uf, Ur, Xue, Xue, Xue, Ur, Ur, Ur, Ur, Ur, Ur, Xue, Mm, Hh^Fds, Hh^Fds, Gs^Fds, Gs^Fds, Gll, Gll^Fdf, Gs^Fds, Rb^Es, Rb^Es, Gg, Rb, Rb, Gll^Fdf, Gs^Fds, Gll^Fdf
Gg, Gg, Gs^Fds, Hh^Fds, Mm, Mm, Mm, Mm^Xm, Mm, Hh^Fds, Hhd^Fdf, Rb, Gg, Hh^Fds, Mm, Xue, Ce, Ur, Ur, Xue, Mm^Xm, Xue, Xue, Uh, Xue, Xue, Mm^Xm, Mm^Xm, Mm^Xm, Xue, Xue, Ur, Ur, Ur, Ur, Xue, Mm, Hhd^Fdf, Hhd^Fdf, Gs^Fds, Gs^Fds, Gll^Fdf, Gll^Fdf, Gll^Fdf, Rb, Gg, Hh^Fds, Gg, Rb, Gs^Fds, Gll^Fdf, Gll
Gg, Gg, Gg, Hhd^Fdf, Hhd^Fdf, Mm, Mm, Mm, Mm, Mm, Hhd^Fdf, Rb, Gg, Hhd^Fdf, Hh^Fds, Xue, Rb, Uue, Xue, Xue, Mm^Xm, Mm^Xm, Mm^Xm, Xue, Mm^Xm, Mm^Xm, Mm, Mm, Mm^Xm, Mm^Xm, Xue, Re^Vct, Ur, Ur, Ur, Xue, Xue, Mm, Hhd^Fdf, Gll^Fdf, Gs^Fds, Gll^Fdf, Gs, Gs, Rb, Gd^Fetd, Hh^Fds, Hh^Fds, Rb, Gg, Gs, Gs
Gg, Gg, Gs, Gll^Fdf, Hh^Fds, Mm, Mm, Mm, Mm, Mm, Hh^Fds, Rb, Rb, Gs^Fds, Gs^Fds, Rb, Gg^Es, Xue, Mm, Mm, Mm, Mm, Mm, Mm^Xm, Mm, Mm, Mm^Xm, Mm, Mm^Xm, Mm, Mm, Xue, Xue, Ur, Ur, Ce, Hhd^Fdf, Mm, Hh^Fds, Gll^Fdf, Gs^Fds, Gs^Fds, Gg, Gg, Rb, Gd^Xfw, Gd^Xfw, Hh^Fds, Gd^Xfw, Rb, Gg^Es, Gg
Gg, Gg, Gs, Gs^Fds, Hh^Fds, Hhd^Fdf, Hh^Fds, Mm, Mm, Mm, Hh^Fds, Gs^Fds, Gs, Rb, Rb, Rb, Gg, Hhd^Fdf, Hh^Fds, Mm, Mm, Mm, Mm, Mm, Mm^Xm, Mm^Xm, Mm, Mm^Xm, Mm^Xm, Mm, Mm, Mm, Xue, Ce, Ur, Rb, Gg, Hhd^Fdf, Gll^Fdf, Gs^Fds, Gg, Gg, Rb^Es, Rb^Es, Gg, Rb, Rb, Gd^Xfw, Gd^Es, Rb, Gg^Es, Gg
Gg, Gg, Gs, Gs^Fds, Gs^Fds, Hhd^Fdf, Hh^Fds, Hhd^Fdf, Hhd^Fdf, Hhd^Fdf, Gs^Fds, Gs^Fds, Gg, Rb, Gg, Gg, Gg, Gs^Fds, Gs^Fds, Hhd^Fdf, Hh^Fds, Mm, Hhd^Fdf, Mm, Mm, Mm, Mm, Mm, Mm, Mm, Mm, Mm, Mm, Xue, Hhd^Fdf, Rb, Rb, Gg, Gg^Es, Gg, Rb, Rb, Re^Vct, Gg, Gs^Fds, Gg, Gg, Rb, Rb, Rb, Rb, Rb
Rb, Gg, Gg, Gg, Gg^Efm, Gll^Fdf, Gs^Fds, Hh^Fds, Gll^Fdf, Gll^Fdf, Gs, Gs, Rb, Rb, Gg, Gg^Es, Gg^Es, Gs^Fds, Gll^Fdf, Gll^Fdf, Gs^Fds, Hhd^Fdf, Gll^Fdf, Hh^Fds, Hhd^Fdf, Mm, Hhd^Fdf, Mm, Mm, Mm, Hhd^Fdf, Mm, Hh^Fds, Mm, Hhd^Fdf, Ce, Gg, Rb, Rb, Rb^Es, Gd^Fetd, Gd^Xfw, Gs^Fds, Gll, Ce, Ce, Ce, Gg, Gd, Gd^Es, Gd, Gg
Gg, Rb, Rb, Gg, Gg^Efm, Gg^Efm, Gs, Gs^Fds, Gg^Es, Gg^Es, Rb, Rb, Gg, Gg, Gs, Gg, Gg^Es, Gs, Gs^Fds, Gll^Fdf, Gll^Fdf, Gs^Fds, Gs^Fds, Gs^Fds, Gll^Fdf, Hhd^Fdf, Gs^Fds, Hh^Fds, Hhd^Fdf, Hhd^Fdf, Gll^Fdf, Hhd^Fdf, Gs^Fds, Hhd^Fdf, Gs^Fds, Gs^Fds, Gg, Gg^Es, Gg, Gd^Fetd, Gd^Xfw, Gd^Xfw, Gll^Fdf, Gll^Fdf, Ce, 6 Ke, Ce, Gg, Gd^Fetd, Gd, Gd^Fetd, Gg
Gs, Gg, Gg, Rb, Rb, Gg, Gg, Gg, Rb, Rb, Gg, Gg, Gll^Fdf, Gs^Fds, Gs^Fds, Gs, Gg^Es, Gg, Gs, Gs^Fds, Gs^Fds, Gll^Fdf, Gll^Fdf, Gll^Fdf, Gll^Fdf, Gll^Fdf, Gs^Fds, Gs^Fds, Gs^Fds, Gll^Fdf, Gs^Fds, Gll^Fdf, Gs^Fds, Gll^Fdf, Gs^Fds, Gll, Gg, Gg, Gg, Gd^Fetd, Gll^Fdf, Gll^Fdf, Gd^Fetd, Gll, Gs^Fds, Ce, Gs^Fds, Gll, Re^Vct, Gd^Xfw, Gd, Gg
Gll^Fdf, Gs, Gd, Gd^Es, Gd, Rb, Rb, Rb, Gd, Gd, Gd^Fetd, Gll^Fdf, Hh^Fds, Hh^Fds, Gll^Fdf, Gs, Gg^Es, Gg^Es, Gg^Es, Gs, Gs, Gs, Gg, Gs^Fds, Gs^Fds, Gll^Fdf, Gd^Fetd, Gs^Fds, Gll^Fdf, Gs^Fds, Gs^Fds, Gs^Fds, Gll, Gll, Gg, Gg, Gg^Es, Gg, Gs, Gs^Fds, Gll^Fdf, Gd^Fetd, Gd^Xfw, Gll^Fdf, Gll^Fdf, Gll, Gs^Fds, Gd^Fetd, Gd^Xfw, Gd^Xfw, Gd, Gg
Gll^Fdf, Gll^Fdf, Gd^Fetd, Gd, Gd^Fetd, Re^Vct, Gg, Gg, Gd, Gd^Xfw, Gd^Xfw, Gd^Fetd, Hh^Fds, Hhd^Fdf, Gll, Gg, Gg, Gg^Es, Gg^Es, Gg^Es, Gg, Gg^Es, Gd, Gs, Gd, Gd^Fetd, Gd^Xfw, Gd^Fetd, Gd^Xfw, Gs^Fds, Gd^Fetd, Gll^Fdf, Gll^Fdf, Gll^Fdf, Gs, Gg, Gg, Gg^Es, Gg^Es, Gs^Fds, Gll, Gll^Fdf, Gs^Fds, Gd^Xfw, Re^Vct, Gll, Gll^Fdf, Gd^Xfw, Gd^Xfw, Gs^Fds, Gd, Gd
Gll^Fdf, Gd^Fetd, Gd^Xfw, Gd^Xfw, Gd^Fetd, Gs, Gs, Gg, Gd^Es, Gd, Gd^Xfw, Gd^Fetd, Hh^Fds, Hhd^Fdf, Gs^Fds, Gg, Gg, Gg, Gg, Gg, Gs, Gg, Gd, Gd, Gd^Es, Gd, Gd, Gd^Xfw, Gd, Gd, Gd^Xfw, Gll^Fdf, Gd^Fetd, Gs, Gg^Es, Gg, Gs, Gg, Gg^Es, Gg, Gg, Gs, Gd^Fetd, Gd^Xfw, Gg, Gll^Fdf, Gd^Es, Gd^Xfw, Gd, Gs^Fds, Gd, Gg
Gs^Fds, Gll, Gd^Xfw, Re^Vct, Gs^Fds, Gll^Fdf, Ce, Ce, Ce, Gd, Gd, Gd^Fetd, Gs^Fds, Gs^Fds, Gs^Fds, Gs^Fds, Gg, Gg^Es, Gg, Gs, Gs^Fds, Gs^Fds, Gd^Fetd, Gd^Xfw, Gd, Gd, Re^Vct, Gd, Gd^Es, Gd, Gd, Gd^Xfw, Gd, Gg, Gg^Es, Gg, Hh^Fds, Gs, Gg, Gg, Gg^Es, Gg, Gg, Gd^Fetd, Gg^Es, Gs, Gd, Gd, Gd, Gd^Es, Gg, Gg
Gll, Gd^Fetd, Gd^Fetd, Gs^Fds, Gll^Fdf, Gll, Ce, 5 Ke, Ce, Gg, Re^Vct, Gll^Fdf, Gs, Gll^Fdf, Gll^Fdf, Gg, Gg, Gg^Es, Gg, Gs, Gll^Fdf, Gll, Gd^Fetd, Gd^Xfw, Gd, Gd, Gd, Gd, Gg, Gd, Re^Vct, Gd, Gd, Gd, Hhd^Fdf, Hh^Fds, Hhd^Fdf, Hh^Fds, Gg, Gg, Gg, Gg, Gg, Gg, Gg, Gg^Es, Gg^Es, Gg^Es, Gg, Gg, Gg, Gg
Hhd^Fdf, Gs^Fds, Hhd^Fdf, Gll^Fdf, Hhd^Fdf, Gll^Fdf, Gs^Fds, Ce, Gd, Gd, Gd, Gg, Gg, Gs, Gs, Gg, Gg, Gg^Es, Gg, Gll^Fdf, Gll, Gll, Gll^Fdf, Gd^Fetd, Gd, Gd^Es, Ce, Ce, Ce, Gg, Gg, Gd, Gs, Gs, Hhd^Fdf, Hh^Fds, Hh^Fds, Gg, Gg, Gg, Gg^Es, Gg, Gs, Gg, Gs, Gg, Gs, Gg, Gs, Gg, Gg, Gs
Hhd^Fdf, Hh^Fds, Hhd^Fdf, Hhd^Fdf, Hhd^Fdf, Hh^Fds, Gll^Fdf, Gs^Fds, Gd, Gd^Xfw, Gd, Gd, Gg, Gg, Gg^Es, Gg^Es, Gg, Gg^Es, Gg, Gg, Gg, Gll^Fdf, Gs, Gs^Fds, Gs, Gd, Ce, 2 Ke, Ce, Gg^Es, Gg, Gg, Hh^Fds, Hhd^Fdf, Hhd^Fdf, Hhd^Fdf, Hh^Fds, Gs, Gg, Gg^Es, Gg^Es, Gg, Gll^Fdf, Gs, Gs^Fds, Gs^Fds, Gll^Fdf, Gs, Gs^Fds, Gll^Fdf, Gg, Gs^Fds
Hh^Fds, Hh^Fds, Hhd^Fdf, Hh^Fds, Hhd^Fdf, Hh^Fds, Gll, Gd^Fetd, Gd^Xfw, Gd^Xfw, Gd^Es, Gd, Gg^Efm, Gg, Gg^Es, Gg, Gg, Gg, Gg, Gg, Gg, Gg, Gg, Gd^Fetd, Gd^Xfw, Gd, Gd, Ce, Gd, Gd, Gd, Hh^Fds, Hh^Fds, Hhd^Fdf, Hhd^Fdf, Hh^Fds, Gs, Gs, Gg^Es, Gg^Es, Gg, Gll^Fdf, Gll^Fdf, Gll^Fdf, Gll, Gll^Fdf, Gs^Fds, Gll^Fdf, Gs^Fds, Gll^Fdf, Gs^Fds, Gg
Hh^Fds, Hh^Fds, Hhd^Fdf, Hhd^Fdf, Hhd^Fdf, Hh^Fds, Gs^Fds, Gd^Fetd, Gd^Fetd, Gd, Gd, Gd, Gg, Gg, Gg, Gg, Gg, Gg, Gg^Efm, Gg, Gg^Efm, Gg^Efm, Gg^Efm, Re^Vct, Gd, Gd^Xfw, Gd^Xfw, Gd^Xfw, Gd^Xfw, Gd^Xfw, Re^Vct, Gs, Gs, Hhd^Fdf, Hhd^Fdf, Gs, Gg, Gg^Es, Gg^Es, Gg, Gs, Gs, Gll^Fdf, Gs^Fds, Gll^Fdf, Gll^Fdf, Gll^Fdf, Gs^Fds, Gll, Gll, Gs^Fds, Gg
Hh^Fds, Hh^Fds, Hhd^Fdf, Hh^Fds, Hh^Fds, Hh^Fds, Gll^Fdf, Gll, Gll^Fdf, Gll^Fdf, Gg, Gg, Gg, Gg, Gg, Gg, Gg, Gg, Gg, Gg^Efm, Gg, Gg, Gg, Gg, Gd, Gd, Gg, Gg, Gg, Gd, Gg, Gg, Gg, Gg, Gg, Gg, Gg, Gg, Gg, Gg, Gg, Gs^Fds, Gs^Fds, Gll^Fdf, Gll^Fdf, Gs^Fds, Gll^Fdf, Gs^Fds, Gs^Fds, Gs^Fds, Gs^Fds, Gg
