border_size=1
usage=map

Rb, Gg, Gg, Gg, Gg, Gg, Gg, Gs^Fds, Gll^Fdf, Gll, Gs^Fds, Gg, Gll^Fdf, Gs^Fds, Gll^Fdf, Gg, Gg, Gg, Gg, Gg, Gg, Gg^Es, Gg, Gg, Gg, Gg, Gg, Gg, Gg, Gg, Gg, Gg, Gg, Gg, Gs^Fds, Gg, Gg, Gg, Gg, Gg^Es, Gg, Gg, Gs^Fds, Gs^Fds, Hh^Fds, Hh^Fds, Hhd^Fdf, Hh^Fds, Hh^Fds, Gs^Fds, Gg, Gg, Gs, Gd, Ds, Ds, Wwt, Wwt, Wwt, Wwt, Wwt, Wwt, Wwt, Wwt, Wwt, Wwt, Wwt, Wot, Wot, Wot, Wwrt, Wot, Wot, Wot, Wot
Gg, Rb, Rb, Gg, Gg, Gg^Efm, Gg, Gs^Fds, Gll^Fdf, Gs^Fds, Gs^Fds, Gs^Fds, Gs^Fds, Gll^Fdf, Gll^Fdf, Gs^Fds, Gg, Gg, Gg^Es, Gg, Gg, Gg^Es, Gg^Es, Gg, Gg, Gg, Gs^Fds, Gg, Gg, Gg, Gg, Gg, Gs^Fds, Gs^Fds, Hhd^Fdf, Gs^Fds, Gs^Fds, Gg, Gg, Gg, Gg, Gg, Gll, Hh^Fds, Hh^Fds, Hhd^Fdf, Hhd^Fdf, Hh^Fds, Hh^Fds, Gs^Fds, Gg, Gg^Es, Gs, Gd, Ds, Ds, Wwt, Wwt, Wwt, Wwt, Wwt, Wwt, Wwt, Wwt, Wwt, Wwt, Wwt, Wot, Wot, Wot, Wwrt, Wot, Wot, Wot, Wot
Gg, Gg, Gg, Rb, Rb, Gg, Gg^Efm, Gs^Fds, Gll, Mm, Gll^Fdf, Gll^Fdf, Gll^Fdf, Gs^Fds, Gll, Gs^Fds, Gg, Gg^Es, Gg, Gg, Gg, Gg, Gg, Gg, Gg, Gg, Gll^Fdf, Gs^Fds, Gg, Gg, Gs^Fds, Gs^Fds, Hh^Fds, Hhd^Fdf, Hh^Fds, Hhd^Fdf, Hh^Fds, Gs^Fds, Gll^Fdf, Gg, Gg^Es, Gg, Gg, Gs^Fds, Gll^Fdf, Hhd^Fdf, Gll^Fdf, Hhd^Fdf, Hhd^Fdf, Gll^Fdf, Gg, Gg, Gs, Gd, Ds, Ds, Ds, Wwt, Wwt, Wwt, Wwt, Wwt, Wwt, Wwt, Wwt, Wwt, Wwt, Wot, Wot, Wot, Wot, Wwrt, Wot, Wot, Wot
Gg, Gg^Es, Gg^Es, Gg, Rb, Gg, Gg^Efm, Gg, Gg^Efm, Gll^Fdf, Gs^Fds, Gll^Fdf, Gll^Fdf, Gll^Fdf, Gs^Fds, Gs^Fds, Gg, Gg^Es, Gg, Gg, Gll^Fdf, Gg, Gg, Gg, Gg, Gg, Gll^Fdf, Gs^Fds, Gg, Gg, Gs^Fds, Hh^Fds, Hh^Fds, Hh^Fds, Hhd^Fdf, Hhd^Fdf, Hh^Fds, Hhd^Fdf, Gll^Fdf, Gg, Gg, Gg^Es, Gg, Gg, Gg, Gll^Fdf, Gll, Gll^Fdf, Gll^Fdf, Gll^Fdf, Gg, Gg^Es, Gs, Gd, Gd, Ds, Ds, Ds, Wwt, Wwt, Wwt, Wwt, Wwt, Wwt, Wwt, Wwt, Wwt, Wot, Wot, Wot, Wwrt, Wot, Wot, Wot, Wot
Gg, Gg^Efm, Gg^Efm, Gg, Gg, Rb, Gg, Gg^Efm, Gg, Gg, Gs^Fds, Gs^Fds, Gs^Fds, Gll^Fdf, Gll^Fdf, Gll, Gg, Gg^Es, Gll, Gs^Fds, Gll^Fdf, Gg, Gg, Gg, Gg, Gg, Gg, Gg, Gg, Gs^Fds, Hh^Fds, Hh^Fds, Hhd^Fdf, Hhd^Fdf, Gll^Fdf, Hh^Fds, Hhd^Fdf, Hhd^Fdf, Gll^Fdf, Gg, Gs^Vc, Gg^Es, Gg, Gg, Gg^Es, Gg, Gg, Gll, Gg, Gg, Gg, Gg, Gs^Es, Gs, Gs, Gd, Ds, Ds, Ds, Wwt, Wwt, Wwt, Wwt, Wwt, Wwt, Wwt, Wwt, Wot, Wot, Wot, Wwrt, Wot, Wot, Wot, Wot
Gs^Fds, Gg, Gg, Gg^Efm, Gg, Rb, Rb, Gg, Gg, Gg, Gg, Gs^Fds, Gs^Fds, Gll, Gg, Gg, Gg, Gg, Gll, Gs^Fds, Gll^Fdf, Gg, Gg^Efm, Gg, Gg, Gg^Efm, Gg, Gg, Gs^Vc, Gll^Fdf, Hhd^Fdf, Hhd^Fdf, Hh^Fds, Hhd^Fdf, Gll^Fdf, Gs^Fds, Gll^Fdf, Hhd^Fdf, Gll^Fdf, Gg, Gs, Gg, Gs, Gs, Gs, Gg, Gs, Gs, Gs, Gg, Gs, Gs, Gs, Gs, Gd, Gd, Ds, Ds, Wwt, Wwt, Wwt, Wwt, Wwt, Wwt, Wwt, Wwt, Wot, Wot, Wwrt, Wwrt, Wot, Wot, Wot, Wot, Wot
Gll^Fdf, Gs^Fds, Gs^Fds, Gg, Gg, Gg^Es, Rb, Gg, Gg^Es, Gg^Es, Gg^Es, Gg, Gg, Gg, Gg, Gg, Gg, Gg, Gll^Fdf, Gs^Fds, Gg, Gg, Gg^Efm, Gg, Gg, Gg^Efm, Gg, Gg, Gs^Fds, Gll^Fdf, Hh^Fds, Hhd^Fdf, Hh^Fds, Hhd^Fdf, Gll^Fdf, Gll, Gg, Gll^Fdf, Gs, Gs, Gs, Gs, Gd, Gs, Gd, Gs, Gd, Gs, Gs, Gs^Es, Gd, Gd, Gd, Gd, Ds, Gd, Ds, Ds, Wwt, Wwt, Wwt, Wwt, Wwt, Wwt, Wwt, Wwt, Wot, Wot, Wwrt, Wot, Wot, Wot, Wot, Wot, Wot
Gll^Fdf, Gs^Fds, Gll^Fdf, Gs^Fds, Gg, Gg, Gg, Rb^Es, Rb, Gg, Gg, Gg, Gg^Efm, Gg, Gg, Gg, Gg, Gg, Gg, Gg, Gg, Gg^Efm, Gg, Gg, Gg, Gg^Efm, Gg^Efm, Gs^Fds, Hh^Fds, Hh^Fds, Hh^Fds, Hhd^Fdf, Hh^Fds, Gs^Fds, Gll, Gll, Gg, Gg, Gs, Gs, Gd, Gd, Ds, Gd, Ds, Gd, Gd, Gd, Gd, Gd, Ds, Ds, Ds, Ds, Wwt, Ds, Wwt, Wwt, Wwt, Wwt, Wwt, Wwt, Wwt, Wwt, Wwt, Wwt, Wot, Wot, Wwrt, Wot, Wot, Wot, Wot, Wot, Wot
Gll^Fdf, Gll^Fdf, Gll^Fdf, Gs^Fds, Gs^Fds, Gg, Gg^Efm, Gg, Gg, Rb, Gg, Gg^Efm, Gg^Efm, Gg, Gg, Gg, Gs^Fds, Gll, Gll^Fdf, Gg, Gg, Gg^Efm, Gg^Efm, Gg, Gg, Gg^Efm, Gg, Gll^Fdf, Hhd^Fdf, Hhd^Fdf, Gll^Fdf, Hhd^Fdf, Gll^Fdf, Gs^Fds, Gg, Gg^Es, Gg, Gs, Gd, Gd, Ds, Gd, Ds, Ds, Wwf, Ds, Ds, Gd, Ds, Gd, Ds, Wwt, Wwt, Wwt, Wwt, Wwt, Wwt, Wwt, Wwt, Wwt, Wwt, Wwt, Wwt, Wwt, Wwt, Wot, Wot, Wot, Wot, Wwrt, Wwrt, Wot, Wot, Wot, Wot
Gll^Fdf, Gs^Fds, Gll^Fdf, Gll^Fdf, Gll^Fdf, Gg, Gg^Efm, Gg, Gg, Rb, Gg, Gg, Gg, Gg^Efm, Gll^Fdf, Gs^Fds, Hh^Fds, Gll^Fdf, Hhd^Fdf, Gll^Fdf, Gg, Gg, Gg^Efm, Gg, Gg, Gg^Efm, Gg, Gll^Fdf, Gll^Fdf, Hh^Fds, Gs^Fds, Gll^Fdf, Gg, Gg, Gg, Gg, Gs, Gs, Gd, Ds, Ds, Ds, Wwf, Wwf, Wwt, Ds, Ds, Ds, Wwf, Ds, Wwt, Wwt, Wwt, Wwt, Wwt, Wwt, Wwt, Wwt, Wwt, Wwt, Wwt, Wwt, Wwt, Wwt, Wot, Wot, Wot, Wot, Wot, Wot, Wot, Wot, Wot, Wot, Wot
Gs^Fds, Gll^Fdf, Gll^Fdf, Gs^Fds, Gll^Fdf, Gg, Gg^Efm, Gg, Gg, Rb, Gg, Gg, Gg, Gg, Gll^Fdf, Hhd^Fdf, Hhd^Fdf, Hhd^Fdf, Hhd^Fdf, Gll^Fdf, Gg, Gg, Gs^Vc, Gg, Gg, Gg, Gg, Gg, Gg, Gs^Fds, Gg, Gg, Gg, Gg^Es, Gs, Gs, Gd, Gd, Ds, Ds, Wwt, Wwt, Wwf, Wwf, Wwt, Wwt, Wwf, Wwf, Wwf, Wwt, Wwt, Wwt, Wwt, Wwt, Ds, Wwt, Ds, Ds, Ds, Wwt, Ds, Wwt, Wwt, Wot, Wot, Wot, Wot, Wot, Wwrt, Wwrt, Wot, Wot, Wot, Wot, Wot
Gll, Gll^Fdf, Gll^Fdf, Gll, Gll^Fdf, Gg, Re^Vct, Gg^Efm, Gg, Rb, Gg, Gg, Gg, Gll^Fdf, Hhd^Fdf, Hhd^Fdf, Hh^Fds, Hh^Fds, Hhd^Fdf, Gll^Fdf, Gg, Gg, Gg, Gg, Gg, Gg, Gg, Gg, Gg, Gg, Gg, Gg, Gg, Gs, Gd, Gd, Gd, Ds, Ds, Wwt, Wwt, Wwt, Ds, Ds, Ds, Wwt, Wwt, Wwf, Ds, Wwt, Ds, Wwt, Ds, Ds, Gd, Ds, Gd, Ds, Gd, Ds, Ds, Wwt, Wwt, Wwt, Wwt, Wot, Wot, Wot, Wwrt, Wot, Wot, Wot, Wot, Wot, Wot
Gs^Fds, Gs^Fds, Gs^Fds, Gll^Fdf, Gs^Fds, Gg, Gg, Gg, Gg, Rb, Gg, Gg, Gg, Gll^Fdf, Gs^Fds, Gs^Fds, Hhd^Fdf, Hhd^Fdf, Hh^Fds, Gs^Fds, Gg, Gg, Gg, Gg, Gg^Es, Gg^Es, Gg, Gg, Gs^Vc, Gg, Gll^Fdf, Gg, Gs, Gd^Fetd, Gd^Fetd, Ds, Ds, Ds, Wwt, Wwt, Wwt, Ds, Ds, Re^Vct, Gd, Ds, Ds, Wwt, Ds, Ds, Gd, Ds, Gd, Gd, Gd, Gd, Re^Vct, Gd, Gd, Ds, Ds, Wwt, Wwt, Wwt, Wwt, Wot, Wot, Wwrt, Wot, Wot, Wot, Wot, Wot, Wot, Wot
Gg, Gll, Gg, Gll, Gg, Gg, Ce, Gg, Gg, Rb, Gg, Gg, Gg^Es, Gg, Gs^Fds, Gs^Fds, Hh^Fds, Hhd^Fdf, Hhd^Fdf, Gll^Fdf, Gg, Gg, Gg^Es, Gg^Es, Gg, Gg, Gg, Gg, Gg, Gg^Es, Gg, Gg, Gs, Gd^Fetd, Gd^Fetd, Ds, Wwt, Wwt, Wwt, Wwt, Ds, Ds, Gd, Gd, Gd^Es, Gd, Gd, Ds, Gd, Gd, Ce, Gd, Gd, Gs, Ce, Gs, Gd, Gd, Ds, Ds, Ds, Wwt, Wwt, Wwt, Wwt, Wot, Wot, Wot, Wot, Wwrt, Wwrt, Wot, Wot, Wot, Wot
Gg, Re^Vct, Gg^Es, Gg, Gg, Ce, 1 Ke, Ce, Rb, Rb, Gg, Re^Vct, Gg, Gg, Gll^Fdf, Hh^Fds, Hh^Fds, Hhd^Fdf, Hh^Fds, Gs^Fds, Gg, Gg, Gg^Es, Gg, Gg, Gg, Gg, Gg^Es, Gg, Gll^Fdf, Gd^Fetd, Gg, Gs, Gd, Ds, Ds, Wwt, Wwt, Wwt, Ds, Gd, Gd, Gd, Gd^Es, Gs, Gd, Gd, Gd, Gs, Ce, Gs, Gs, Ce, Gs, Gs, Ce, Gd, Ds, Ds, Ds, Wwt, Wwt, Wwt, Wwt, Wot, Wot, Wot, Wot, Wot, Wot, Wot, Wwrt, Wot, Wot, Wot
Rb, Gg, Rb, Gg, Gg, Ce, Ce, Ce, Gg, Gg, Gg, Gg, Gg, Gg, Gll^Fdf, Hhd^Fdf, Hhd^Fdf, Hhd^Fdf, Gll^Fdf, Gs^Fds, Gg, Gg, Gg^Es, Gll^Fdf, Gll^Fmf, Gg, Gg^Es, Gg, Gg, Gll^Fmf, Gs, Gs, Gd, Gd, Ds, Wwt, Wwt, Wwt, Ds, Ds, Gd, Gd, Gd, Gs, Gs, Re^Vct, Gs, Gs, Gs, Ce, Gs, Ce, 3 Ke, Ce, Gs, Ce, Gd, Ds, Ds, Wwt, Wwt, Wwt, Wwt, Wot, Wot, Wot, Wot, Wot, Wot, Wot, Wot, Wwrt, Wwrt, Wot, Wot
Gg, Rb^Es, Gg, Rb, Rb, Rb, Gg, Gg, Gg, Gg, Gll^Fdf, Gg^Es, Gg, Gg, Gg, Gll^Fdf, Gll^Fdf, Gll^Fdf, Gg, Gg, Gg, Gg, Gg, Gll^Fdf, Gg, Gg, Gg, Gg, Gg, Gs, Gd, Gd^Fetd, Ds, Ds, Wwf, Wwf, Wwf, Wwt, Ds, Gd, Ce, Gd, Ce, Gs, Gg, Gs, Gs, Gs^Es, Gg, Gs, Gg, Ce, Ce, Ce, Gs, Gs, Gd, Ds, Ds, Ds, Ds, Wwt, Wwt, Wwt, Wot, Wot, Wot, Wot, Wot, Wot, Wot, Wwrt, Wot, Wot, Wot
Gg^Efm, Gg^Efm, Gg^Efm, Gg, Gg, Gg, Gll^Fdf, Gs^Fds, Gs^Fds, Gll^Fdf, Hhd^Fdf, Gll^Fdf, Gg, Gg, Gg, Gg, Gg, Gg, Gg, Gg, Gs, Gg, Gs, Gg^Es, Gg, Gg, Gll^Fdf, Gll^Fdf, Gs, Gs, Gd^Fetd, Ds, Ds, Wwt, Wwt, Wwf, Wwf, Wwf, Ds, Ke, Gd, Ce, Gs, Ce, Ce, Gg, Gg^Es, Gg^Es, Gg, Ce, Gs, Gs, Gs, Gs, Gs, Ce, Gs, Gd, Gd, Ds, Ds, Wwt, Wwt, Wwt, Wwt, Wot, Wot, Wot, Wwrt, Wot, Wwrt, Wwrt, Wot, Wot, Wot
Gg^Efm, Gg, Gg, Gg, Gs^Fds, Gll^Fdf, Hhd^Fdf, Hh^Fds, Hh^Fds, Hh^Fds, Hhd^Fdf, Gll^Fdf, Gg, Gg, Gg^Es, Gg^Es, Gg^Es, Gg, Gg, Gg, Gs, Gs, Gs, Gs, Gs, Gll^Fmf, Gll^Fdf, Gd^Fetd, Gs, Gs, Gd^Fetd, Ds, Wwt, Wwt, Wwt, Wwt, Ke, Ds, Gd, Gd, Re^Vct, Gs, Gs, Gs, Ce, Gg, Ce, Gg, Gg, Ce, Ce, Gs^Es, Gd, Gs, Ce, Ce, Gs, Gs, Re^Vct, Gd, Ds, Ds, Wwt, Wwt, Wwt, Wot, Wot, Wwrt, Wwrt, Wot, Wot, Wot, Wot, Wot, Wot
Gg^Efm, Gg, Gg, Gs^Fds, Hh^Fds, Hh^Fds, Hh^Fds, Hhd^Fdf, Hhd^Fdf, Hh^Fds, Hhd^Fdf, Hh^Fds, Gs^Fds, Gs, Gg, Gg^Es, Gg, Gg, Gg, Gs, Gd^Fetd, Gd, Gs^Vc, Gd, Gd, Gd^Fetd, Gd, Gd, Gd, Gd^Fetd, Ds, Ds, Wwt, Wwt, Wwt, Ce, Gd, Gd, Gd, Gd, Gs, Gs, Gg, Gs, Gs, Ce, Gs, Ce, Gs, Gs, Gd, Gd^Es, Gd, Gd, Gd, Gd, Gs, Gs, Gd, Gd, Ds, Ds, Wwt, Wwt, Wwt, Wwt, Wot, Wot, Wot, Wot, Wot, Wot, Wot, Wot, Wot
Gg, Gg, Gs^Fds, Gs^Fds, Hhd^Fdf, Hh^Fds, Hh^Fds, Hhd^Fdf, Hhd^Fdf, Hh^Fds, Hhd^Fdf, Hh^Fds, Gs^Fds, Gg, Gg^Es, Gg, Gg, Gg, Gll^Fmf, Gd^Fetd, Ss, Ds, Ds, Ds, Ds, Gd^Fetd, Ds, Ds, Ds, Ds, Wwt, Wwt, Wwt, Wwt, Ce, Ce, Gd, Gd, Ce, Ce, Ce, Ce, Ce, Gg^Es, Gs, Gs, Gs, Ke, Gs, Gd, Gd, Gd^Es, Gd^Xfw, Gd^Xfw, Gd^Xfw, Gd, Gd, Gd, Ds, Ds, Ds, Ds, Wwt, Wwt, Wwt, Wwt, Wot, Wot, Wot, Wwrt, Wwrt, Wot, Wot, Wot, Wot
Gs^Fds, Gs^Fds, Hh^Fds, Hh^Fds, Hhd^Fdf, Hh^Fds, Gs^Fds, Hh^Fds, Hhd^Fdf, Hhd^Fdf, Gll^Fdf, Hh^Fds, Gs^Fds, Gg, Gg, Gg, Ss, Ss, Ss, Ss, Wwt, Wwt, Wwt, Wwf, Wwf, Ds, Wwt, Wwt, Wwt, Ds, Wwf, Wwt, Wwt, Wwt, Ce, Gd, Gd, Gd, Ce, Re^Vct, Ce, Re^Vct, Ce, Gg, Gg, Gg^Es, Gs, Gs, Gs, Gd, Gd^Xfw, Gd^Xfw, Gd^Kov, Gd^Kov, Gd^Kov, Gd^Xfw, Gd^Xfw, Gd, Ds, Ds, Wwt, Wwt, Wwt, Wwt, Wwt, Wot, Wot, Wot, Wot, Wot, Wot, Wot, Wwrt, Wot, Wot
Gs^Fds, Hh^Fds, Hh^Fds, Hhd^Fdf, Hhd^Fdf, Hh^Fds, Gs^Fds, Gll^Fdf, Gll^Fdf, Gll^Fdf, Gll, Gs^Fds, Ss, Gg, Ss, Ss, Ss, Ss, Ss^Vhs, Ss, Wwt, Wwt, Wwt, Wwf, Wwf, Wwt, Wwt, Wwt, Wwt, Wwt, Wwt, Wwf, Ce, Ce, Gd, Gd, Gs, Ce, Re^Vct, Ce, 2 Ke, Ce, Re^Vct, Ce, Gg, Gg, Gs, Gs, Gd, Gd, Gd^Xfw, Gd^Kov, Gd^Kov, Gs^Kov, Gs^Kov, Gd^Kov, Gd^Xfw, Gd, Ds, Ds, Ds, Wwt, Wwt, Wwt, Wwt, Wot, Wot, Wot, Wot, Wot, Wot, Wot, Wot, Wwrt, Wot
Hh^Fds, Hh^Fds, Hh^Fds, Hhd^Fdf, Hh^Fds, Gll^Fdf, Gg, Gg, Gg, Gll, Ss, Ss, Wwt, Ss, Wwt, Wwt, Wwt, Ss, Wwt, Wwt, Wwt, Wwt, Wwt, Wwf, Ds, Wwt, Wwt, Wwt, Wwt, Wwt, Wwt, Wwt, Ce, Gd, Gd, Gd^Es, Gd^Es, Ce, Ce, Ce, Ce, Ce, Ce, Ce, Gg, Re^Vct, Gs, Ce, Gd, Gd, Gd^Xfw, Gd^Kov, Gd^Kov, Gs^Kov, Gs^Kov, Gd^Kov, Gd^Xfw, Gd, Gd, Ds, Ds, Wwt, Wwt, Wwt, Wwt, Wot, Wot, Wot, Wwrt, Wot, Wot, Wot, Wwrt, Wwrt, Wot
Hhd^Fdf, Hhd^Fdf, Hhd^Fdf, Hhd^Fdf, Gll^Fdf, Gs^Fds, Gg, Gg, Ss, Ss, Wwt, Wwt, Wwt, Wwt, Wwt, Wwt, Wwt, Wwt, Wwt, Wwt, Wwt, Wwt, Ds, Ds, Ds, Ds, Ds, Wwt, Ds, Wwt, Wwf, Wwf, Wwt, Ce, Ce, Gd, Gd, Gd, Ce, Re^Vct, Ce, Re^Vct, Ce, Gg, Gg^Es, Gg^Es, Gs, Ce, Gd, Gd, Gd^Xfw, Gd^Kov, Gd^Kov, Gs^Kov, Gd^Kov, Gd^Kov, Gd^Xfw, Gs, Gd, Ds, Ds, Ds, Wwt, Wwt, Wwt, Wot, Wot, Wwrt, Wot, Wot, Wot, Wwrt, Wot, Wot, Wot
Gll^Fdf, Hh^Fds, Gll^Fdf, Hh^Fds, Gs^Fds, Gg, Gg, Ss, Ss, Wwt, Wwt, Wwt, Wwt, Wwt, Ss, Wwt, Wwt, Wwt, Ss, Wwt, Wwt, Ds, Gd, Gd, Gd, Gd, Gd, Ds, Gd, Ds, Ds, Wwt, Wwt, Wwt, Wwt, Ce, Ce, Gd, Gd, Ce, Gs, Ce, Gg, Gg^Es, Gg, Gg, Gs, Gs, Gs, Gd, Gd, Gd^Xfw, Gd^Xfw, Gd^Kov, Gd^Xfw, Gd^Xfw, Gd, Gs, Gd, Ds, Ds, Wwt, Wwt, Wwt, Wwt, Wot, Wot, Wwrt, Wot, Wot, Wwrt, Wwrt, Wot, Wot, Wot
Gg, Gs^Fds, Gll, Gs^Fds, Gg, Gg, Gg, Ss, Wwt, Wwt, Wwt, Wwt, Ds, Ds, Ss, Ss, Ss, Wwt, Ss, Ss, Ss, Ds, Gd, Gs^Vc, Gs, Gs^Es, Gd^Fetd, Gd, Gd^Fetd, Gd, Gd, Ds, Ds, Wwt, Wwt, Wwt, Ce, Gd, Gd, Gd, Gs, Gs, Gg, Gg^Es, Re^Vct, Gs, Gs, Gg, Gs, Gs, Gd, Gd, Gd, Gd, Gd, Gd, Gd, Gs, Gd, Ds, Ds, Wwt, Wwt, Wwt, Wwt, Wot, Wot, Wot, Wwrt, Wot, Wot, Wot, Wot, Wot, Wot
Ss, Ss, Ss, Gg, Ss, Ss, Ss, Ss, Wwt, Wwt, Wwt, Ds, Ds, Ss, Wwt, Wwt, Wwt, Ss, Ss, Ss, Ss, Ds, Ds, Gd, Gs, Gd^Fetd, Gd^Fetd, Gd^Fetd, Gd^Fetd, Gs, Gs^Es, Gd, Ds, Wwt, Wwt, Wwt, Ce, Ds, Gd, Gd, Gd, Re^Vct, Gs, Gs, Gs, Gs, Gs, Ke, Gg, Gs^Es, Gs, Gd, Gd, Gd, Gd, Gd, Gs, Gs, Gs, Gd, Ds, Ds, Wwt, Wwt, Wwt, Wwt, Wot, Wot, Wot, Wot, Wwrt, Wot, Wot, Wot, Wot
Ss, Ss, Wwt, Ss, Ss, Ss, Wwt, Wwt, Wwt, Wwt, Wwt, Wwt, Ss, Wwt, Ss, Ss^Vhs, Ds, Ds, Wwf, Ss, Ds, Ds, Gd, Gd, Gd^Es, Gd^Fetd, Gd^Fetd, Gd^Fetd, Gd^Fetd, Gd^Fetd, Gs, Gd, Gd, Ds, Wwf, Wwf, Wwt, Ke, Ds, Gd, Gd, Gs, Gs, Gs, Gs, Gs, Gs, Ce, Gg, Gg, Gg^Es, Gs, Gs, Gs, Gs, Gs, Gs^Es, Gs, Gd, Gd, Ds, Ds, Wwt, Wwt, Wwt, Wwt, Wot, Wot, Wot, Wot, Wot, Wot, Wwrt, Wot, Wot
Ss, Wwt, Wwt, Wwt, Wwt, Wwt, Wwt, Wwt, Wwt, Wwt, Ss, Ss, Ss, Ss, Wwt, Ds, Ss, Ss, Ss, Ss, Wwt, Ds, Gd, Gd, Gd, Gs, Gd^Fetd, Gd^Fetd, Gd^Fetd, Gd^Fetd, Gs, Gs, Gd, Ds, Ds, Wwt, Wwt, Wwt, Wwt, Ds, Ke, Gd, Gd, Gs, Ce, Ce, Ce, Ce, Gg, Gg, Gg, Gg^Es, Gg, Gg, Gg, Gs, Gs^Es, Gs, Gd, Gd, Ds, Wwt, Wwt, Wwt, Wwt, Wot, Wot, Wot, Wot, Wot, Wot, Wot, Wot, Wwrt, Wwrt
Wwt, Wwt, Wwt, Wwt, Wwt, Wwt, Wwt, Wwt, Ss, Wwt, Ss, Wwt, Ss, Ss, Wwt, Wwt, Ss, Ss, Ds, Wwt, Wwt, Ds, Ds, Gd, Gd, Gd^Es, Gs^Es, Gd^Fetd, Gd^Fetd, Gd^Fetd, Gs, Gs^Es, Gs, Gd, Ds, Wwt, Wwt, Wwt, Wwt, Ds, Ds, Ce, Ce, Ce, Gd, Gs, Gs, Gg, Gs, Gg, Gg, Gg, Re^Vct, Gg, Gs, Gs, Gs, Gd, Gd, Gd, Ds, Ds, Wwt, Wwt, Wwt, Wot, Wot, Wot, Wwrt, Wot, Wot, Wot, Wot, Wot, Wwrt
Wwt, Wwt, Ss, Wwt, Ss, Wwt, Ss, Ss, Ss, Ss, Ss, Wwt, Ss, Ss, Wwt, Wwt, Ds, Ss, Ss, Ds, Ds, Ss, Ds, Ds, Ds, Gd, Gd, Gs, Gs, Gs, Gd^Fetd, Gs, Gs^Es, Gd, Gd, Ds, Ds, Wwt, Wwt, Wwf, Wwf, Ds, Ds, Gd, Gd, Gs, Gd, Gs, Re^Vct, Gs, Gg, Gg, Gg, Gg, Gs, Gs^Es, Gd, Gd, Ds, Gd, Ds, Wwt, Wwt, Wwt, Wwt, Wot, Wot, Wot, Wwrt, Wwrt, Wot, Wot, Wwrt, Wwrt, Wot
Wwt, Wwt, Ss, Ss, Ss, Ss, Ss, Ss, Gs, Ss, Ds, Ss, Ss, Wwt, Wwt, Ss, Ss, Ds, Wwf, Ss, Ss, Wwt, Ds, Ds, Ds, Gd, Ds, Gd, Gd, Gs, Gd^Fetd, Gd^Fetd, Gs, Gs, Gs^Es, Gd, Ds, Wwt, Ds, Wwf, Wwt, Wwt, Ds, Ds, Gd, Gd, Gd, Gs, Gs, Gs, Gs, Gg, Gs, Gs, Gs, Gs, Gd, Ds, Ds, Ds, Wwt, Wwt, Wwt, Wwt, Wot, Wot, Wot, Wot, Wot, Wot, Wot, Wot, Wwrt, Wot, Wot
Ss, Ss, Ss, Ss, Gs, Gs, Gs, Gs, Gs, Ss, Gs, Ds, Wwt, Ds, Ds, Wwt, Wwf, Ds, Wwf, Ss, Wwt, Ss, Ds, Wwf, Wwf, Ds, Ds, Ds, Gd, Gd^Fetd, Gd^Fetd, Gs, Gd^Fetd, Gs, Gs, Gd^Es, Gd, Ds, Ds, Ds, Wwt, Wwt, Wwt, Ds, Ds, Ds, Gd, Gd, Gd, Gs, Gs^Es, Gs, Gs, Gs^Es, Gs, Gs, Gd, Ds, Ds, Wwt, Wwt, Wwt, Wwt, Wot, Wot, Wot, Wot, Wwrt, Wwrt, Wot, Wot, Wot, Wot, Wot, Wot
Ss, Ss, Ss, Gs, Gg, Gs, Gg, Gg, Gg^Es, Gs, Gs, Ss, Ss, Wwt, Wwt, Wwf, Wwt, Wwt, Ds, Ds, Wwt, Wwt, Ss, Wwf, Ds, Ds, Ds, Ds, Gd, Gs, Gs, Gd^Fetd, Gd^Fetd, Gs, Gd^Fetd, Gs^Es, Gs, Gd, Gd^Es, Ds, Ds, Wwt, Wwt, Wwt, Wwt, Ds, Ds, Gd, Gd, Gs^Es, Gd, Gs, Gs, Gs, Gs, Gs, Gs, Gd, Ds, Wwt, Wwt, Wwt, Wwt, Wot, Wot, Wot, Wot, Wot, Wot, Wot, Wwrt, Wot, Wot, Wot, Wot
Ss, Ss, Gs, Gs, Gg^Es, Gg, Gs^Fds, Gg, Gg, Gg, Gg^Es, Gs, Ss, Ss, Ds, Ds, Wwt, Wwt, Ss, Ss, Ss, Wwt, Ds, Ss, Wwf, Ds, Ds, Ds, Gd, Gs^Vc, Gs, Gs^Es, Gs, Gs, Gd^Fetd, Gd^Fetd, Gd^Fetd, Gs, Gs, Gd^Es, Gd^Es, Ds, Ds, Wwt, Wwt, Wwt, Wwt, Ds, Gd, Gd, Gd, Gd, Gd, Gs, Gs, Gs, Gs, Gd, Gd, Ds, Ds, Wwt, Wwt, Wot, Wot, Wot, Wot, Wot, Wot, Wot, Wot, Wwrt, Wwrt, Wot, Wot
Ss, Gs, Gs^Es, Gg^Es, Gg, Gs^Fds, Gll^Fdf, Gs^Fds, Gs^Fds, Gg, Gg, Gs, Gs, Ds, Ss, Ss, Wwt, Ss^Vhs, Ss, Ss, Ds, Wwt, Ss, Ds, Ds, Ds, Ds, Ds, Ds, Gd, Gd, Gs, Gs, Gs^Es, Gs, Gd^Fetd, Gd^Fetd, Re^Vct, Gd^Fetd, Gs, Gs, Gd, Ds, Wwt, Wwt, Wwt, Wwf, Ds, Ds, Gd, Gd, Gd, Gd, Gd, Gs, Gs, Gs, Gd, Ds, Ds, Wwt, Wwt, Wwt, Wot, Wot, Wot, Wot, Wot, Wot, Wot, Wot, Wot, Wot, Wwrt, Wot
Ss, Ss, Gs, Gg^Es, Gs^Fds, Gs^Fds, Gs^Fds, Gll^Fdf, Gs^Fds, Gg, Gg, Gs, Gs, Ss, Ss, Ds, Ss, Ds, Wwf, Wwf, Wwf, Ss, Ds, Ds, Ds, Ds, Ds, Wwt, Ds, Ds, Ds, Gd, Gd, Gs^Es, Gs, Gd^Fetd, Gd^Fetd, Gd^Fetd, Gd^Fetd, Gd^Fetd, Gs, Gd, Gd, Ds, Ds, Wwf, Wwt, Wwt, Wwt, Ds, Gd, Gd, Gd, Gd, Gd, Gd, Gd, Gd, Ds, Ds, Wwt, Wwt, Wwt, Wot, Wot, Wot, Wot, Wot, Wwrt, Wwrt, Wot, Wot, Wot, Wwrt, Wot
Gs, Gs, Gg, Gg, Gll^Fdf, Gll^Fdf, Gs^Fds, Gll^Fdf, Gs^Fds, Gll, Gg, Gg^Es, Gs, Gs, Ds, Ds, Ss, Ds, Wwf, Ds, Wwt, Ss, Ds, Ss^Vhs, Wwf, Ds, Ss, Ss, Wwt, Ds, Ds, Ds, Ds, Gd, Gd, Gs, Gs, Gd^Fetd, Ce, Ce, Ce, Gs, Gs, Gd, Gd, Ds, Wwt, Wwt, Wwt, Ds, Ds, Ds, Ds, Ds, Ds, Gd, Gd, Gd, Ds, Wwt, Wwt, Wwt, Wwt, Wwt, Wot, Wot, Wot, Wwrt, Wot, Wot, Wot, Wot, Wwrt, Wwrt, Wot
Gg, Gg, Gll^Fdf, Gs^Fds, Gll, Gs^Fds, Gll^Fdf, Gll^Fdf, Gll^Fdf, Gs^Fds, Gs^Fds, Gg^Es, Gs, Ss, Ss, Ss, Ds, Ss, Wwt, Ss, Ss, Wwt, Wwt, Wwf, Ds, Wwf, Ds, Wwt, Wwt, Wwt, Ss, Ds, Ds, Gd, Ds, Ce, Gd, Gs, Ce, 7 Ke, Ce, Gd^Fetd, Gs, Re^Vct, Gd, Ds, Ds, Wwt, Wwf, Wwf, Wwf, Wwt, Wwt, Wwt, Ds, Ds, Ds, Gd, Gd, Ds, Wwt, Wwt, Wwt, Wwt, Wot, Wot, Wot, Wwrt, Wwrt, Wot, Wot, Wot, Wwrt, Wot, Wot
Gg, Gll^Fdf, Gs^Fds, Gll, Gll, Gs^Fds, Gll^Fdf, Gs^Fds, Gll^Fdf, Gs^Fds, Gs^Fds, Gg, Gg^Es, Gs, Ss, Ss, Ss, Ds, Ss, Wwt, Ss, Ss, Wwt, Wwt, Ds, Ss, Ss, Wwt, Ss, Ds, Ds, Ds, Ds, Ds, Ds, Ds, Ce, Gs, Gs, Ce, Gd^Fetd, Gs, Gd^Fetd, Gs, Gs^Es, Gd, Gd, Ds, Ds, Wwf, Wwt, Wwt, Wwt, Wwt, Wwf, Ds, Wwt, Ds, Ds, Ds, Wwt, Wwt, Wwt, Wwt, Wot, Wot, Wot, Wot, Wot, Wwrt, Wwrt, Wot, Wot, Wot, Wot
Gg, Gll^Fdf, Gll^Fdf, Gs^Fds, Gs^Vc, Gs^Fds, Gll^Fdf, Gs^Fds, Gll^Fdf, Gll^Fdf, Gll^Fdf, Gg, Gg, Gs, Ss, Wwf, Ss, Ss, Ss, Ds, Ds, Ss, Ds, Wwt, Ss, Ds, Wwf, Wwt, Ss, Wwt, Wwt, Ss, Ds, Ds, Ds, Ds, Ds, Gd, Gs, Gs, Gg, Gd^Fetd, Gd^Fetd, Gd^Fetd, Gs, Gs^Es, Gs, Gd, Ds, Ds, Ds, Wwt, Wwt, Wwf, Wwf, Wwf, Wwt, Wwt, Wwt, Ds, Wwt, Wwt, Wwt, Wwt, Wwt, Wot, Wot, Wot, Wot, Wot, Wwrt, Wwrt, Wot, Wot, Wot
Gg, Gs^Fds, Gs^Fds, Gs^Fds, Gs^Fds, Gll, Gll^Fdf, Gll^Fdf, Gll^Fdf, Gs^Fds, Gs^Fds, Gg, Gg^Es, Gs, Gs, Ss, Ss, Ds, Ds, Ds, Ss, Ss, Ds, Ds, Wwt, Wwt, Wwt, Ds, Ss, Ss, Ss, Ss, Wwt, Ds, Ds, Ds, Ds, Ce, Gd, Gs, Gs, Gd^Fetd, Gg, Gd^Fetd, Gd^Fetd, Gd^Fetd, Gs, Gd, Gd, Ds, Ds, Ds, Ds, Ds, Ds, Wwt, Wwt, Wwt, Wwt, Wwt, Wwt, Wwt, Wwt, Wwt, Wwt, Wot, Wot, Wot, Wwrt, Wwrt, Wot, Wot, Wwrt, Wot, Wot
Gg, Gs^Fds, Gll, Gs^Fds, Gll, Gs^Fds, Gll^Fdf, Gs^Fds, Gs^Fds, Gll, Gs^Fds, Gg, Gg, Gg, Gs, Ss, Ds, Ds, Ss, Ss, Ss, Ss, Ds, Ds, Ss, Ss, Wwt, Wwt, Ss, Ss^Vhs, Wwt, Wwt, Ss, Wwt, Ss, Ds, Ds, Ds, Ds, Re^Vct, Gd, Gd^Fetd, Gd^Fetd, Gd^Fetd, Gs, Gd^Fetd, Gd^Fetd, Gs, Gd^Fetd, Gd, Gd, Gd, Gd, Gd, Gd, Ds, Wwt, Wwt, Wwt, Wwt, Wwt, Wwt, Wwt, Wwt, Wwt, Wot, Wot, Wot, Wot, Wot, Wwrt, Wwrt, Wot, Wot, Wot
Gg, Gg, Gg, Gll, Gg, Gll^Fdf, Gll, Gll^Fdf, Gll, Gs^Fds, Gg, Gg, Gg, Gg^Es, Gs, Ss, Gs, Ss, Gs, Gs, Gs, Ss, Gs, Ds, Ss, Ds, Ss, Ss, Wwt, Wwt, Ds, Ss, Ds, Ds, Ss, Wwt, Wwt, Ds, Ds, Ds, Gd, Gg, Gs, Gs, Gs^Es, Gs, Gd^Fetd, Gd^Fetd, Gs, Gd^Fetd, Gd^Fetd, Gs, Gs, Gs, Gd, Ds, Wwt, Wwt, Wwt, Wwt, Wwt, Wwt, Wwt, Wwt, Wot, Wot, Wot, Wot, Wot, Wwrt, Wot, Wot, Wot, Wot, Wot
Gg, Gg, Gg^Efm, Gg^Efm, Gg^Efm, Gg, Gg, Gll, Gg, Gg, Gg, Gg, Gg, Gg, Gg, Gs, Gg^Es, Gs^Es, Gg, Gg^Es, Gg^Es, Gs, Gg, Gs, Ss, Ss, Ds, Wwt, Ss, Ds, Ds, Wwf, Ss, Ss, Ds, Ss, Ss, Ss, Ds, Ds, Ds, Gd, Gd, Gd, Gd, Gs^Es, Gs^Es, Gd^Fetd, Gd^Fetd, Gd^Fetd, Gd^Fetd, Gd^Fetd, Gs, Gs, Gd, Ds, Ds, Wwt, Wwt, Wwt, Wwt, Wwt, Wwt, Wot, Wot, Wot, Wot, Wot, Wot, Wwrt, Wwrt, Wot, Wot, Wot, Wot
Gg^Efm, Gg, Gg^Efm, Gg, Gg^Efm, Gg, Gg, Gg, Gs^Vc, Gg, Gg, Gg^Es, Gg, Gs^Vc, Gg, Gg, Gg, Gg, Gll^Fdf, Gll^Fdf, Gg, Gg^Es, Gg, Gs, Gs, Ss, Ds, Wwf, Ds, Ss, Ds, Ds, Ss, Ss, Wwf, Ss, Ss, Wwt, Ds, Ds, Ds, Ds, Ds, Ds, Ds, Gd, Gs, Gs, Gd^Fetd, Gd^Fetd, Gs^Es, Gs, Gd, Gs, Gd, Gd, Ds, Ds, Wwt, Wwt, Wwt, Wwt, Wwt, Wot, Wot, Wot, Wot, Wot, Wot, Wot, Wwrt, Wot, Wot, Wwrt, Wot
Gg, Gg^Efm, Gg, Gg, Gg, Gg, Gg, Gg, Gg^Es, Gg, Gg, Gg, Gg^Es, Gg, Gs^Fds, Gg, Gll, Gs^Fds, Gs^Fds, Gll^Fdf, Gg, Gg, Gg, Gg^Es, Gs^Es, Ss, Ss, Wwf, Ds, Ss, Ss, Ds, Ss, Ss^Vhs, Ss, Ss, Ds, Wwt, Wwt, Wwt, Ss, Ds, Wwt, Ds, Ds, Gd, Gd, Gs, Gs, Gs^Es, Gd, Gd, Ds, Gd, Ds, Ds, Ds, Ds, Wwt, Wwt, Wwt, Wwt, Wot, Wot, Wot, Wot, Wwrt, Wwrt, Wot, Wot, Wot, Wot, Wot, Wwrt, Wot
Gg, Gg, Gg, Gg^Es, Gg, Gg, Gg, Gg^Es, Gg, Gg, Gg, Gg^Es, Gg, Gg, Gs^Fds, Gll^Fdf, Gll, Gs^Fds, Gll^Fdf, Gs^Fds, Gs^Fds, Gg, Gg, Gg, Gg, Gs, Gs, Ss, Ss, Wwf, Ss, Ss, Wwf, Wwt, Ss, Ss, Ss, Wwt, Wwt, Ss, Ds, Wwf, Ss, Ss, Ss, Ds, Ds, Gd, Gd, Gd, Gd, Ds, Ds, Ds, Ds, Ds, Wwt, Wwt, Wwt, Wwt, Wot, Wot, Wot, Wot, Wwrt, Wwrt, Wot, Wot, Wot, Wot, Wot, Wot, Wwrt, Wwrt, Wot
Gg^Es, Gg, Gg, Gg, Gg, Gg^Es, Gg, Gg^Es, Gg, Gg^Es, Gg, Gg, Gll, Gs^Fds, Gll^Fdf, Gll^Fdf, Gs^Fds, Gll^Fdf, Gll, Gs^Fds, Gll^Fdf, Gs^Fds, Gll, Gg, Gg, Gg, Gs, Ss, Gs, Ss, Ss, Ds, Ds, Wwt, Ss, Ss, Ds, Ss, Wwf, Ds, Wwf, Wwf, Ss, Ss, Ds, Ss, Ss, Ds, Ds, Ds, Ds, Ds, Wwt, Wwt, Wwt, Wwt, Wwt, Wwt, Wot, Wot, Wot, Wot, Wot, Wwrt, Wot, Wot, Wot, Wot, Wot, Wot, Wwrt, Wwrt, Wot, Wot, Wot
Gg, Gg, Gg, Gg, Gg, Gg, Gg, Gg, Gg^Efm, Gg, Gg, Gll, Gll^Fdf, Gll^Fdf, Gll, Gs^Fds, Gs^Fds, Gll^Fdf, Gs^Fds, Gs^Fds, Gs^Fds, Gll^Fdf, Gs^Fds, Gs^Fds, Gg, Gg, Gg, Gs, Gs, Gs, Ss, Ss, Ds, Ds, Ss, Ss, Ss, Wwf, Ss, Wwf, Ds, Wwt, Wwt, Wwt, Wwf, Wwf, Ss, Wwf, Ds, Ds, Wwt, Wwt, Wwt, Wwt, Wwt, Wwt, Wwt, Wwt, Wot, Wot, Wwrt, Wot, Wot, Wwrt, Wot, Wot, Wot, Wot, Wot, Wwrt, Wot, Wot, Wot, Wot, Wot
Gg^Es, Gg, Gg, Gg, Gg^Es, Gg, Gg^Efm, Gg^Efm, Gg^Efm, Gg, Gg, Gs^Fds, Gll^Fdf, Gll, Gs^Fds, Gll, Gll^Fdf, Gll^Fdf, Hh^Fms, Hhd^Fdf, Gs^Fds, Gll^Fdf, Gs^Fds, Gs^Fds, Gll, Gg^Es, Gg, Gs^Vc, Gg^Es, Gs, Gs, Ss, Ds, Wwf, Wwf, Wwf, Wwf, Wwf, Ss, Ss, Ss, Ss, Wwt, Ss, Ss, Ds, Ss, Wwf, Wwf, Wwt, Wwt, Wwt, Wwt, Wwt, Wwt, Wwt, Wwt, Wwt, Wot, Wot, Wot, Wot, Wot, Wwrt, Wwrt, Wot, Wot, Wot, Wwrt, Wwrt, Wot, Wot, Wwrt, Wot, Wot
Gg, Gg, Gg, Gs^Vc, Gg, Gg, Gg, Gg, Gg^Efm, Gg, Gg, Gs^Fds, Gs^Fds, Gll^Fdf, Gs^Fds, Gll^Fdf, Gs^Fds, Hh^Fms, Hhd^Fdf, Hh^Fms, Hh^Fms, Gll^Fdf, Gll, Gs^Fds, Gs^Fds, Gg, Gg^Es, Gg, Gg^Es, Gg, Gg, Gs, Ss, Ss, Ds, Ss, Ds, Ss, Ds, Ss, Ds, Ds, Wwf, Wwt, Ss, Ss, Ss, Ds, Ds, Wwt, Wwt, Wwt, Wwt, Wwt, Wot, Wot, Wot, Wot, Wot, Wwrt, Wot, Wot, Wot, Wot, Wwrt, Wot, Wot, Wot, Wot, Wot, Wwrt, Wwrt, Wot, Wot, Wot
Gg^Es, Gg, Gg^Es, Gg^Es, Gg, Gg^Efm, Gg, Gg^Efm, Gg^Efm, Gg, Gg, Gs^Fds, Gll^Fdf, Gll^Fdf, Gs^Fds, Gll^Fdf, Hh^Fms, Hhd^Fdf, Hh^Fms, Hhd^Fdf, Hh^Fms, Gll^Fdf, Gs^Fds, Gll^Fdf, Gll^Fdf, Gs^Fds, Gg, Gg^Es, Gg, Gg^Es, Gs, Gs, Ss, Ss, Ss, Ds, Ss, Ds, Ss, Ss, Ds, Wwf, Ds, Ss, Ds, Ss, Gs, Gd, Ds, Wwt, Wwt, Wwt, Wwt, Wot, Wot, Wot, Wot, Wot, Wwrt, Wwrt, Wot, Wot, Wot, Wot, Wot, Wot, Wot, Wot, Wot, Wot, Wwrt, Wot, Wot, Wot, Wot
Gg, Gg^Es, Gg, Gg, Gg, Gg, Gg, Gg, Gg, Gg^Efm, Gg, Gll, Gg, Gg, Gg, Hh^Fms, Gll^Fdf, Hhd^Fdf, Hh^Fms, Hhd^Fdf, Hh^Fms, Hh^Fms, Gll, Gll, Gll, Gs^Fds, Gg, Gg, Gg, Gg, Gs, Gs, Gg, Ds, Ds, Ds, Ds, Ds, Ds, Ds, Ds, Ds, Ss, Ss, Ds, Ds, Ds, Gd, Ds, Ds, Wwt, Wwt, Wot, Wot, Wot, Wot, Wwrt, Wwrt, Wot, Wot, Wot, Wot, Wot, Wot, Wot, Wot, Wot, Wot, Wot, Wot, Wwrt, Wot, Wot, Wot, Wot
