Hhd^Fts, Hhd, Hhd, Hhd, Hhd, Gs, Gd, Gs, Gs, Gs, Gs, Gs^Es, Gs, Gs, Gs, Gs, Gs, Gs, Gs, Gs, Gd, Gd, Gd, Gd, Gd, Gs, Gs, Gs, Gs, Gs, Gd, Gs, Gs, Gs, Gs, Gs, Gs, Gs, Gd, Gs, Gd, Gs, Gd, Gs, Gs, Gs, Gd^Fts, Gd^Fts, Gd^Fts, Ds, Dd^Ftd, Ds, Ds, Wwt, Wwt, Wwt, Wwt, Wwt, Wwt, Wot, Wot, Wot, Wot, Wot, Wot, Wot, Wwrt, Wot, Wot, Wot, Wot, Wot, Wot, Wot, Wot, Wot, Wot
Hhd, Hhd^Fts, Hhd^Fts, Hhd, Gs, Mm, Gs, Gs, Gd, Gs, Gs, Gs, Gs, Gd^Es, Gs, Gd^Es, Gd, Gs, Gs, Gs, Gs, Gs, Gs, Gs, Gs, Gd, Gd, Gd, Gd, Gd, Gd, Gs, Gd, Gd, Gd^Es, Gd, Gs, Gd, Gs, Gs, Gs, Gd, Gs^Es, Gs, Gs, Re^Vct, Gs, Gd^Fts, Gd^Fts, Dd^Ftd, Dd^Ftd, Ds, Ds, Wwt, Wwt, Wwt, Wwt, Wwt, Wwt, Wwt, Wwt, Wot, Wot, Wot, Wot, Wwrt, Wot, Wot, Wot, Wot, Wot, Wot, Wot, Wot, Wot, Wot, Wot
Hhd, Hhd^Fts, Gd^Fts, Gd^Fts, Gd, Gs, Gd^Fts, Gs, Gs, Gd, Gs, Gs, Gd^Es, Gs, Gd, Gd, Gs, Gs, Arrw, Arrw, Arrw, Arrw, Arrw, Gs, Gd, Gd, Gs^Es, Gs^Es, Gs^Es, Gs^Es, Gs, Gd, Gs, Gd, Gs, Gs, Gs, Gs, Gd^Fts, Gd, Re^Vct, Gd, Gs, Gd^Es, Gs, Gd, Gd, Gd^Fts, Gd^Fts, Gd^Fts, Ds, Ds, Ds, Ds, Ds, Ds, Ds, Wwt, Wwt, Wwt, Wwt, Wot, Wot, Wot, Wot, Wot, Wot, Wot, Wwrt, Wot, Wot, Wot, Wot, Wot, Wot, Wot, Wot
Hhd, Hhd^Fts, Gd^Fts, Gs, Gd^Es, Gs, Gs, Gs, Gs, Gd^Es, Gs, Gd, Gs, Gs, Gs, Gs, Gs, Gs, Arrw, Arrw, Gd^Var, Arrw, Arrw, Gs, Gs, Gs^Es, Gd^Fts, Gs, Gs, Gs, Gs, Gs, Gs, Gs, Gd^Fts, Gd^Fts, Gs, Gs, Gd, Gd, Gs, Gd, Gd, Gd, Ce, Gs, Gd, Gs, Gd, Gd, Gd, Ds, Ds, Dd^Ftd, Ds, Ds, Wwt, Wwt, Wwt, Wwt, Wot, Wot, Wot, Wot, Wot, Wot, Wot, Wot, Wot, Wot, Wot, Wot, Wot, Wot, Wot, Wot, Wot
Hhd, Hhd, Gs, Gd^Es, Gs, Gd, Gd, Gs^Es, Gs, Gd, Gs, Gs, Gd^Fts, Gd^Fts, Gs, Gd^Fts, Gs, Gs, Arrw, Arrw, Gs, Gs^Es, Gs^Es, Gd, Gs, Gs, Gs, Gd, Arrw, Gd, Gd^Es, Arrw, Arrw, Gs, Gd^Fts, Gd, Gd, Gs, Gd^Fts, Gs, Gs, Gd, Gd, Ce, 1 Ke, Ce, Gd, Re^Vct, Gs, Gd, Dd^Ftd, Dd^Ftd, Ds, Ds, Wwt, Wwt, Wwt, Wwt, Wwt, Wwt, Wot, Wot, Wot, Wot, Wot, Wot, Wot, Wwrt, Wot, Wot, Wot, Wot, Wwrt, Wot, Wot, Wot, Wot
Hhd, Gs, Gd, Gs, Gd^Fts, Gs, Gs, Gs, Gd, Gs, Gs, Gd^Fts, Gd, Gd, Gd^Fts, Gs, Gs, Gs, Gs, Arrw, Arrw, Gd, Gd^Es, Gs^Es, Gd, Gs^Es, Gs^Es, Gd, Arrw, Arrw, Gd^Var, Arrw, Arrw, Gs, Gd^Fts, Gd, Gd^Fts, Gd^Fts, Gs, Gd^Fts, Gs, Gs, Gs, Ce, Ce, Ce, Gs, Gs, Gd^Fts, Dd^Ftd, Dd^Ftd, Ds, Wwt, Ds, Wwt, Wwt, Wwt, Wwt, Wwt, Wot, Wot, Wot, Wot, Wot, Wot, Wot, Wwrt, Wot, Wot, Wot, Wot, Wot, Wot, Wot, Wot, Wot, Wot
Gs, Gs, Gd, Gs^Es, Gs, Gs, Gd^Fts, Gs, Gs, Gd^Es, Gs, Gs, Gd^Fts, Gd^Fts, Gs, Gs, Gs, Gs, Gs, Gs, Gs, Gs, Gd^Es, Gs, Gd^Fts, Gd, Gs^Es, Gs, Arrw, Arrw, Arrw, Arrw, Gs, Gs, Gs, Gs, Gs, Gd^Fts, Gs, Gs, Gd, Gs, Gd, Gs, Gd, Gd, Gd^Fts, Gd^Fts, Ds, Ds, Ds, Ds, Wwt, Wwt, Wwt, Wwt, Wwt, Wwt, Wot, Wot, Wot, Wot, Wot, Wot, Wot, Wot, Wot, Wot, Wot, Wot, Wot, Wot, Wot, Wot, Wot, Wot, Wot
Gs, Gs, Gd^Fts, Gd^Es, Gs^Es, Gs, Gs, Gs, Gs, Gd^Es, Gd^Es, Gs, Gs, Gs, Gs, Gd, Gs, Gd^Fts, Gd, Gs, Gs, Gd, Gd, Gs, Gs, Gs, Gs, Gs, Gs, Gs, Gs, Gs, Gs, Gd^Fts, Gd, Gd^Fts, Gd, Gs, Gd, Gd, Gs, Re^Vct, Gs, Gs^Es, Gs, Gs, Gd^Fts, Gd^Fts, Ds, Ds, Wwt, Wwt, Wwt, Wwt, Wwt, Wwt, Wot, Wot, Wot, Wot, Wot, Wot, Wot, Wot, Wot, Wwrt, Wwrt, Wot, Wot, Wot, Wot, Wwrt, Wot, Wot, Wot, Wot, Wot
Gs, Gs, Gd, Gd, Gs, Gs, Gs, Gs, Gd^Fts, Gs, Gs, Gs, Gs, Gd^Fts, Gs, Gd^Es, Gd^Es, Gs, Gd^Fts, Gs, Gd, Gd, Gs^Es, Gd, Gd, Gs, Gd, Gd, Gd, Gs, Gs, Gs, Gd^Fts, Gs, Gd, Gd, Gd, Gd^Fts, Gs, Gd, Gd, Gs, Gs^Es, Gs, Re^Vct, Gd^Fts, Gd^Fts, Dd^Ftd, Dd^Ftd, Ds, Ds, Wwt, Wwt, Wwt, Wot, Wot, Wot, Wot, Wot, Wot, Wot, Wwrt, Wot, Wot, Wot, Wot, Wot, Wot, Wot, Wot, Wwrt, Wot, Wot, Wot, Wot, Wot, Wot
Gs, Gs, Gs, Gs^Es, Gs, Gs, Gd, Gs, Gd^Fts, Gd^Fts, Gs, Gd^Es, Gs, Gd^Fts, Gd, Gs, Gd^Es, Gs, Gs, Gs, Gd, Gs, Gs, Gd, Gs, Gs, Gs, Gs, Gs, Gs, Gd, Gs, Gs, Gd^Fts, Gs, Gs, Gd^Fts, Gs, Gs, Gs, Gd, Gd, Gs^Es, Gs, Gd^Fts, Gd^Fts, Gd^Fts, Gd^Fts, Dd^Ftd, Ds, Ds, Wwt, Wwt, Wot, Wot, Wot, Wot, Wot, Wot, Wot, Wot, Wot, Wot, Wot, Wot, Wot, Wot, Wot, Wot, Wot, Wot, Wwrt, Wot, Wot, Wwrt, Wot, Wot
Gs, Gd^Es, Gs, Gs, Gs, Gd^Fts, Gs, Gs, Gs, Gd, Gd, Gd, Gs, Gs, Gd, Gs, Gd^Fts, Gs^Es, Gd, Gs, Gd, Gd^Es, Gs, Gd, Gs, Gs, Gd^Fts, Gd^Fts, Gd^Fts, Gs^Es, Gs^Es, Gd, Gs^Es, Gs, Gs, Gd^Fts, Gs, Gs, Gd^Es, Gs^Es, Gd, Gs, Gs, Gd, Gd^Fts, Gd^Fts, Dd^Ftd, Dd^Ftd, Dd^Ftd, Ds, Ds, Wwt, Wwt, Wot, Wot, Wot, Wot, Wot, Wot, Wot, Wot, Wwrt, Wot, Wot, Wot, Wot, Wot, Wot, Wot, Wot, Wot, Wot, Wot, Wot, Wot, Wot, Wot
Gs^Es, Gs, Gd, Gd^Es, Gs, Gs, Gd, Gs, Gs, Gd^Fts, Gs, Gs, Gd^Fts, Gd, Gd, Gs, Gs, Gs^Es, Gs^Es, Gd, Gs^Es, Gs, Gs, Gs, Hhd, Hhd, Hhd^Fts, Gd^Fts, Gd^Fts, Gs, Gd, Gd, Gd, Gd, Gd, Gs, Gd, Gd, Gd, Gs, Gs, Gs, Gs, Gd, Gd^Fts, Dd^Ftd, Dd^Ftd, Dd^Ftd, Ds, Ds, Wwt, Wwt, Wwt, Wwt, Wot, Wot, Wot, Wot, Wot, Wwrt, Wot, Wot, Wot, Wwrt, Wot, Wwrt, Wot, Wot, Wot, Wot, Wot, Wot, Wot, Wot, Wot, Wot, Wot
Gs, Gd, Gs, Gs^Es, Gd^Es, Gd, Gs^Es, Gs, Gd^Es, Gs, Gd, Gs, Gs, Gd^Fts, Gs, Gd, Gs, Gd, Gd, Gs, Gs, Gs, Hhd, Hhd, Hhd^Fts, Hhd^Fts, Hhd^Fts, Gd^Fts, Gd^Fts, Gs, Gd, Gs, Gs, Gs^Es, Gs, Gs, Gs^Es, Gs, Gs, Gd, Gd, Gd^Fts, Gs, Gd, Gd^Fts, Dd^Ftd, Dd^Ftd, Dd^Ftd, Ds, Ds, Ds, Wwt, Wwt, Wwt, Wot, Wot, Wot, Wot, Wot, Wwrt, Wot, Wot, Wot, Wot, Wot, Wot, Wot, Wwrt, Wwrt, Wot, Wot, Wot, Wot, Wot, Wot, Wwrt, Wot
Gs, Gd, Gd^Es, Gd, Gs, Gd, Gs, Gs^Es, Gd, Gs, Gs, Gd, Gd, Gs, Gd, Gd^Es, Gs, Gs, Gs, Gd, Gs, Gs, Hhd, Hhd^Fts, Hhd^Fts, Hhd, Hhd^Fts, Gd^Fts, Gd^Fts, Gs, Gd, Gs, Hhd, Hhd, Gs, Gs, Gd^Fts, Gs, Gs, Gs, Gd, Gd, Gs, Gd, Gs, Gd^Fts, Ds, Dd^Ftd, Ds, Ds, Ds, Wwt, Wwt, Wwt, Wot, Wot, Wot, Wot, Wot, Wot, Wot, Wot, Wot, Wot, Wot, Wot, Wot, Wot, Wwrt, Wot, Wot, Wot, Wot, Wot, Wot, Wot, Wot
Gs, Gs, Gd^Es, Gs, Gs, Gd, Gs, Gs, Gs, Gd, Gd, Gs, Gs, Gs, Gs, Gd, Gs, Gd, Gs^Es, Gs, Gd, Gs, Hhd, Hhd^Fts, Hhd, Hhd, Hhd, Gd^Fts, Gs, Gs, Gs, Gs, Gs, Hhd, Gd, Gs, Gd, Gs, Gd, Gd, Gs, Gd^Es, Gs, Gs^Es, Gs^Es, Gd, Gd, Ds, Ds, Ds, Wwt, Wwt, Wwt, Wwt, Wot, Wot, Wot, Wot, Wot, Wot, Wot, Wot, Wot, Wot, Wot, Wot, Wwrt, Wot, Wwrt, Wot, Wot, Wot, Wot, Wot, Wot, Wwrt, Wot
Gs, Gs, Gd, Gs, Gd^Fts, Gs, Gd, Gs, Gs, Gd^Es, Gs, Gs, Arrw, Arrw, Gs, Gs, Gs, Gs, Gs^Es, Gs^Es, Gs, Gs, Hhd, Hhd, Hhd, Hhd, Gs, Gs, Gd, Gs^Es, Gd, Gd^Fts, Gd, Gd, Gs, Gs, Gd^Var, Gd, Hhd, Hhd, Hhd, Hhd, Gs, Gd, Gs, Gd, Ds, Ds, Ds, Ds, Wwt, Wwt, Wwt, Wwt, Wot, Wot, Wot, Wot, Wot, Wot, Wot, Wot, Wot, Wot, Wot, Wot, Wot, Wot, Wot, Wot, Wot, Wot, Wot, Wot, Wot, Wot, Wot
Gd, Gs, Gd, Gd^Es, Gs, Gd, Gs, Gd^Fts, Gs^Es, Gd^Es, Gs, Arrw, Arrw, Arrw, Gs, Gs, Gd, Gd, Gd^Var, Gd, Gd, Gs, Gs, Gs, Gs, Gd, Gd, Gs, Gd^Es, Gs, Gs^Es, Gs, Gs, Gs, Gd^Fts, Gs, Gs^Es, Gs, Hhd, Hhd, Gs, Hhd, Gd, Gd, Gd, Gd, Ds, Ds, Ds, Wwt, Wwt, Wwt, Wwt, Wot, Wot, Wot, Wot, Wot, Wwt, Wwt, Wwt, Wot, Wot, Wot, Wot, Wot, Wot, Wot, Wot, Wot, Wot, Wot, Wwrt, Wot, Wot, Wot, Wot
Gd, Gd^Fts, Gs, Gs^Es, Gd^Es, Gd, Gs, Gd, Gd^Es, Gs, Gs, Arrw, Arrw, Gs, Gd, Gs, Gs^Es, Gd, Gs, Gs^Es, Gs, Gs^Es, Gs, Gs^Es, Gs, Gs^Es, Gs, Gs^Es, Gs, Gd, Gs, Gd^Es, Gd, Gs, Gd^Fts, Gd, Gd, Gs, Gs, Gs, Gd^Fts, Gs, Gd, Gs, Gd, Ds, Dd^Ftd, Ds, Ds, Wwt, Wwt, Wwt, Wot, Wot, Wot, Wot, Wot, Wot, Wwt, Wwt, Wwt, Wwt, Wwt, Wot, Wot, Wot, Wot, Wot, Wwt, Wot, Wot, Wot, Wot, Wot, Wot, Wot, Wot
Gs, Gs, Gd^Fts, Gs, Gs, Gd, Gs, Gs^Es, Gs, Gs, Gd, Arrw, Gs, Gs, Gs, Gs^Es, Gs, Gs, Gs, Gd, Gs, Gs, Gs, Gd, Gs, Gs, Gs, Gs, Gs, Gs, Gs, Gs, Gs, Gs, Gs, Gs, Gs, Gd, Gs^Es, Gs, Gs, Gs, Gd, Gs, Gd, Ds, Dd^Ftd, Ds, Ds, Wwt, Wwt, Wwt, Wwt, Wot, Wwt, Wwt, Wwt, Wwt, Wwt, Wwt, Wwt, Wwt, Wwt, Wwt, Wwt, Wwt, Wwt, Wwt, Wwt, Wwt, Wwt, Wot, Wot, Wot, Wot, Wot, Wot
Gs, Gs, Gd, Gd, Gs, Gd^Fts, Gs, Gd, Gs, Gs, Gd, Gs, Gs, Gd, Gs^Es, Gs, Arrw, Arrw, Gs^Es, Gs, Gs, Gs, Arrw, Gd, Gd, Gd, Gs^Es, Arrw, Arrw, Arrw, Gs, Gd, Gs, Gs, Gd^Fts, Gd^Fts, Gd, Gs, Gs, Gd^Es, Gs, Gd^Es, Gd, Gs^Es, Gd, Ds, Ds, Dd^Ftd, Ds, Ds, Ds, Wwt, Wwt, Wwt, Wwt, Wwt, Wwt, Wwt, Ds, Wwt, Ds, Wwt, Wwt, Wwt, Wwt, Wwt, Wwt, Wwt, Wwt, Wwt, Wwt, Wot, Wot, Wot, Wot, Wwrt, Wot
Gd^Es, Gs, Gs^Es, Gs, Gs, Gd^Fts, Gs, Gs, Gd^Fts, Gs, Gs, Gs^Es, Gd, Gs, Gs, Arrw, Arrw, Gs, Gd, Gd, Arrw, Arrw, Arrw, Gs, Gd, Gs^Es, Gd, Arrw, Arrw, Arrw, Gs, Gs, Gd, Gd^Fts, Gs, Gs, Gd, Gs, Arrw, Arrw, Arrw, Gs, Gd, Gs, Gs, Gd, Ds, Dd^Ftd, Ds, Ds, Wwt, Wwt, Wwt, Wwt, Wwt, Wwt, Ds, Ds, Ds, Ds, Ds, Ds, Ds, Ds, Ds, Wwt, Wwt, Wwt, Wwt, Wwt, Wwt, Wot, Wwrt, Wot, Wot, Wwrt, Wot
Gs^Es, Gs, Gs, Gs, Gs, Gd^Fts, Gs, Gd, Gs, Gd, Gd^Es, Gd, Gs^Es, Gs, Gs, Arrw, Arrw, Gs^Es, Gs, Gs, Arrw, Arrw, Arrw, Gd, Gs^Cov, Gd^Cov, Gs^Cov, Gs, Arrw, Arrw, Gs, Gd, Gd, Gs, Arrw, Gs, Gs, Gs, Gs, Arrw, Arrw, Gs, Gd, Gs, Gs, Gd, Gd, Ds, Ds, Wwt, Wwt, Wwt, Wwt, Ds, Ds, Ds, Ds, Ds, Ds, Dd^Ftd, Dd^Ftd, Dd^Ftd, Dd^Ftd, Dd^Ftd, Dd^Ftd, Ds, Ds, Wwt, Wwt, Wwt, Wwt, Wot, Wot, Wot, Wot, Wwrt, Wot
Gs, Gd, Gs, Gd, Gs, Gs, Gs, Gd, Gs, Gs, Gd^Fts, Gs, Gs, Gs, Arrw, Arrw, Arrw, Gd^Es, Gd^Es, Gs, Gs, Arrw, Arrw, Gs^Cov, Gd^Cov, Gd^Cov, Gs^Cov, Gd^Cov, Arrw, Arrw, Gs, Gd, Gs, Arrw, Arrw, Arrw, Gd, Gd^Es, Gs, Arrw, Arrw, Arrw, Gs, Gd, Gs, Gs, Rd, Ds, Wwt, Wwt, Ds, Wwt, Dd^Ftd, Dd^Ftd, Ds, Ds, Gd, Ds, Gd^Fts, Dd^Ftd, Dd^Ftd, Ds, Dd^Ftd, Dd^Ftd, Dd^Ftd, Dd^Ftd, Ds, Ds, Wwt, Wwt, Wwt, Wot, Wot, Wot, Wot, Wwrt, Wot
Gs, Gd^Es, Gs, Gs, Gd^Fts, Gd^Fts, Gd^Es, Gd^Es, Gs, Gs, Gd, Gd, Gs, Gs, Arrw, Arrw, Gs, Gs, Gd^Es, Gs, Gs, Arrw, Arrw, Arrw, Arrw, Gs^Kov, Arrw, Arrw, Arrw, Arrw, Gs, Gd, Gd, Arrw, Arrw, Gs, Gs, Gd, Gd^Es, Gs, Arrw, Arrw, Gs, Gd, Rd, Rd, Rd, Ds, Wwt, Ds, Gd, Ds, Ds, Dd^Ftd, Ds, Gd, Gd^Es, Gd, Gd^Fts, Gd^Fts, Gd^Fts, Dd^Ftd, Gd^Fts, Dd^Ftd, Dd^Ftd, Dd^Ftd, Ds, Ds, Wwt, Wwt, Wwt, Wwrt, Wot, Wot, Wot, Wot, Wot
Gs, Gs, Gs^Es, Gs, Gd, Gs^Es, Gs, Gs, Gd, Gs, Gd, Gs, Gs, Gs, Gs, Gs, Gd, Gd, Gs, Gs^Es, Gd, Gs, Gs, Arrw, Arrw, Arrw, Arrw, Arrw, Gs, Gs, Gd^Es, Gs, Gs, Arrw, Arrw, Arrw, Arrw, Gs, Gs^Es, Gd, Arrw, Arrw, Gs, Gd, Rd, Rd, Wwt, Wwt, Rd, Ds, Gs, Gd^Es, Gd, Ds, Gd, Gd, Gd, Gd, Gd^Fts, Gd^Fts, Gd^Fts, Gd^Fts, Gd^Fts, Dd^Ftd, Dd^Ftd, Dd^Ftd, Ds, Ds, Wwt, Wwt, Wot, Wot, Wwrt, Wot, Wot, Wot, Wot
Gd, Gd, Gd, Gd, Gs^Es, Gd^Es, Gd^Fts, Gs, Gs, Gd, Gd^Fts, Gs, Gd, Gs, Gd, Gs, Gd, Gs, Gs, Gs, Gs, Gs, Gd^Es, Gs, Gs, Gd, Gs, Gs, Gs^Es, Gs, Gd, Gs, Gd, Gd^Var, Arrw, Arrw, Arrw, Gd, Gd, Gs, Arrw, Arrw, Gd^Fts, Gs, Rd, Rd, Wwt, Wwt, Rd, Rd, Gd^Fts, Gd^Fts, Gs, Gd, Gs, Gd, Gd^Fts, Gd^Fts, Gd^Fts, Gd^Fts, Gd^Fts, Gd^Fts, Gd^Fts, Dd^Ftd, Dd^Ftd, Ds, Ds, Wwt, Wwt, Wwt, Wot, Wot, Wwrt, Wot, Wwrt, Wot, Wot
Gs, Gd^Fts, Gd, Gs, Gs, Gs, Gs, Gd^Var, Gs, Gs, Gs, Gd, Gs, Gs, Gs, Gs, Gd^Es, Gs, Arrw, Arrw, Arrw, Gs, Gs, Gd^Es, Gs, Gs, Gd^Es, Gd, Gs, Gd, Gd, Gs, Gd, Arrw, Arrw, Arrw, Gs, Gd, Gs, Gd, Gd^Fts, Gs, Gs, Gd^Fts, Rd, Rd, Sm, Wwt, Rd, Rd, Gd, Gs, Gs, Gs^Es, Gs, Gd, Gd^Fts, Gd^Fts, Gd^Fts, Gd^Fts, Gd^Fts, Gd^Fts, Dd^Ftd, Dd^Ftd, Ds, Ds, Wwt, Wwt, Wwt, Wwt, Wot, Wot, Wot, Wot, Wot, Wot, Wot
Gd^Fts, Gs, Gd, Gs, Gd, Gd, Gs, Gd, Gs^Es, Gd, Gs, Gd, Gs^Es, Gs, Gs, Gs, Gd, Gd, Gs, Arrw, Arrw, Arrw, Gs, Gs, Gs, Gd, Gd, Gd, Arrw, Arrw, Gs, Gd, Gs, Gs, Gs, Gs, Gs, Gd, Gd, Gd, Rd, Gd^Fts, Rd, Gd^Fts, Rd, Rd, Sm, Rd, Rd, Rd, Gd, Gd^Fts, Gd, Gs, Gd^Fts, Gd, Gd^Fts, Gd^Fts, Gd^Fts, Gd^Fts, Gd, Gd, Dd^Ftd, Dd^Ftd, Ds, Ds, Wwt, Wwt, Wwt, Wot, Wot, Wot, Wot, Wot, Wot, Wot, Wot
Gs, Gd, Gs^Es, Gd, Gd, Gs, Gd^Fts, Gs, Gd^Es, Gs^Es, Gs, Gs, Gd, Gs, Gd, Gd^Es, Gd, Gs, Gd, Gs, Arrw, Arrw, Arrw, Arrw, Arrw, Gs, Gd^Es, Gs, Gs, Arrw, Gs, Gs, Arrw, Gs, Gd^Fts, Gd, Gd^Fts, Gd^Fts, Rd, Rd, Rd, Rd, Rd, Rd, Rd, Rd, Wwt, Rd, Rd, Gd, Gs, Gs^Es, Gd^Fts, Gd, Gd^Fts, Gd^Fts, Gd^Fts, Gd^Fts, Gd^Fts, Gd, Gd, Gd, Ds, Dd^Ftd, Ds, Ds, Wwt, Wwt, Wwt, Wot, Wot, Wot, Wot, Wot, Wot, Wwrt, Wot
Gs, Gd, Gs, Gs, Gs, Gd, Gs, Gs, Gd^Es, Gd, Gs, Gs, Arrw, Gs, Gs, Gs^Es, Gd, Arrw, Gs, Gd, Gs, Arrw, Arrw, Arrw, Arrw, Gs, Gs^Es, Gd, Gd, Gd, Gs, Arrw, Arrw, Gs, Gd^Fts, Gd, Rd, Rd, Rd, Rd, Sm, Rd, Sm, Rd, Wwt, Wwt, Rd, Rd, Rd, Gs, Gd^Fts, Gs, Gd, Gd^Fts, Gd^Fts, Gs, Gd^Fts, Gd^Fts, Gd, Gd, Gd, Ds, Ds, Ds, Wwt, Wwt, Wwt, Wwt, Wwt, Wot, Wwrt, Wot, Wot, Wot, Wwrt, Wot, Wot
Gs, Gs^Es, Gd, Gd, Gs, Gd^Fts, Gd, Gd, Gd, Gd, Gs, Gs, Gs, Gs, Gs, Gs, Gs, Gs, Gs, Gd, Gd, Gs, Gs, Arrw, Gs, Gd, Gs^Es, Gs, Arrw, Gd, Gs, Gd^Fts, Gs, Gs, Rd, Rd, Rd, Rd, Sm, Sm, Rd, Sm, Rd, Sm, Rd, Wwt, Rd, Rd, Gd, Gs, Gd^Fts, Gd, Gd^Fts, Gd, Gd^Fts, Gs, Gd^Fts, Gd, Gd, Gd, Dd^Ftd, Ds, Ds, Ds, Wwt, Wwt, Wwt, Wwt, Wot, Wot, Wot, Wot, Wot, Wwrt, Wot, Wot, Wot
Gs, Gs, Gs, Gd^Fts, Gd, Gs, Gs, Gs, Gs, Gd, Gd, Gd, Gs, Gs, Gs^Es, Gd, Gs, Gs^Es, Gs, Gs, Gd^Es, Gs, Gd, Gs, Gs, Gd, Gd, Gs, Arrw, Arrw, Gd, Gd^Fts, Rd, Rd, Rd, Rd, Wwt, Wwt, Rd, Rd, Rd, Rd, Rd, Rd, Rd, Rd, Rd, Rd, Gd^Es, Gs, Gd, Gd, Gd^Fts, Gd^Fts, Gd, Gd^Fts, Gd, Gd^Fts, Gd^Fts, Gd^Fts, Dd^Ftd, Dd^Ftd, Ds, Ds, Wwt, Wwt, Wwt, Wot, Wot, Wot, Wot, Wwrt, Wot, Wwrt, Wot, Wot, Wot
Gd, Gs^Es, Gs, Gs, Gs, Gs^Es, Gd, Gd^Es, Gs, Gd, Gd^Fts, Gs, Gs, Gd, Gs, Gs^Es, Gs, Gs, Gd, Gd^Es, Gs, Gs^Es, Gs, Gs^Es, Arrw, Gs, Gd^Es, Gs, Gd, Gd^Var, Gs, Gs, Rd, Rd, Sm, Sm, Rd, Rd, Rd, Rd, Gd, Rd, Gd, Gd, Gd, Rd, Gd, Gd, Gs, Gs, Gd, Gd^Fts, Gd, Gd^Fts, Gd^Fts, Gd^Fts, Gd, Gd^Fts, Gd^Fts, Gd^Fts, Dd^Ftd, Dd^Ftd, Dd^Ftd, Ds, Ds, Wwt, Wwt, Wwt, Wwt, Wot, Wot, Wot, Wwrt, Wot, Wot, Wot, Wot
Gd, Gs, Gs, Gs^Es, Gd, Gs, Gs, Gs, Gs^Es, Gs, Gs, Gd, Gd^Fts, Gd, Gs, Gs, Gs, Gd^Es, Gd, Gs, Gd, Gs, Gs, Gd, Gs, Gs, Gd, Gs, Gd^Fts, Gd, Arrw, Rd, Rd, Rd, Sm, Rd, Rd, Rd, Gd, Gd, Arrw, Gs, Gd^Fts, Gs, Gd, Gs, Gs, Gs, Gs, Gs, Gd^Fts, Gd, Gd, Gd^Fts, Gd^Fts, Gd, Gd^Fts, Gd^Fts, Gd^Fts, Gd^Fts, Gd^Fts, Dd^Ftd, Dd^Ftd, Ds, Ds, Wwt, Wwt, Wwt, Wwt, Wwt, Wwt, Wot, Wot, Wot, Wot, Wwrt, Wot
Gd^Fts, Gd^Fts, Gd^Fts, Gs, Gs, Gd^Fts, Gs, Gs, Gd, Gs, Gd, Gd, Gd, Gs, Gd, Gd^Es, Gd, Gd, Gs, Gd, Gs, Gd, Arrw, Gs, Gd, Gd^Fts, Gs^Es, Gs, Gd^Fts, Gs, Rd, Rd, Rd, Sm, Rd, Rd, Rd, Gs, Gd, Gs, Gs, Gs, Gd^Fts, Gd^Fts, Gd, Gs, Gs, Gd^Fts, Gs, Gs^Es, Gs, Gd^Fts, Gs, Gd, Gd^Fts, Gd, Gd^Fts, Gd, Gd, Gd^Fts, Gd^Fts, Gd^Fts, Dd^Ftd, Dd^Ftd, Ds, Ds, Wwt, Wwt, Wwt, Wwt, Wwt, Wwt, Wwt, Wot, Wot, Wwrt, Wot
Gd, Gd, Gd, Gs, Gd, Gs, Gd^Fts, Gs, Gd, Gd^Es, Gs^Es, Gs, Gd^Es, Gd, Gd, Gd, Gs, Gd, Gd, Gd^Fts, Gd^Fts, Gd, Gs, Gs, Gd, Gd^Fts, Gd^Fts, Gs^Es, Gd, Rd, Rd, Rd, Wwt, Sm, Rd, Rd, Gs, Gd^Fts, Gd^Fts, Gd, Gs, Gs, Gd^Fts, Gs, Gs, Gs, Gs, Gd, Gd^Es, Gd, Gs, Gs, Gd, Gd, Gd, Gd^Fts, Gs, Gd^Fts, Gd, Gd^Fts, Gd^Fts, Gd^Fts, Dd^Ftd, Dd^Ftd, Ds, Ds, Ds, Wwt, Ds, Ds, Ds, Wwt, Wwt, Wwt, Wwrt, Wot, Wot
Rd, Rd, Rd, Gd, Gd, Gd, Gd, Gs, Gd^Fts, Gs, Gs, Gs^Es, Gd^Fts, Gd, Gd^Fts, Gd^Fts, Gs, Gs, Arrw, Gd, Gd, Gd^Fts, Gs, Gd^Fts, Rd, Gs, Gd, Gs, Rd, Rd, Rd, Sm, Rd, Rd, Rd, Arrw, Gs, Gs, Gs, Gd, Gs, Gd, Gd, Gd, Gs, Gd^Fts, Gd, Gs, Gs, Gs, Gs, Gd, Gs, Gs^Es, Gs, Gd, Gs, Gd, Gd^Fts, Gd^Fts, Gd^Fts, Gd, Gd, Dd^Ftd, Ds, Ds, Ds, Ds, Dd^Ftd, Ds, Ds, Wwt, Wwt, Wwt, Wwt, Wwrt, Wwrt
Rd, Rd, Rd, Rd, Rd, Rd, Rd, Gd, Rd, Gd^Fts, Gd, Gd, Gd, Gd, Gd, Gd^Fts, Gd, Gs, Gd, Gd, Rd, Gd, Rd, Rd, Rd, Rd, Rd, Rd, Rd, Rd, Sm, Sm, Rd, Rd, Gd, Gs, Gd, Gd, Gs, Gs, Gd^Es, Gs, Gs, Gs, Gs, Gs, Gs, Gd, Gs, Gs, Gd, Gs, Gs^Es, Gs, Gs^Es, Gs, Gd, Gs, Gs, Gd^Fts, Gd, Gs, Gd, Gs, Gs, Ds, Ds, Dd^Ftd, Dd^Ftd, Dd^Ftd, Ds, Ds, Wwt, Wwt, Wwt, Wot, Wot
Sm, Sm, Sm, Rd, Rd, Rd, Rd, Rd, Rd, Rd, Rd, Rd, Rd, Gd, Rd, Rd, Rd, Rd, Rd, Rd, Rd, Rd, Rd, Rd, Sm, Rd, Rd, Rd, Rd, Rd, Sm, Rd, Rd, Rd, Gd^Fts, Gd^Fts, Gs, Gs, Arrw, Gs, Gd, Gd^Var, Gd, Gs, Gs, Gs, Gd, Gs, Gd, Gd^Fts, Gd, Gs, Gd, Gd, Gd, Gs, Gd, Gd, Gs, Gd, Gd, Gd, Gs^Es, Gd, Gd, Gd, Gd, Ds, Ds, Dd^Ftd, Dd^Ftd, Ds, Ds, Wwt, Wwt, Wot, Wot
Rd, Rd, Rd, Sm, Wwt, Wwt, Wwt, Rd, Rd, Rd, Rd, Rd, Rd, Rd, Rd, Rd, Rd, Rd, Rd, Rd, Wwt, Rd, Sm, Sm, Rd, Sm, Wwt, Rd, Sm, Sm, Rd, Rd, Rd, Gd, Gd, Gs, Gd, Gs, Gs, Gs, Gs, Gs, Gs, Gd, Gd, Gd^Es, Gd, Gs^Es, Gs^Es, Gs, Gs, Gs, Gs, Gd, Gd^Es, Gs, Gs^Es, Gd^Es, Gs, Gs, Gs, Gd, Gs, Gd, Gd, Gd, Gd, Gd, Ds, Dd^Ftd, Dd^Ftd, Ds, Ds, Wwt, Wwt, Wwt, Wwt
Rd, Rd, Rd, Rd, Rd, Wwt, Rd, Sm, Sm, Rd, Sm, Sm, Wwt, Wwt, Sm, Sm, Sm, Sm, Sm, Sm, Rd, Wwt, Rd, Rd, Rd, Rd, Rd, Wwt, Rd, Rd, Rd, Rd, Gd, Gd^Fts, Gs, Gd, Gd^Es, Gs, Gd, Gd, Gd^Es, Gs, Gd, Gd, Gs, Gd, Gd, Gs, Gs, Gs, Gd, Gs^Es, Gs, Gd, Gs, Gd, Gd, Gs, Gd, Gs^Es, Gd, Gs, Gs, Gd^Es, Gd^Es, Gd, Gd, Gs, Gs, Ds, Dd^Ftd, Dd^Ftd, Ds, Wwt, Wwt, Wwt, Wwt
Gd, Gd, Gd, Rd, Rd, Rd, Rd, Rd, Rd, Sm, Rd, Rd, Rd, Rd, Rd, Rd, Rd, Rd, Rd, Rd, Rd, Rd, Rd, Rd, Gd, Rd, Rd, Rd, Rd, Rd, Gd, Gd, Gd, Gd, Gs, Gs, Gs, Gs, Gd, Gs, Gd, Gs, Gd, Gd^Fts, Gs, Gs, Gd, Gs, Gd, Gs, Gs^Es, Gd, Gs, Gs, Gd^Fts, Gd, Gd^Fts, Gs, Gs, Gs, Gd, Gd^Es, Gd^Var, Gs, Gs, Gs, Gd^Es, Gd^Es, Gs, Gd, Ds, Ds, Ds, Wwt, Ds, Ds, Ds
Gs, Gs, Gd, Gd, Gd, Rd, Gd, Rd, Rd, Rd, Rd, Rd, Rd, Rd, Rd, Rd, Rd, Rd, Rd, Rd, Gd, Rd, Gd^Fts, Gd^Fts, Gd^Fts, Gs, Gd^Fts, Rd, Gd^Fts, Gd^Fts, Gd, Gd^Fts, Gs, Gd, Gs, Gs^Es, Arrw, Gs, Gs, Gs, Gs^Es, Gd, Gs, Gs, Gs, Gs, Gd, Gd^Fts, Gd, Gd, Gs, Gs, Gs, Gs, Gs, Gd^Fts, Gs, Gs, Gs, Gd, Gs, Gd, Gs, Gd, Gd, Gd, Gs^Es, Gd, Gd, Gs, Ds, Ds, Ds, Ds, Dd^Ftd, Dd^Ftd, Dd^Ftd
Gd^Fts, Gd^Fts, Gd, Gs^Es, Gd, Gd, Gd^Fts, Gs, Gd, Rd, Gs, Gd, Gs, Gd, Gs, Gd, Gd^Fts, Gd, Gd^Fts, Gs, Gs, Gd^Fts, Gs, Gs, Arrw, Gd^Fts, Arrw, Gs, Gs, Gs, Gs, Gs, Gs, Gs, Gs, Gs, Gs, Gs, Gd, Gs, Gs, Gs, Gd^Es, Gs^Es, Gs^Es, Gs, Gd, Gd^Es, Gs, Gs, Gs, Gs, Gd^Fts, Gd^Fts, Gs, Gs, Gd, Gd, Gs, Gd, Gs, Gs, Gd, Gd, Gs, Gs, Gs, Gd^Es, Gd, Gs, Gd, Ds, Dd^Ftd, Dd^Ftd, Dd^Ftd, Dd^Ftd, Dd^Ftd
Gd, Gs, Gd, Gd, Gd^Fts, Gs, Gs, Gd, Gd, Gs, Gd, Gd^Fts, Gd, Gd, Gs^Es, Gs, Gd, Gs, Gs, Arrw, Gd^Es, Gs, Arrw, Arrw, Arrw, Arrw, Arrw, Arrw, Arrw, Gs, Gd^Es, Gs, Arrw, Arrw, Arrw, Gd, Gs, Gd, Gs, Arrw, Gs, Gs^Es, Re^Vct, Gd, Gd^Es, Ce, Ce, Ce, Ce, Gs, Gd, Re^Vct, Gs, Gs, Gs, Gs, Gd, Gd, Gs^Es, Gs, Gd, Gd^Es, Gs^Es, Gs, Gd^Fts, Gs, Gd^Fts, Gs, Gs, Gd, Gd^Fts, Gd^Fts, Gd, Dd^Ftd, Gd^Fts, Dd^Ftd, Gd
Gs, Gd, Gd^Fts, Gd^Fts, Gd, Gs, Gd, Gd^Fts, Gd, Gs, Gd^Fts, Gs, Gs, Gs, Gs, Gs^Es, Gs^Es, Gs, Gd, Gs, Gd, Gs, Arrw, Arrw, Gs, Arrw, Gs, Arrw, Arrw, Gs, Gd, Gs, Gs, Arrw, Arrw, Gd, Gd^Es, Gd^Es, Gs, Gs, Gs, Gs, Gs, Gs, Gs^Es, Gs, Ce, Ke, Ce, Gs, Gd, Gd, Gs, Gs, Gd, Gd^Es, Gs, Gd, Gs, Gd, Gs, Gd, Gd, Gs, Gd, Gd, Gd^Fts, Gs, Gs, Gd, Gd^Fts, Gd^Fts, Gd^Fts, Gd^Fts, Gd^Fts, Gd^Fts, Gd^Fts
Gs^Es, Gd, Gd^Fts, Gs, Gd^Es, Gs^Es, Gs, Gd, Gd^Fts, Gd, Gs, Gd, Gs^Es, Gs, Gs, Arrw, Gs, Gd, Gd^Es, Gd^Fts, Gs, Gs, Gs, Gs, Gd, Gd, Gd^Fts, Gs, Gd, Gs, Gs, Gs^Es, Gs, Arrw, Arrw, Gs, Gs, Gs, Gd, Gs, Arrw, Gs, Gs, Gs, Gd, Ce, Gs, Ce, Gs, Ce, Gd, Gd^Fts, Re^Vct, Gs, Gd, Gs, Gd, Gs, Gd, Gs, Gd^Es, Gs, Gd, Gd^Es, Gs, Gs, Gs, Gs, Gd, Gd^Fts, Gd^Fts, Gd, Gd, Gd^Fts, Gd^Fts, Gd^Fts, Gd
Gs, Gs, Gd, Gd^Fts, Gs, Gs, Gs, Gs, Gs, Gd, Gs, Gs, Gs, Gd, Gd, Gs, Gs, Gd, Gd^Fts, Gs, Arrw, Gd, Gd^Fts, Gd, Gs, Gs, Gs, Gd^Es, Gs, Gd, Gd^Fts, Gd, Gs, Arrw, Arrw, Gs, Gs, Gs, Gd, Gs, Gs, Gs, Gs, Gs, Gd, Gd, Gd^Fts, Ce, Gs, Gs, Gd, Gs, Gs, Gs, Gs, Gs, Gd, Gs^Es, Gd, Gs, Gs, Gs, Gs, Gd, Gs, Gd^Es, Gd, Gs^Es, Gd^Fts, Gd^Fts, Gd^Fts, Gd^Fts, Gd^Fts, Gd^Fts, Gd^Fts, Gd^Fts, Gd
Gd, Gd^Es, Gs, Gs, Gs, Gd, Gd^Fts, Gd^Fts, Gs, Gs, Gs, Gs, Gs, Gs, Gs, Gd^Fts, Gs, Gs, Gd, Gd, Gs, Gs, Gd, Gs^Es, Gd, Gs, Arrw, Gs, Arrw, Gs, Gs, Gd, Gs^Es, Gs, Gs, Gs, Gs, Gs^Es, Gd^Es, Gs, Gd, Gd, Gs, Re^Vct, Gs, Gd, Gd, Gd, Gs, Gd, Gd, Gs^Es, Gs, Gs, Gd, Gs, Gd, Gd, Gs^Es, Gd^Var, Gd, Gd^Es, Gd, Gd, Gs, Gs, Gs, Gs^Es, Gd^Fts, Gd, Gd^Fts, Gd^Es, Gd, Gd^Fts, Gd^Fts, Gd^Fts, Gd
Gd, Gs, Gs, Gd^Fts, Gs, Gs, Gs, Gd, Gs, Gs^Es, Gs, Arrw, Gs, Gs^Es, Gs, Gs, Gs, Gs, Gs, Gd, Gd, Gs, Gs, Gs, Arrw, Arrw, Arrw, Arrw, Arrw, Arrw, Arrw, Gd, Gd^Fts, Gd^Es, Gs, Arrw, Arrw, Gs, Gd, Gs, Gs, Gd, Gs^Es, Gs, Gd, Gs, Gd, Re^Vct, Gs^Es, Gs, Gs, Gd, Gs^Es, Gs, Gd, Gs, Gs, Gs, Gs, Gd, Gs, Gd, Gs, Gd^Fts, Gd, Gd^Fts, Gs, Gd, Gd^Fts, Gd, Gd, Gd^Fts, Gd^Fts, Gd^Fts, Gd^Fts, Gd^Fts, Gd
Gs, Gd^Fts, Gd, Gd, Gs, Gd^Fts, Gd, Gd, Gd, Gs^Es, Gs, Gs, Gs, Gs, Gs, Gs, Arrw, Arrw, Arrw, Gd, Gd^Fts, Gd^Fts, Gs, Arrw, Arrw, Arrw, Gd^Kov, Gs^Cov, Gd^Cov, Arrw, Arrw, Gs, Gd, Gs, Gd, Gs, Arrw, Arrw, Gd, Gs, Gs, Gd^Es, Gd, Gs, Gs, Gd, Gd^Es, Gs, Gs, Gs, Gs, Gs, Gs, Gd, Gd, Gs, Gs, Gs^Es, Gd, Gs, Gd, Gs, Gs, Gs, Gs, Gs, Gs, Gd, Gd, Gd, Gd^Fts, Gd, Gd^Fts, Gd^Fts, Gd^Fts, Gd, Gd
Gs, Gd^Fts, Gs, Gd, Gs, Gd, Gd, Gd^Var, Gs^Es, Gd, Gs, Gs, Gs, Arrw, Gs, Gs, Arrw, Arrw, Gs, Gd, Gd, Gs, Arrw, Arrw, Gd^Cov, Gd^Cov, Gd^Cov, Gd^Cov, Gd^Cov, Arrw, Arrw, Gs, Gd, Gd^Fts, Gs, Gs, Arrw, Arrw, Gs, Gd, Gs, Gs, Gs, Gs, Gs, Gd, Gs, Gs, Gd^Fts, Gd^Fts, Gs, Gs, Gs, Gs, Gd, Gd, Gs, Gd, Gs, Gs, Gd, Gs, Hhd, Hhd, Hhd, Hhd, Gs, Gs^Es, Gd, Gd, Gd^Fts, Gd^Fts, Gd^Fts, Gd^Es, Gd, Gd^Fts, Gs
Gs, Gs, Gs, Gs, Gd, Gs^Es, Gs, Gd, Gs, Gs^Es, Gs, Gd, Gd, Gd, Gs^Es, Gs, Arrw, Arrw, Gs, Gd^Es, Gd, Gs, Arrw, Arrw, Gs, Gd^Cov, Gs^Cov, Gd^Cov, Gd, Arrw, Arrw, Gs, Gd, Gs, Gs, Arrw, Arrw, Arrw, Gs, Gs, Gd, Gd, Gs, Gs, Gd, Gs, Gs, Gs^Es, Gs, Gs, Gd^Fts, Gs, Gs, Gd, Gd, Gs, Gs^Es, Gd, Gs, Gd, Gs, Gd^Fts, Gd^Fts, Hhd^Fts, Hhd^Fts, Hhd, Gs, Gd, Gs^Es, Gd, Gd, Gd, Gd^Fts, Gd^Fts, Gd^Fts, Gd^Fts, Gs
Gs, Gs, Gd^Es, Gs, Gs, Gs, Gd, Gd, Gs^Es, Gd, Gd, Gd, Gs, Gd, Gs, Gs, Arrw, Arrw, Arrw, Gs, Gd, Gd^Fts, Gd, Arrw, Arrw, Gs, Gd, Gd, Gs, Arrw, Arrw, Arrw, Gs, Gd, Gs, Arrw, Arrw, Gs, Gd, Gd, Gs, Gd, Gs, Gd^Fts, Gd, Gs, Gd^Fts, Gd, Gd, Gs, Gd^Fts, Gs, Gs, Gs^Es, Gs, Gd, Gs, Gs, Gs, Gd, Gs, Gd^Fts, Hhd, Hhd^Fts, Hhd, Hhd, Gs, Gs, Gs, Gs, Gs, Gd^Fts, Gd, Gd^Es, Gs^Es, Gd, Gd
Gs, Gd^Es, Gs, Gd, Gd^Fts, Gs, Gs^Es, Gs, Gs, Gd, Gs, Gs, Arrw, Gs, Gs, Gs, Gs, Arrw, Arrw, Gs, Gs^Es, Gd, Gs, Arrw, Arrw, Gs, Gs, Gd, Gs, Gs, Gs, Gs, Gd, Gs, Gs, Arrw, Gs, Gs, Gd, Gs, Gs, Gs, Gs, Gd^Fts, Gs, Gd, Gd^Fts, Gs, Gs, Gs, Gs, Gs, Gd^Fts, Gs, Gs, Gs, Gs^Es, Gs, Gs^Es, Gd, Gs, Gs, Gs, Hhd, Gs, Gs, Gd, Gd, Arrw, Arrw, Gd^Var, Gd, Gs, Gd, Gd, Gs, Gs
Gd, Gs, Gs, Gs, Gd, Gs, Gd, Gs, Gs, Gs, Gd, Gs, Gs, Gs, Gs, Gd, Gs, Arrw, Arrw, Arrw, Arrw, Gs, Gs, Gs, Gd, Gd, Gs, Gd, Gd, Gs, Gd^Es, Gs, Gs, Gs^Es, Gs, Gd, Gs, Gs^Es, Gd, Gs, Gs^Es, Gd, Gd, Gs, Gs, Gd, Gs, Gs^Es, Gd, Gs, Gs, Gd^Fts, Gs, Gd, Gs, Gs, Gs^Es, Gd^Es, Gd, Gd, Gd, Gs^Es, Gd, Gd, Gd, Gs, Gd, Gs, Gd, Arrw, Gd, Gd, Arrw, Gd, Gs, Arrw, Gs
Gs^Es, Gs^Es, Gs, Gs, Gd^Es, Gd, Gd, Gd, Gd, Re^Vct, Gd, Gs^Es, Gs^Es, Gd^Es, Re^Vct, Gd^Es, Gd, Gd, Gs, Arrw, Arrw, Gs, Gs^Es, Gd, Gs, Gs, Gs, Gs^Es, Gd, Gs, Gs, Gs, Arrw, Gd, Gd^Es, Gd, Gd, Gs, Gs, Gd^Fts, Gs, Gs^Es, Gs, Gd^Es, Gs, Gs, Gs, Gs, Gd, Gd^Es, Gs, Gs, Gd^Fts, Gs, Gd, Gs, Gs, Gs, Gs, Gs, Gs, Gd^Es, Gs, Gs^Es, Gd, Gd, Gd^Cov, Gd^Fts, Gd^Fts, Gd, Gs, Gd, Gs, Gd, Gd^Fts, Gs, Gs
Gd, Gs, Gd^Fts, Gd, Gd, Gs, Gs, Gd^Fts, Gd, Gd^Es, Gd, Gs, Gs, Gs, Gs, Gs, Gs, Gs, Gd, Gs, Gd, Gd, Gs, Gs, Arrw, Gs, Arrw, Gs, Gs, Gd, Gd, Arrw, Arrw, Gs, Gs, Gs^Es, Gs, Gs, Gs^Es, Gd^Fts, Gs, Gs, Gd^Es, Gd, Gs, Gd^Fts, Gs, Gs, Gd, Gs, Gs, Gd, Gs, Gs, Gs, Gd, Gd^Fts, Gs, Gd, Gd^Es, Gd, Gs, Gd^Fts, Gd, Gd, Gd^Cov, Gs^Kov, Gd^Cov, Gd^Fts, Gs, Arrw, Gs, Gd^Es, Gs, Gd, Gs, Gs
Gd, Gd, Gd, Gs, Gs, Gd, Gs, Gs, Gd, Gd, Gs, Gd^Fts, Gd, Gs, Gs, Gd, Gs, Gs^Es, Gd, Gs, Gd, Gd, Gs, Arrw, Arrw, Arrw, Arrw, Arrw, Gs, Gs, Gd, Gs, Gs, Gd, Gd, Gs, Gd^Fts, Gs, Gd, Gs, Gd^Es, Gs, Gs, Gs, Gs, Gs, Hhd, Hhd, Gs, Gs, Gs, Gs^Es, Gs, Gs, Gd^Es, Gs, Gs, Gs, Gd, Gd, Gs, Gs, Gs, Gs, Gs, Gs^Cov, Gd^Cov, Gd^Cov, Gs, Gs, Gd, Gd, Gs, Gs, Gs, Gd, Gs
Gd, Gs, Gs, Gs, Gs^Es, Re^Vct, Gd, Gd^Es, Gs, Gd, Ce, Gs, Gd, Gs, Gd, Gd^Fts, Gd, Gs, Gd, Gd, Gd, Gs^Es, Arrw, Arrw, Gd^Var, Gd, Gs, Arrw, Gs, Gs, Gd^Es, Gs, Gs, Gs, Gd, Gs, Gd^Fts, Gd, Gs, Gd, Gd, Gs, Gd^Fts, Gs, Gs, Hhd, Gd, Hhd, Hhd, Gs, Gd^Fts, Gd^Fts, Gd^Var, Gs, Gs, Gd, Gs, Gs, Gd^Es, Gs, Gs, Gs, Gs, Gs^Es, Gs^Es, Gd, Gd^Fts, Gd, Gs, Gd, Gs, Gd, Gs, Arrw, Gs, Gs^Es, Gd
Gd, Gs^Es, Gs, Gd, Gd, Gs, Gs, Gd^Es, Ce, Gs, Ce, Gd, Ce, Gs, Gs, Gs^Es, Gd^Es, Gs, Gd^Fts, Gs, Gs, Gs, Arrw, Arrw, Gs, Gd, Gs^Es, Gs, Gs, Gd, Gs, Gs, Gs^Es, Arrw, Gs^Es, Gd, Gd, Gd, Gs, Gd^Fts, Gd, Gs, Gs, Gd^Fts, Gs, Hhd, Gs, Hhd, Hhd, Gd^Fts, Gs^Es, Gs, Hhd, Gd^Fts, Hhd, Gd, Gd, Gs, Gs, Gs, Gs, Arrw, Arrw, Gs, Gs, Gs, Gs, Gs, Gd^Es, Gs, Gd, Gd^Fts, Gs, Gs, Gd^Es, Gd, Gs
Gd, Gs, Gs, Gd, Gd, Gd, Gd, Gs, Gd, Ce, Ke, Ce, Gs, Gs, Gd, Re^Vct, Gs, Gs, Gd, Gd^Fts, Gs, Gd, Gs, Gs, Gs, Gd^Es, Gd, Gs, Gd^Es, Gs, Arrw, Gd, Gd, Gs, Gd, Gd, Gs, Gs, Gs, Gd^Fts, Gs, Gs, Gs, Gs, Gs, Gd^Es, Gd, Hhd, Gd^Fts, Gs, Gs^Es, Gs, Gs, Hhd, Gs, Gs, Gs^Es, Gs, Gd^Fts, Gs, Gs, Arrw, Arrw, Gs, Gs, Gs, Gd, Gd, Gs, Gs, Gd^Fts, Gd, Gd^Fts, Gd, Gs, Gd, Gs
Gs, Gd, Gs, Gs^Es, Gs, Gd^Fts, Re^Vct, Gd, Gd, Ce, Ce, Ce, Ce, Gs, Gd^Es, Gs, Gs, Gd, Gs^Es, Gd, Gd^Fts, Gd, Gd, Gs^Es, Gs, Gd, Gd^Fts, Gs, Gd, Gs, Gs, Gs, Gs, Gd, Gs, Gs, Gd^Fts, Gd, Gd, Gd, Gd, Gd, Gd^Fts, Gd^Fts, Gs, Gs^Es, Gd, Hhd, Gs, Gd^Fts, Gs, Gs, Gd^Fts, Gs, Gs^Es, Gd, Gd, Gs, Gs, Gs, Arrw, Arrw, Arrw, Arrw, Gs, Gd, Gd, Gs, Gs, Gs, Gd, Gd, Gd^Fts, Gs, Gd^Es, Gs, Gs
Gs, Gd, Gd^Es, Gd, Gs, Gs, Gd, Gd, Gs, Gd, Gs, Gs, Gs, Gs, Gs, Gs, Gd, Gd^Fts, Gs, Gs, Gs, Gs, Gs, Gd, Gd, Gs, Gs, Gs, Gs^Es, Gd, Gs, Gs, Gs^Es, Gs, Gs, Gs, Gs, Gs, Gs, Gd^Fts, Gd, Gs, Gs, Gs, Gs, Gs, Gs, Gs, Gs, Gs, Gd^Fts, Gs, Gd^Fts, Gs, Gs, Gs^Es, Gs, Gs, Gs, Gs, Arrw, Arrw, Arrw, Arrw, Gs, Gs, Gd, Gs^Es, Gs, Gs, Gd^Fts, Gs, Gs, Gd, Gd^Es, Gs, Gs
Gs, Gs, Gs, Gd, Gd, Gd, Gs, Gs, Gs, Gd, Gs, Gs, Gd, Gs, Gs, Gd, Gs, Gs, Gs, Gs, Gs, Gs, Gs, Gs, Gs, Gs, Gs, Gs, Gs, Gs, Gs, Gd^Es, Gs, Gd, Gd, Gs, Gs, Gd^Fts, Gs, Gs, Gs, Gd, Gs, Gd^Fts, Gs, Gd^Fts, Gs, Gd^Fts, Gd^Fts, Gs, Gs, Gs, Gd^Fts, Gd^Fts, Gd^Fts, Gs, Gd^Fts, Gs, Arrw, Arrw, Arrw, Arrw, Arrw, Arrw, Arrw, Gs, Gs, Gs, Gd^Fts, Gs, Gs, Gs, Gs, Gs, Gd, Gd, Gs
