Gd^Fts, Gd^Fts, Gd, Gd^Fts, Gd^Fts, Gd^Fts, Gd, Gd^Fts, Gs, Gs, Gs^Es, Gd^Es, Gs, Gs, Gs, Gs, Gs, Gs, Gs, Gd^Es, Gs, Gs, Gs, Gs, Gs, Gs, Gd, Gs^Es, Gd, Gs, Gs, Gs^Es, Gd^Es, Gs, Gd, Gs, Gd^Fts, Gs, Gs^Es, Gs, Gs, Gs, Gd^Fts, Gs, Gs, Gs, Gs, Gs, Gd^Fts, Gd^Fts, Gd^Fts, Gs, Gs, Gs
Gs, Gd^Fts, Gs, Gd^Es, Gs, Gd, Gd^Fts, Gd^Fts, Arrw, Gd^Fts, Gd^Fts, Gd^Es, Arrw, Arrw, Gs, Gs, Gs, Gd, Gs, Gs, Gd, Gd, Gd, Arrw, Arrw, Gd^Fts, Gs, Gd, Gs^Es, Gs, Gd^Fts, Gs, Gs, Gd, Gs, Gd^Fts, Gs^Es, Gs, Gs^Es, Gs^Es, Gs, Gs, Gd^Fts, Gd^Fts, Gd, Gd^Fts, Gd^Fts, Gs, Arrw, Gs, Gd^Fts, Gd^Fts, Gs^Es, Gd^Es
Gd^Es, Gd^Es, Gs, Gd^Fts, Gd, Gd^Fts, Gd^Fts, Gd^Fts, Gd^Fts, Gd^Fts, Gd^Var, Gd^Fts, Arrw, Gs, Gd^Fts, Gd^Fts, Gd^Es, Gs, Gd, Gs, Gd, Gd, Gs, Gs, Arrw, Arrw, Gs, Gd, Gd, Gd, Gd^Fts, Gs, Gd^Es, Arrw, Gs, Gs, Gs, Gs, Gd^Fts, Gs, Gs, Gs^Es, Gd^Fts, Gd, Gs, Gd^Fts, Arrw, Arrw, Arrw, Arrw, Gd^Fts, Gd^Fts, Gd^Es, Gd
Ss, Gs, Gs, Gs, Gs^Es, Gd, Gd^Es, Gs, Gs, Arrw, Gd^Fts, Gd^Fts, Gs, Arrw, Gs, Gs, Gs, Gs, Ce, Ce, Ce, Gd^Es, Gd^Es, Gs, Gd, Gd, Gs, Gd^Fts, Gd, Gd^Var, Gd^Fts, Gs^Es, Gd^Es, Gd^Fts, Gd^Fts, Gs, Gd, Gd^Fts, Gs, Gs, Gd^Fts, Gs, Gs^Es, Gs, Gd^Fts, Gs, Arrw, Arrw, Arrw, Arrw, Arrw, Gs, Gd^Fts, Gd
Wwt, Ss, Ss, Ss, Ss, Gd^Es, Gs, Gd^Es, Gd^Fts, Gs, Gd, Gs, Arrw, Arrw, Gs, Gd^Fts, Gs, Gd, Ce, 1 Ke, Ce, Gd, Gd, Gs, Gd, Gs, Gd^Fts, Gs, Gs, Gs, Gd, Gs, Gs, Gd^Es, Gs, Gd^Fts, Gs, Gd, Gs, Gd^Fts, Gd^Fts, Gd, Gs, Gd^Fts, Gs, Gd^Fts, Gd^Es, Gd^Fts, Arrw, Arrw, Arrw, Gs, Gd^Fts, Gd^Fts
Wwt, Wwt, Wwt, Wwt, Wwt, Ss, Gs, Gs, Gd^Fts, Gd^Fts, Gd^Es, Gs^Es, Gd, Gd^Fts, Gd, Gs, Gd^Fts, Ce, Ce, Ce, Ce, Ce, Gd, Gd, Gd, Arrw, Arrw, Gd^Fts, Arrw, Gs, Gd, Gd^Fts, Gs, Gd^Es, Gd^Fts, Arrw, Gs, Gd^Fts, Gd^Fts, Gd, Gs^Es, Gd, Gd^Fts, Gd^Fts, Gd^Fts, Gd^Fts, Gs, Gd^Es, Gs, Arrw, Arrw, Arrw, Arrw, Arrw
Wwt, Wwt, Wwt, Wwt, Wwt, Ds, Ds, Ds, Ds, Gd, Gs, Gs, Gd, Gd^Es, Gs^Es, Gd, Gs^Es, Gd, Gd, Gs, Gd^Es, Gd, Gs, Gs, Ds, Gs, Gd, Arrw, Gs, Gs, Gd, Gs, Gd, Gs, Gd^Fts, Gs, Gs, Gd^Fts, Gs^Es, Gs, Gs, Gs, Gs, Gd^Var, Gs, Gd^Fts, Gd^Fts, Gd, Gd^Fts, Arrw, Arrw, Arrw, Arrw, Arrw
Ss, Wwt, Wwt, Wwt, Wwt, Ds, Ds, Ds, Ds, Ds, Ds, Ds, Ds, Gs, Ds, Gs, Gd, Gs, Gs, Gd, Gs, Gs, Ds, Ds, Ds, Ds, Ds, Gd, Gs, Gs, Ds, Gs^Es, Gd, Gs, Gd^Var, Gd^Fts, Gs, Gd^Fts, Gd^Es, Gd, Gs, Gd^Fts, Gs, Gd, Gd^Fts, Gd^Fts, Gs, Gd^Fts, Gd^Fts, Gs, Gs, Arrw, Gs, Gd^Fts
Gd, Ds, Wwt, Wwt, Wwt, Wwt, Ds, Ds, Wwt, Ds, Ds, Ds, Ds, Ds, Ds, Ds, Ds, Gd, Gd, Gs, Gs, Ds, Ds, Ds, Wwrt, Ds, Ds, Ds, Ds, Ds, Ds, Ds, Ds, Gd, Gs, Gd^Fts, Arrw, Gd, Gd, Gs, Gs, Gd^Fts, Gs^Es, Gs^Es, Gs, Gd^Fts, Gs, Gd^Fts, Gd^Fts, Gd, Gd^Fts, Gs, Gd^Fts, Gs
Gd^Fts, Ds, Ds, Wwt, Wot, Wwt, Wwt, Wwt, Wwt, Wwt, Wwt, Wwt, Wwt, Ds, Wwt, Ds, Ds, Ds, Ds, Ds, Ds, Ds, Wwf, Wwrt, Wwrt, Wwrt, Wwt, Ds, Ds, Ds, Wwt, Ds, Ds, Gd, Gs, Gd^Fts, Gd^Fts, Gd^Fts, Gd, Gd^Fts, Gs, Gs, Gd, Gd^Fts, Gs, Gs, Gd^Fts, Gs, Gd^Fts, Gd, Gd, Gs, Gd, Gs
Gd^Fts, Ds, Ds, Wwt, Wot, Wot, Wot, Wot, Wwt, Wwt, Wwt, Wwt, Wwt, Wwt, Wwt, Wwt, Wwt, Ds, Ds, Ds, Ds, Wwf, Wwf, Wwf, Wwrt, Wwrt, Wwt, Wwt, Wwt, Wwt, Wwt, Ds, Ds, Gs, Gd, Gs, Gs, Gs, Gd^Es, Gs^Es, Gs, Gd, Gs, Gs^Es, Gs, Gd, Gs, Gs, Gs, Gs, Gd^Es, Gd, Gd, Gs
Gd, Gd, Ds, Wwt, Wwt, Wot, Wot, Wot, Wot, Wwt, Wot, Wot, Wwt, Wwt, Wwt, Wwt, Wwt, Wwt, Wwt, Wwt, Wwrt, Wwrt, Wwf, Wwf, Wwrt, Wwrt, Wwt, Wwt, Wwt, Wwt, Wwt, Ds, Ds, Ds, Ds, Gd, Gd, Gd, Gs, Gs, Ds, Ds, Ds, Gs, Ds, Gd, Gd^Es, Gs, Gd^Es, Gd, Gd, Gs, Ds, Ds
Ds, Ds, Ds, Wwt, Wwt, Wot, Wot, Wwt, Wot, Wwt, Wwt, Wot, Wot, Wwt, Wot, Wwt, Wot, Wwt, Wwt, Wwt, Wwrt, Wwrt, Wwf, Wwf, Wwf, Wwrt, Wwrt, Wwt, Wot, Wwt, Wwt, Wwt, Ds, Ds, Ds, Ds, Ds, Ds, Ds, Ds, Ds, Ds, Ds, Ds, Ds, Ds, Ds, Gd, Gs, Gs, Ds, Ds, Ds, Ds
Ds, Ds, Wwt, Wwt, Wwt, Wot, Wwt, Wot, Wwt, Wwt, Wot, Wwt, Wot, Wot, Wwt, Wwt, Wot, Wwt, Wot, Wwt, Wwt, Wwrt, Wwrt, Wwf, Wwf, Wwrt, Wwrt, Wwt, Wwt, Wwt, Wwt, Wwt, Wwt, Ds, Wwt, Ds, Ds, Ds, Ds, Ds, Wwt, Wwt, Wwt, Ds, Wwt, Ds, Ds, Ds, Ds, Ds, Ds, Ds, Wwt, Wwt
Wwt, Wwt, Wwt, Wwt, Wot, Wwt, Wwt, Wot, Wot, Wwt, Wot, Wwt, Wwt, Wot, Wot, Wwt, Wot, Wwt, Wwt, Wwt, Wwt, Wwrt, Wwrt, Wwrt, Wwf, Wwf, Wwrt, Wwrt, Wwt, Wwt, Wot, Wwt, Wwt, Wwt, Wwt, Wwt, Wwt, Wwt, Wwt, Wwt, Wwt, Wwt, Wwt, Wwt, Wwt, Wwt, Wwt, Ds, Ds, Ds, Wwt, Wwt, Wwt, Wwt
Wwt, Wwt, Wwt, Wwt, Wot, Wwt, Wwt, Wwt, Wot, Wot, Wot, Wot, Wot, Wwt, Wwt, Wwt, Wwt, Wwt, Wot, Wot, Wot, Wwt, Wot, Wwrt, Wwf, Wwf, Wwrt, Wwrt, Wwt, Wwt, Wot, Wwt, Wwt, Wwt, Wwt, Wwt, Wwt, Wwt, Wwt, Wwt, Wwt, Wwt, Wwt, Wwt, Wwt, Wwt, Wwt, Wwt, Wwt, Wwt, Wot, Wwt, Wwt, Wwt
Wwt, Wot, Wwt, Wot, Wot, Wot, Wot, Wot, Wot, Wot, Wot, Wot, Wot, Wot, Wot, Wot, Wot, Wot, Wot, Wot, Wot, Wot, Wot, Wwrt, Wwf, Wwf, Wwrt, Wwrt, Wwt, Wwt, Wot, Wwt, Wot, Wwt, Wot, Wwt, Wot, Wot, Wot, Wwt, Wwt, Wot, Wot, Wot, Wwt, Wot, Wot, Wot, Wot, Wot, Wwt, Wwt, Ds, Wwt
Wwt, Wot, Wot, Wot, Wot, Wot, Wot, Wot, Wot, Wot, Wot, Wot, Wot, Wot, Wot, Wot, Wot, Wot, Wot, Wot, Wot, Wot, Wwrt, Wwrt, Wwf, Wwf, Wwrt, Wot, Wot, Wot, Wwt, Wot, Wot, Wwt, Wwt, Wot, Wot, Wwt, Wwt, Wot, Wot, Wwt, Wwt, Wot, Wwt, Wwt, Wot, Wot, Wwt, Wwt, Ds, Ds, Gd^Fts, Ds
Wot, Wot, Wot, Wot, Wot, Wot, Wot, Wot, Wot, Wot, Wot, Wot, Wot, Wot, Wot, Wot, Wot, Wot, Wot, Wot, Wot, Wwrt, Wwf, Wwf, Wwf, Wwf, Wwrt, Wot, Wwt, Wwt, Ds, Wwt, Wwt, Wot, Wot, Wwt, Wwt, Wot, Wot, Wwt, Wot, Wwt, Wot, Wwt, Wot, Wot, Wwt, Wwt, Wwt, Ds, Gs, Gd^Fts, Gd, Gs
Wot, Wot, Wot, Wot, Wot, Wot, Wot, Wot, Wot, Wot, Wot, Wot, Wot, Wot, Wot, Wot, Wot, Wot, Wot, Wot, Wot, Wwrt, Wwf, Wwf, Wwf, Wwrt, Wot, Wwt, Ds, Ds, Gd^Fts, Ds, Wwt, Wot, Wot, Wwt, Wot, Wot, Wot, Wot, Wot, Wot, Wot, Wot, Wwt, Wwt, Wwt, Wwt, Ds, Ds, Gd, Gd^Fts, Gd^Fts, Gd^Fts
Wot, Wot, Wot, Wot, Wot, Wot, Wot, Wot, Wot, Wot, Wot, Wot, Wot, Wot, Wot, Wot, Wot, Wot, Wot, Wot, Wot, Wwrt, Wwf, Wwf, Wwrt, Wwrt, Wot, Wwt, Ds, Gd^Var, Gs^Es, Ds, Ds, Wwt, Wot, Wot, Wot, Wot, Wot, Wot, Wot, Wot, Wot, Wot, Wot, Wwt, Wwt, Wwt, Ds, Gd, Gs, Gd^Fts, Gd^Fts, Gs
Wot, Wot, Wot, Wot, Wot, Wot, Wot, Wot, Wot, Wot, Wot, Wot, Wot, Wot, Ww^Vm, Wot, Wot, Wot, Wot, Wot, Wwt, Wwrt, Wwf, Wwf, Wwrt, Wwrt, Wwt, Wwt, Wwt, Ds, Gd^Fts, Gd^Fts, Ds, Wwt, Wot, Wot, Wot, Wot, Wot, Wot, Wot, Wot, Wot, Wot, Wot, Wot, Wot, Wwt, Ds, Gd, Gd^Fts, Gd^Fts, Gd^Fts, Gd
Wot, Wot, Wot, Wot, Wot, Wot, Ww^Vm, Wot, Wot, Wot, Wot, Wot, Wot, Wot, Wot, Wot, Wot, Wot, Wot, Wwt, Ds, Ds, Gs, Wwf, Ds, Wwt, Ds, Wwt, Wwt, Ds, Ds, Ds, Wwt, Wwt, Wwt, Wot, Wwt, Wot, Wot, Wot, Wot, Wot, Wot, Wot, Wot, Wwt, Wot, Wwt, Wwt, Ds, Gs, Gd^Fts, Gd^Fts, Gd^Fts
Wot, Wot, Wot, Wot, Wot, Wot, Wot, Wot, Wot, Wot, Wwt, Wot, Wwt, Wot, Wot, Wot, Wot, Wot, Wwt, Wwt, Ds, Gd^Fts, Gs, Gs, Gs^Es, Ds, Gd^Fts, Ds, Wwt, Wwt, Wwt, Wwt, Wwt, Wwt, Ds, Wwt, Wwt, Wot, Wot, Wot, Wot, Wot, Wot, Wot, Wot, Wot, Wwt, Wwt, Wwt, Ds, Ds, Gd, Gd, Gd^Fts
Wot, Wot, Wot, Wot, Wot, Wot, Wot, Wot, Wwt, Wwt, Ds, Wwt, Ds, Wwt, Wwt, Wot, Wot, Wwt, Ds, Ds, Gd^Fts, Gd^Fts, Gd, Gd^Es, Ds, Gd, Gd^Fts, Ds, Ds, Wwt, Wwt, Wot, Wwt, Ds, Gd^Fts, Ds, Wwt, Wwt, Wot, Wot, Wot, Wot, Wot, Wot, Wot, Wot, Wot, Wwt, Wwt, Wwt, Wwt, Ds, Ds, Gs
Wot, Wot, Wot, Wot, Wot, Wot, Wot, Wwt, Ds, Ds, Gd^Fts, Ds, Gd^Fts, Ds, Wwt, Wot, Wwt, Wwt, Ds, Gd^Var, Gs, Gd, Gs, Ds, Wwt, Ds, Gd^Fts, Gd^Fts, Gd^Fts, Ds, Wwt, Wot, Wwt, Ds, Gd^Fts, Ds, Ds, Wwt, Wwt, Wot, Wot, Wot, Wot, Wot, Wot, Wot, Wot, Wwt, Wot, Wwt, Wwt, Wwt, Ds, Gs
Wot, Wot, Wot, Wot, Wot, Wot, Wot, Wwt, Ds, Gd^Fts, Car, Gd^Fts, Ds, Ds, Wwt, Wwt, Ds, Ds, Gd^Fts, Gs^Es, Gd^Es, Gs, Ds, Ds, Wwt, Ds, Ds, Ds, Ds, Ds, Wwt, Wot, Wwt, Ds, Rr^Vd, Gd^Fts, Ds, Wwt, Wwt, Wot, Wot, Wot, Wot, Wot, Wot, Wot, Wot, Wwt, Wwt, Wot, Wwt, Wwt, Wwt, Ds
Wot, Wot, Wot, Wot, Wot, Wot, Wot, Wwt, Wwt, Ds, Kar, Car, Ds, Wwt, Wwt, Wwt, Ds, Gd^Fts, Gd^Fts, Gd, Ds, Gs, Wwf, Wwt, Wot, Wwt, Wwt, Wwt, Wwt, Wwt, Wot, Wwt, Ds, Ds, Gd, Gd^Fts, Ds, Wwt, Wot, Wot, Wot, Wot, Wot, Wot, Wot, Wot, Wot, Wot, Wwt, Wot, Wot, Wwt, Wwt, Wwt
Wot, Wot, Wot, Wot, Wot, Wot, Wot, Wwt, Wwt, Car, Ds, Car, Gd^Fts, Ds, Wwt, Wwt, Ds, Gd^Fts, Gd^Fts, Ds, Wwrt, Wwf, Wwf, Wwrt, Wwrt, Wot, Wot, Wwt, Wot, Wot, Wwt, Wwt, Ds, Gd^Fts, Gs^Es, Ds, Wwt, Wwt, Wot, Wot, Wot, Wot, Wot, Wot, Wot, Wot, Wot, Wot, Wot, Wot, Wot, Wwt, Wot, Wwt
Wot, Wot, Wot, Wot, Wot, Wot, Wot, Wot, Wot, Wwt, Ds, Gd^Fts, Gd^Fts, Ds, Wwt, Wwt, Ds, Gd^Fts, Gd^Fts, Ds, Wwrt, Wwf, Wwf, Wwf, Wwrt, Wwt, Wwt, Wwt, Wwt, Wwt, Ds, Ds, Gd^Fts, Gd^Fts, Ds, Ds, Wwt, Wot, Wot, Wot, Wot, Wot, Wot, Wot, Wot, Wot, Wot, Wot, Wot, Wwt, Wwt, Wwt, Wwt, Wwt
Wot, Wot, Wot, Wot, Wot, Ww^Vm, Wot, Wot, Wot, Wwt, Ds, Gd^Var, Ds, Ds, Wwt, Wwt, Wwt, Ds, Ds, Ds, Wwrt, Wwrt, Wwf, Wwf, Wwrt, Ds, Ds, Ds, Ds, Ds, Gd^Es, Gd, Ds, Ds, Wwt, Wwt, Wot, Wot, Wot, Wot, Wot, Wot, Wot, Wot, Wot, Wot, Wot, Wot, Wot, Wot, Wot, Wot, Wot, Wot
Wot, Wot, Wot, Wot, Wot, Wot, Wot, Wot, Wot, Wwt, Wwt, Ds, Wwt, Wwt, Wot, Wot, Wot, Wwt, Wwt, Wwt, Wwt, Wwrt, Ds, Wwf, Ds, Ds, Gd^Fts, Gd, Gd^Es, Gs, Gd^Fts, Gd^Fts, Ds, Wwt, Wwt, Wot, Wot, Wot, Wot, Wot, Wot, Wot, Wot, Wot, Wot, Wot, Wot, Wot, Wot, Wot, Wot, Wot, Wot, Wot
Wot, Wot, Wot, Wot, Wot, Wot, Wot, Wot, Wot, Wot, Wot, Wwt, Wwt, Wwt, Wwt, Wwt, Wwt, Wot, Wot, Wot, Wwt, Ds, Gd^Fts, Gs, Gs^Es, Gd^Fts, Gd^Var, Gd^Fts, Ds, Gs^Es, Ds, Ds, Wwt, Wwt, Wwt, Wot, Wwt, Wwt, Wwt, Wot, Wot, Wot, Wot, Wot, Wot, Wot, Wot, Wot, Wot, Wot, Wot, Wot, Wot, Wot
Wot, Wot, Wot, Wot, Wot, Wot, Wot, Wot, Wot, Wot, Wot, Wot, Wot, Wwt, Ds, Wwt, Wwt, Wwt, Wwt, Wwt, Wwt, Ds, Ds, Gd, Wwf, Wwf, Ds, Ds, Wwt, Ds, Wwt, Ds, Wwt, Wot, Wwt, Wwt, Ds, Wwt, Ds, Wwt, Wwt, Wot, Wot, Wot, Wot, Wot, Wot, Wot, Wot, Wot, Wot, Wot, Wot, Wot
Wot, Wot, Wot, Wot, Wot, Wot, Wot, Wot, Wot, Wot, Wot, Wot, Wwt, Wwt, Ds, Ds, Ds, Ds, Ds, Wwt, Wwt, Wwt, Wwt, Ds, Wwf, Wwf, Wwrt, Wwt, Wot, Wwt, Wwt, Wwt, Wwt, Wwt, Wwt, Ds, Gd^Es, Ds, Gd^Es, Ds, Wwt, Wot, Wot, Wot, Wot, Wot, Wot, Wot, Wot, Wot, Wot, Wot, Wot, Wot
Wot, Wot, Wot, Wot, Wot, Wot, Wot, Wot, Wot, Wot, Wot, Wot, Wwt, Ds, Gd^Fts, Gd^Fts, Gd^Es, Gd^Fts, Ds, Ds, Ds, Wwt, Wwt, Wwrt, Wwf, Wwf, Wwf, Wwrt, Wot, Wot, Wot, Wot, Wot, Wot, Wwt, Ds, Ds, Gd^Var, Ds, Ds, Wwt, Wot, Wot, Wot, Wot, Wot, Wot, Wot, Wot, Wot, Wot, Wot, Wot, Wot
Wot, Wot, Wot, Wot, Wot, Wot, Wot, Wot, Wot, Wot, Wot, Wot, Wwt, Ds, Ds, Gd^Fts, Gd^Fts, Gd^Var, Gd, Gd^Fts, Gd^Fts, Ds, Wwt, Wwrt, Wwrt, Wwf, Wwf, Wwrt, Wot, Wot, Wot, Wot, Wot, Wot, Wot, Wwt, Wwt, Ds, Ds, Wwt, Wwt, Wot, Wot, Wot, Wot, Wot, Wot, Wot, Wot, Wot, Wot, Wot, Wot, Wot
Wot, Wot, Wot, Wot, Wot, Wot, Wot, Wot, Wot, Wot, Wot, Wot, Wot, Wwt, Ds, Gd^Fts, Gd^Es, Gs, Gd^Fts, Gs^Es, Gd^Fts, Ds, Wwt, Wwrt, Wwrt, Wwf, Wwf, Wwrt, Wot, Wot, Wot, Wot, Wot, Wot, Wot, Wot, Wot, Wwt, Wwt, Wwt, Wot, Wot, Wot, Wot, Wot, Wot, Wot, Wot, Wot, Wot, Wot, Wot, Wot, Wot
Wot, Wot, Wot, Wot, Wot, Wot, Wot, Wot, Wot, Wot, Wot, Wot, Wot, Wwt, Wwt, Ds, Ds, Gd^Fts, Ds, Ds, Ds, Ds, Wwt, Wwrt, Wwrt, Wwf, Wwf, Wwrt, Wot, Wot, Wot, Wot, Wot, Wot, Wot, Wot, Wot, Wot, Wot, Wot, Wot, Wot, Wot, Wot, Wot, Wot, Wot, Wot, Wwt, Wot, Wot, Wot, Wot, Wot
Wot, Wot, Wot, Wot, Wot, Wot, Wot, Wot, Wot, Wot, Wot, Wot, Wot, Wot, Wot, Wwt, Wwt, Ds, Wwt, Wwt, Wwt, Wwt, Wot, Wwrt, Wwrt, Wwf, Wwf, Wwrt, Wwrt, Wot, Wot, Wot, Wot, Wot, Wot, Wot, Wot, Wot, Wot, Wot, Wot, Wot, Wot, Wot, Wot, Wot, Wwt, Wot, Wot, Wot, Wwt, Wot, Wwt, Wot
Wot, Wot, Wot, Wot, Wot, Wot, Wot, Wot, Wot, Wot, Wot, Wot, Wot, Wot, Wot, Wot, Wot, Wwt, Wot, Wot, Wot, Wot, Wot, Wot, Wwrt, Wwf, Wwf, Wwf, Wwrt, Wot, Wot, Wot, Wot, Wot, Wot, Wot, Wot, Wot, Wot, Wot, Wot, Wot, Wot, Wot, Wot, Wwt, Wwt, Wot, Wwt, Wot, Wwt, Wwt, Wwt, Wwt
Wwt, Wwt, Wwt, Wot, Wot, Wot, Wot, Wot, Wot, Wot, Wot, Wot, Wot, Wot, Wot, Wot, Wot, Wot, Wot, Wot, Wot, Wot, Wot, Wot, Wot, Wwrt, Wwf, Wwf, Wwf, Wwrt, Wot, Wot, Wot, Wot, Wot, Wot, Wot, Wot, Wot, Wot, Wot, Wot, Wot, Wot, Wot, Wot, Wwt, Wot, Wot, Wot, Wwt, Wwt, Wwt, Wwt
Wwt, Wwt, Wwt, Wwt, Wwt, Wot, Wot, Wot, Wot, Wot, Wot, Wot, Wot, Wot, Wot, Wot, Wot, Wot, Wot, Wot, Wot, Wot, Wot, Wot, Wot, Wwrt, Wwrt, Wwf, Wwf, Wwrt, Wot, Wot, Wot, Wot, Wot, Wot, Wot, Wot, Wot, Wot, Wot, Wot, Wot, Wwt, Wot, Wot, Wwt, Wwt, Wwt, Wwt, Wwt, Wwt, Wwt, Wwt
Ds, Ds, Ds, Wwt, Wwt, Wwt, Wot, Wot, Wot, Wot, Wot, Wot, Wot, Wot, Wot, Wot, Wot, Wot, Wot, Wot, Wot, Wot, Wot, Wot, Wot, Wwrt, Wwrt, Wwf, Wwf, Wwrt, Wot, Wot, Wot, Wot, Wot, Wot, Wot, Wot, Wot, Wot, Wot, Wot, Wwt, Wwt, Wwt, Wwt, Wwt, Wwt, Wwt, Wwt, Ds, Wwt, Ds, Ds
Ds, Ds, Ds, Ds, Ds, Wwt, Wwt, Wot, Wot, Wot, Wot, Wot, Wot, Wot, Wot, Wot, Wot, Wot, Wot, Wot, Wot, Wot, Wot, Wot, Wwrt, Wwrt, Wwf, Wwf, Wwf, Wwrt, Wot, Wot, Wot, Wot, Wot, Wot, Wot, Wot, Wot, Wot, Wwt, Wot, Wot, Wwt, Wwt, Wwt, Ds, Ds, Ds, Ds, Ds, Ds, Ds, Ds
Gd^Fts, Gd^Fts, Ds, Ds, Ds, Wwt, Wwt, Wot, Wot, Wot, Wot, Wot, Wot, Wot, Wot, Wot, Wot, Wot, Wot, Wot, Wot, Wot, Wwrt, Wwrt, Wwrt, Wwrt, Wwf, Wwf, Wwrt, Wwrt, Wot, Wot, Wot, Wot, Wot, Wot, Wot, Wot, Wot, Wot, Wwt, Wot, Wot, Wwt, Wwt, Wwt, Ds, Ds, Ds, Ds, Ds, Ds, Gs, Gs
Gd^Fts, Gd^Fts, Gd^Fts, Ds, Ds, Ds, Wwt, Wwt, Wwt, Wot, Wot, Wot, Wot, Wot, Wot, Wot, Wot, Wot, Wot, Wot, Wot, Wot, Wwrt, Wwrt, Wwf, Wwf, Wwf, Wwf, Wwrt, Wot, Wot, Wot, Wot, Wot, Wot, Wot, Wot, Wot, Wot, Wot, Wot, Wot, Wwt, Wwt, Wwt, Ds, Ds, Ds, Rr^Vd, Gs, Gd, Gd, Hhd, Gd
Gd^Fts, Gd^Fts, Gd^Fts, Gd^Fts, Ds, Ds, Ds, Wwt, Wwt, Wot, Wot, Wot, Wot, Wot, Wot, Wot, Wot, Wot, Wot, Wot, Wot, Wot, Wwrt, Wwrt, Wwf, Wwf, Wwrt, Wwrt, Wot, Wot, Wot, Wot, Wot, Wot, Wot, Wot, Wot, Wot, Wot, Wot, Wot, Wot, Wwt, Wwt, Wwt, Ds, Ds, Ds, Ds, Gd, Gs, Hhd, Hhd^Fts, Hhd
Gd^Fts, Gd^Fts, Gd^Fts, Gd^Fts, Gd^Fts, Ds, Ds, Wwt, Wwt, Wot, Wot, Wot, Wot, Wot, Wot, Wot, Wot, Wot, Wot, Wot, Wot, Wot, Wwrt, Wwrt, Wwf, Wwf, Wwrt, Wwt, Wwt, Wot, Wwt, Wot, Wwt, Wot, Wot, Wot, Wwt, Wot, Wwt, Wot, Wot, Wot, Wwt, Wwt, Wwt, Wwt, Wwt, Ds, Ds, Ds, Gd, Hhd, Hhd, Hhd^Fts
Gd^Fts, Gd^Fts, Gd^Fts, Gd^Fts, Ss, Ds, Wwt, Wwt, Wot, Wot, Wot, Wwt, Wot, Wwt, Wwt, Wot, Wwt, Wwt, Wwt, Wot, Wot, Wwt, Wwrt, Wwf, Wwf, Wwf, Wwrt, Wwt, Wwt, Wot, Wot, Wwt, Wot, Wwt, Wot, Wwt, Wot, Wot, Wot, Wwt, Wwt, Wot, Wot, Wot, Wwt, Wwt, Ds, Ds, Ds, Ds, Gd, Gd, Hhd, Hhd^Fts
Gd^Fts, Gd^Fts, Gd^Fts, Gd^Fts, Ss, Wwt, Wwt, Wwt, Wwt, Wwt, Wwt, Wwt, Wwt, Wot, Wot, Wot, Wot, Wot, Wwt, Wot, Wwt, Wwrt, Wwrt, Wwf, Wwf, Wwrt, Wwrt, Wwt, Wwt, Wwt, Wwt, Wot, Wot, Wot, Wwt, Wwt, Wwt, Wwt, Wwt, Wot, Wwt, Wot, Wot, Wot, Wwt, Wwt, Ds, Ds, Ds, Gd, Gd^Fts, Hhd^Fts, Hhd^Fts, Hhd^Fts
Gs, Ss, Ss, Ss, Ss, Wwt, Wwt, Wwt, Ds, Wwt, Ds, Wwt, Wwt, Wwt, Wwt, Wot, Wot, Wot, Wwt, Wwt, Wwt, Wwrt, Wwrt, Wwf, Wwf, Wwrt, Wwrt, Wwt, Ds, Wwt, Wwt, Wwt, Wwt, Wwt, Wwt, Wwt, Wwt, Wwt, Wwt, Wwt, Ds, Wwt, Wwt, Wwt, Wwt, Wwt, Wwt, Ds, Ss, Gd, Gd^Fts, Gd^Fts, Gd^Fts, Gd^Fts
Ss, Ss, Ss, Ss, Wwt, Wwt, Wwt, Wwt, Ds, Ds, Ds, Ds, Ds, Wwt, Wwt, Wwt, Wwt, Wwt, Wwt, Wwt, Ds, Wwrt, Wwrt, Wwf, Wwf, Wwrt, Ds, Ds, Ds, Ds, Ds, Wwt, Wwt, Wwt, Wwt, Wwt, Wwt, Wwt, Ds, Ds, Ds, Ds, Ds, Wwt, Wwt, Wwt, Wwt, Ss, Ss, Gd, Gd^Fts, Gd^Fts, Hhd^Fts, Gd^Fts
Ss, Ss, Ss, Ss, Wwt, Wwt, Wwt, Ds, Ds, Ds, Gd^Fts, Ds, Ds, Ds, Wwt, Wwt, Ds, Wwt, Ds, Ds, Ds, Ds, Ds, Wwf, Ds, Ds, Ds, Ds, Gd, Ds, Ds, Ds, Wwt, Wwt, Ds, Wwt, Ds, Wwt, Ds, Ds, Gd, Ds, Ds, Ds, Ds, Wwt, Wwt, Wwt, Wwt, Ss, Gd^Fts, Hhd^Fts, Hhd^Fts, Hhd^Fts
Ss, Ss, Ss, Ss, Wwt, Wwt, Wwt, Ds, Ds, Gd^Fts, Gd^Fts, Ds, Ds, Ds, Ds, Ds, Ds, Ds, Ds, Ds, Gs, Ds, Ds, Ds, Ds, Ds, Gd, Re^Vct, Gs, Gd, Ds, Ds, Ds, Ds, Ds, Ds, Ds, Ds, Ds, Ds, Gs, Gd, Gd, Ds, Ds, Wwt, Wwt, Wwt, Wwt, Gd^Fts, Hhd^Fts, Hhd^Fts, Hhd^Fts, Hhd^Fts
Wwt, Ss, Ss, Ss, Wwt, Wwt, Wwt, Wwt, Ss, Ss, Ss, Gd^Fts, Gd^Fts, Ds, Ds, Ds, Gs, Ds, Gd, Car, Gd, Gs, Gs, Car, Car, Gs, Gd, Gd, Gs, Gs, Gs, Ds, Gd, Ds, Gd, Ds, Gs, Gd, Gd^Fts, Gd, Gd^Fts, Gd, Rr^Vd, Gs, Gd^Fts, Ss, Wwt, Wwt, Wwt, Gd^Fts, Hhd^Fts, Hhd^Fts, Md, Md
Wwt, Wwt, Wwt, Wwt, Wwt, Wwt, Wwt, Wwt, Wwt, Ss, Ss, Ss, Gd^Fts, Re^Vct, Gs, Gd, Ce, Ce, Gs, Gd^Fts, Car, Gd, Gd, Gd, Gd, Gs, Re^Vct, Gs, Gd^Fts, Gd^Fts, Gd^Fts, Gd, Gd^Fts, Gd^Fts, Gd^Fts, Gd^Fts, Gd^Fts, Gd^Fts, Hhd^Fts, Gs, Gd^Fts, Gd^Fts, Gs, Gd, Gd^Fts, Ss, Ss, Wwt, Wwt, Wwt, Hhd^Fts, Md, Md, Md
Wwt, Wwt, Wwt, Wwt, Wwt, Wwt, Wwt, Wwt, Wwt, Ss, Ss, Gd^Fts, Gd^Fts, Gd, Gd^Fts, Gd^Fts, Ce, Gd, Gd^Fts, Car, Car, Ce, Ce, Car, Gs, Gd, Gd^Fts, Gs, Gd, Gs, Hhd^Fts, Gd^Fts, Gd^Fts, Re^Vct, Hhd^Fts, Hhd^Fts, Hhd^Fts, Hhd^Fts, Md, Hhd^Fts, Hhd^Fts, Hhd^Fts, Hhd^Fts, Hhd^Fts, Hhd^Fts, Ss, Ss, Wwt, Wwt, Wwt, Md, Md, Md, Md
Wwt, Wwt, Wwt, Wwt, Ss, Ss, Wwt, Wwt, Wwt, Wwt, Ss, Ss, Ss, Gs, Gd^Fts, Gd^Fts, Gs, Gd^Fts, Gd^Fts, Car, Ce, Kar, Car, Car, Gd^Fts, Gd^Fts, Hhd^Fts, Hhd^Fts, Hhd^Fts, Hhd^Fts, Hhd^Fts, Hhd^Fts, Hhd^Fts, Hhd^Fts, Hhd^Fts, Md, Hhd^Fts, Md, Md, Md, Md, Hhd^Fts, Md, Hhd^Fts, Md, Hhd^Fts, Wwt, Wwt, Wwt, Wwt, Md, Md, Md, Md
Wwt, Wwt, Wwt, Ss, Ss, Ss, Ss, Wwt, Wwt, Wwt, Wwt, Ss, Ss, Gd, Gd, Gd^Fts, Gd^Fts, Re^Vct, Gd^Fts, Gs, Hhd^Fts, Ce, Gd^Fts, Gd^Fts, Hhd^Fts, Hhd^Fts, Md, Hhd^Fts, Hhd^Fts, Hhd^Fts, Hhd^Fts, Md, Md, Md, Md, Md, Hhd^Fts, Md, Md, Md, Md, Md, Md, Md, Md, Md, Hhd^Fts, Wwt, Wwt, Wwt, Wwt, Md, Md, Md
Wwt, Wwt, Ss, Ss, Ss, Ss, Ss, Wwt, Wwt, Wwt, Wwt, Ss, Ss, Gs, Gd^Fts, Gd^Fts, Hhd^Fts, Hhd^Fts, Hhd^Fts, Hhd^Fts, Hhd^Fts, Hhd^Fts, Hhd^Fts, Hhd^Fts, Md, Md, Md, Md, Md, Md, Md, Hhd^Fts, Hhd^Fts, Md, Md, Md, Hhd^Fts, Md, Md, Md, Md, Md, Md, Md, Md, Md, Md, Wwt, Wwt, Wwt, Wwt, Md, Md, Md
Wwt, Wwt, Ss, Ss, Ss, Ss, Gs, Wwt, Wwt, Wwt, Wwt, Ss, Gd^Fts, Gd^Fts, Hhd^Fts, Hhd^Fts, Md, Hhd^Fts, Hhd^Fts, Hhd^Fts, Hhd^Fts, Hhd^Fts, Md, Md, Md, Md, Md, Md, Md, Md, Md, Md, Hhd^Fts, Md, Hhd^Fts, Hhd^Fts, Md, Md, Md, Md, Md, Md, Md, Md, Md, Md, Md, Hhd^Fts, Hhd^Fts, Wwt, Md, Md, Md, Md
Gs, Gs, Gd, Gs, Gd, Gs, Rr^Vd, Gs, Gd, Gd, Gd^Fts, Gd^Fts, Hhd^Fts, Hhd^Fts, Md, Md, Md, Md, Md, Md, Hhd^Fts, Hhd^Fts, Md, Md, Md, Md, Md, Md, Md, Md, Md, Hhd^Fts, Hhd^Fts, Md, Hhd^Fts, Md, Md, Md, Md, Md, Md, Md, Md, Md, Md, Md, Md, Hhd^Fts, Md, Md, Md, Md, Md, Md
Gd, Gd, Gd^Fts, Gd, Gd, Gs, Gd, Gd, Gd^Fts, Gs, Gd^Fts, Gd^Fts, Hhd^Fts, Hhd^Fts, Md, Md, Md, Md, Md, Md, Md, Hhd^Fts, Hhd^Fts, Md, Md, Md, Md, Md, Md, Md, Hhd^Fts, Hhd^Fts, Hhd^Fts, Hhd^Fts, Md, Md, Md, Md, Md, Md, Md, Md, Md, Md, Md, Md, Md, Md, Md, Md, Md, Md, Md, Md
Gs, Gd^Fts, Gs, Gd^Fts, Gs, Gd^Fts, Gd, Gs, Gd^Fts, Gd^Fts, Gd^Fts, Hhd^Fts, Hhd^Fts, Hhd^Fts, Md, Md, Md, Md, Md, Md, Md, Hhd^Fts, Hhd^Fts, Hhd^Fts, Hhd^Fts, Md, Md, Md, Md, Md, Hhd^Fts, Hhd^Fts, Hhd^Fts, Hhd^Fts, Md, Md, Md, Md, Md, Md, Md, Md, Md, Md, Md, Md, Md, Md, Md, Md, Md, Md, Md, Md
Gd^Fts, Gd^Fts, Gd^Fts, Gd^Fts, Gd, Gd, Gd, Gd^Fts, Gd^Fts, Gd^Fts, Hhd^Fts, Hhd^Fts, Md, Hhd^Fts, Md, Md, Md, Md, Md, Md, Md, Md, Md, Hhd^Fts, Hhd^Fts, Md, Md, Md, Md, Md, Hhd^Fts, Md, Md, Hhd^Fts, Md, Md, Md, Md, Md, Md, Md, Md, Md, Md, Md, Md, Md, Md, Md, Md, Md, Md, Md, Md
Gd^Fts, Gs, Gd^Fts, Gd^Fts, Gd^Fts, Gd^Fts, Gs, Gd^Fts, Gd^Fts, Hhd^Fts, Hhd^Fts, Md, Md, Md, Md, Md, Md, Md, Md, Md, Md, Md, Hhd^Fts, Hhd^Fts, Md, Hhd^Fts, Md, Md, Md, Md, Hhd^Fts, Md, Md, Hhd^Fts, Hhd^Fts, Md, Md, Md, Md, Md, Md, Md, Md, Md, Md, Md, Md, Md, Md, Md, Md, Md, Md, Md
