border_size=1
usage=map

Ur^Ii, Uue, Uue, Xue, Xue, Xue, Xue, Xue, Xue, Xue, Xue, Xue, Xue, Xue, Xue, Xue, Xue, Xue, Xue, Xue, Xue, Xue, Xue, Xue, Xue, Xue, Xue, Xue, Xue, Xue, Xue, Xue, Xue, Xue, Xue, Xue, Xue, Xue, Xue, Xue, Xue, Xue, Xue, Xue, Xue, Xue, Xue, Xue, Xue, Xue, Xue, Xue, Xue, Xue, Xue, Xue, Xue, Xue, Xue, Xue
Xue, Ur^Ii, Ur, Uue^Ii, Uue^Ii, Xue, Xue, Xue, Uu^Ufi, Xue, Xue, Xue, Xue, Xue, Xue, Xue, Xue, Xue, Xue, Xue, Xue, Xue, Xue, Xue, Xue, Xue, Xue, Xue, Xue, Xue, Xue, Xue, Xue, Xue, Xue, Xue, Xue, Xue, Xue, Xue, Xue, Xue, Xue, Xue, Xue, Xue, Xue, Xue, Xue, Xue, Xue, Xue, Xue, Xue, Xue, Xue, Xue, Xue, Xue, Xue
Xue, Xue, Xue, Ur, Ur, Uue, Uue, Uu^Ufi, Uue, Uu^Ufi, Re^Vct, Xue, Xue, Xue, Xue, Xue, Xue, Xue, Xue, Xue, Xue, Xue, Xue, Xue, Xue, Xue, Xue, Xue, Xue, Xue, Xue, Xue, Xue, Xue, Xue, Xue, Xue, Xue, Xue, Xue, Xue, Xue, Xue, Xue, Xue, Xue, Xue, Xue, Xue, Xue, Xue, Xue, Xue, Xue, Xue, Xue, Xue, Xue, Xue, Xue
Xue, Xue, Xue, Xue, Re^Vct, Ur, Ce, Ce, Ce, Uue, Uue, Xue, Xue, Xue, Xue, Xue, Xue, Xue, Xue, Xue, Xue, Xue, Xue, Xue, Xue, Xue, Xue, Xue, Xue, Xue, Xue, Xue, Xue, Xue, Xue, Xue, Xue, Xue, Xue, Xue, Xue, Xue, Xue, Xue, Xue, Xue, Xue, Xue, Xue, Xue, Xue, Xue, Xue, Xue, Xue, Xue, Xue, Xue, Xue, Xue
Xue, Xue, Xue, Xue, Uu^Ufi, Uue, Ce, 1 Ke, Ce, Uue, Uue^Ii, Re^Vct, Uue, Xue, Uh^Ii, Uh^Ii, Uh^Ii, Xue, Xue, Xue, Xue, Xue, Xue, Xue, Xue, Xue, Xue, Xue, Xue, Xue, Xue, Xue, Xue, Xue, Xue, Xue, Xue, Xue, Xue, Xue, Xue, Xue, Xue, Xue, Xue, Xue, Xue, Xue, Xue, Xue, Xue, Xue, Xue, Xue, Xue, Xue, Xue, Xue, Xue, Xue
Xue, Xue, Xue, Xue, Uh^Ii, Uu^Ufi, Uue, Ce, Ur, Ur^Ii, Ur, Uue^Ii, Ur, Uue, Ur^Ii, Ur, Ur, Uu^Ufi, Qxua, Qxua, Qxua, Xue, Xue, Xue, Xue, Xue, Xue, Xue, Uh, Xue, Xue, Xue, Xue, Xue, Xue, Xue, Xue, Xue, Xue, Xue, Xue, Xue, Xue, Xue, Xue, Xue, Xue, Xue, Xue, Xue, Xue, Xue, Xue, Xue, Xue, Xue, Xue, Xue, Xue, Xue
Xue, Xue, Xue, Xue, Xue, Uu^Ufi, Uue^Ii, Uue, Re^Vct, Ur, Uu^Ufi, Ur, Uu^Ufi, Ur, Uu^Ufi, Ur, Uu^Ufi, Ur, Ur, Qxua, Qxua, Xue, Xue, Xue, Uu^Ufi, Uh^Ii, Uu^Ufi, Uue, Xue, Uh^Ii, Uh^Ii, Xue, Xue, Xue, Xue, Xue, Xue, Xue, Xue, Xue, Xue, Xue, Xue, Xue, Xue, Xue, Xue, Xue, Xue, Xue, Xue, Xue, Xue, Xue, Xue, Xue, Xue, Xue, Xue, Xue
Xue, Xue, Xue, Xue, Xue, Uue, Uue, Uue^Ii, Ur, Ur, Uu^Ufi, Uh^Ii, Xue, Uh^Ii, Xue, Xue, Xue, Uu^Ufi, Ur, Uue, Uu^Ufi, Uh^Ii, Xue, Xue, Ur, Ur, Ur, Ur, Ur, Xue, Uh^Ii, Xue, Xue, Xue, Xue, Xue, Xue, Xue, Xue, Xue, Xue, Xue, Xue, Xue, Xue, Xue, Xue, Xue, Xue, Xue, Xue, Xue, Xue, Xue, Xue, Xue, Xue, Xue, Xue, Xue
Xue, Xue, Xue, Xue, Uu^Ufi, Uue, Ur, Ur^Ii, Uue, Uue, Qxua, Xue, Xue, Xue, Qxua, Xue, Xue, Xue, Ur, Xue, Uue^Vcl, Uu^Ufi, Ur, Ur, Qxua, Qxua, Xue, Uu^Ufi, Ur, Xue, Xue, Uue, Xue, Xue, Xue, Xue, Xue, Xue, Xue, Xue, Xue, Xue, Xue, Xue, Xue, Xue, Xue, Xue, Xue, Xue, Xue, Xue, Xue, Xue, Xue, Xue, Xue, Xue, Xue, Xue
Xue, Xue, Xue, Xue, Xue, Uue, Ur, Uu^Ufi, Qxua, Qxua, Xue, Xue, Xue, Qxua, Qxua, Qxua, Xue, Xue, Xue, Ur^Ii, Ur, Ur, Xue, Uu^Ufi, Xue, Qxua, Xue, Xue, Xue, Ur, Ur, Uue^Ii, Uue^Ii, Uue^Ii, Ur, Uu^Ufi, Ur, Xue, Xue, Xue, Xue, Xue, Xue, Xue, Xue, Xue, Xue, Xue, Xue, Xue, Xue, Xue, Xue, Xue, Xue, Xue, Xue, Xue, Xue, Xue
Xue, Xue, Xue, Xue, Uh^Ii, Uue^Ii, Ur, Uu^Ufi, Xue, Qxua, Qxua, Xue, Qxua, Qxua, Qxua, Qxua, Qxua, Xue, Xue, Uue^Ii, Ur^Ii, Uu^Ufi, Uh^Ii, Xue, Xue, Qxua, Xue, Xue, Xue, Ur^Ii, Ur, Uue^Vcl, Ur, Ur, Xue, Ur, Uu^Ufi, Ur, Ur, Xue, Xue, Xue, Xue, Xue, Xue, Xue, Xue, Xue, Xue, Xue, Xue, Xue, Xue, Xue, Xue, Xue, Xue, Xue, Xue, Xue
Xue, Xue, Xue, Xue, Uh^Ii, Qxua, Uh^Ii, Ur, Uu^Ufi, Xue, Qxua, Qxua, Qxua, Qxua, Qxua, Qxua, Qxua, Qxua, Xue, Uue^Ii, Ur^Ii, Uu^Ufi, Xue, Xue, Qxua, Qxua, Qxua, Qxua, Xue, Xue, Uue^Ii, Ur^Ii, Uu^Ufi, Uu^Ufi, Xue, Xue, Xue, Uu^Ufi, Ur^Ii, Uh, Xue, Xue, Xue, Xue, Xue, Xue, Xue, Xue, Xue, Xue, Xue, Xue, Xue, Xue, Xue, Xue, Xue, Xue, Xue, Xue
Xue, Xue, Xue, Xue, Uue^Ii, Qxua, Qxua, Ur^Ii, Uu^Ufi, Xue, Xue, Qxua, Qxua, Xue, Xue, Qxua, Qxua, Qxua, Xue, Uue^Ii, Ur, Xue, Xue, Xue, Qxua, Qxua, Qxua, Qxua, Qxua, Xue, Uue^Ii, Ur, Xue, Qxua, Qxua, Qxua, Qxua, Qxua, Ur, Ur^Ii, Xue, Xue, Xue, Xue, Xue, Xue, Xue, Xue, Xue, Xue, Xue, Xue, Xue, Xue, Xue, Xue, Xue, Xue, Xue, Xue
Xue, Xue, Xue, Uu^Ufi, Uue^Ii, Qxua, Qxua, Ur, Xue, Xue, Xue, Xue, Qxua, Xue, Xue, Xue, Xue, Xue, Xue, Uue, Ur^Ii, Xue, Xue, Xue, Xue, Qxua, Qxua, Qxua, Xue, Xue, Uu^Ufi, Ur^Ii, Xue, Xue, Qxua, Qxua, Qxua, Xue, Ur, Ur^Ii, Xue, Xue, Xue, Xue, Xue, Xue, Xue, Xue, Xue, Xue, Xue, Xue, Xue, Xue, Xue, Xue, Xue, Xue, Xue, Xue
Xue, Xue, Xue, Xue, Uue, Qxua, Qxua, Ur^Ii, Xue, Xue, Uue^Vcl, Qxua, Uue^Ii, Qxua, Uue, Xue, Xue, Xue, Ur^Ii, Ur, Uue, Ur^Ii, Ur^Ii, Xue, Xue, Xue, Xue, Qxua, Xue, Xue, Uh^Ii, Ur^Ii, Ur, Xue, Xue, Qxua, Xue, Xue, Ur, Uue^Ii, Xue, Xue, Xue, Xue, Xue, Xue, Xue, Xue, Xue, Xue, Xue, Xue, Xue, Xue, Xue, Xue, Xue, Xue, Xue, Xue
Xue, Xue, Xue, Xue, Ur^Ii, Uue^Vcl, Ur, Ur, Ur, Uue, Xue, Uue^Ii, Xue, Uue^Ii, Uue, Uue, Ur^Ii, Ur^Ii, Xue, Uue, Xue, Uue, Uue^Vcl, Ur^Ii, Uh^Ii, Xue, Xue, Qxua, Xue, Xue, Xue, Uu^Ufi, Ur, Uue, Uue, Qxua, Xue, Uu^Ufi, Ur, Uue, Uue, Xue, Xue, Xue, Xue, Xue, Xue, Xue, Xue, Xue, Xue, Xue, Xue, Xue, Xue, Xue, Xue, Xue, Xue, Xue
Xue, Xue, Xue, Ur^Ii, Qxua, Ur, Uu^Ufi, Xue, Uu^Ufi, Ur, Xue, Xue, Qxua, Xue, Qxua, Ur, Xue, Xue, Xue, Xue, Xue, Xue, Ur, Ur^Ii, Ur, Xue, Qxua, Qxua, Qxua, Xue, Xue, Xue, Ur, Uue^Ii, Ur, Uue, Ur, Ur, Uu^Ufi, Xue, Uu^Ufi, Uh, Uh^Ii, Xue, Xue, Xue, Xue, Xue, Xue, Xue, Xue, Xue, Xue, Xue, Xue, Xue, Xue, Xue, Xue, Xue
Xue, Xue, Xue, Ur^Ii, Uh^Ii, Qxua, Qxua, Uh^Ii, Xue, Ur, Uu^Ufi, Xue, Qxua, Qxua, Xue, Ur, Uue^Ii, Xue, Xue, Xue, Qxua, Qxua, Ur, Xue, Ur^Ii, Xue, Qxua, Qxua, Qxua, Xue, Uue^Ii, Xue, Uue, Ur^Ii, Xue, Ur, Uu^Ufi, Ur, Xue, Xue, Qxua, Xue, Uh^Ii, Xue, Xue, Xue, Xue, Xue, Xue, Xue, Xue, Xue, Xue, Xue, Xue, Xue, Xue, Xue, Xue, Xue
Xue, Xue, Xue, Ur, Ur, Uh^Ii, Xue, Xue, Xue, Ur^Ii, Uu^Ufi, Qxua, Xue, Xue, Xue, Qxua, Qxua, Uue^Ii, Ur, Xue, Qxua, Qxua, Uh, Ur^Ii, Ur, Uue^Ii, Uue, Qxua, Uue^Ii, Uue, Xue, Uue^Ii, Ur^Ii, Ur^Ii, Ur, Ur, Uh, Ur, Uu^Ufi, Uh, Qxua, Xue, Uue^Vcl, Xue, Xue, Xue, Xue, Xue, Xue, Xue, Xue, Xue, Xue, Xue, Xue, Xue, Xue, Xue, Xue, Xue
Xue, Xue, Xue, Uue^Ii, Uue^Vcl, Ur^Ii, Ur, Xue, Xue, Ur, Xue, Uu^Ufi, Xue, Xue, Xue, Qxua, Xue, Qxua, Ur^Ii, Xue, Qxua, Xue, Xue, Uu^Ufi, Uh^Ii, Ur^Ii, Ur^Ii, Uue^Ii, Ur^Ii, Xue, Ur, Ur, Ur, Uu^Ufi, Uh, Uu^Ufi, Uu^Ufi, Ur, Ur, Uu^Ufi, Xue, Xue, Xue, Uue^Ii, Xue, Xue, Xue, Xue, Xue, Xue, Xue, Xue, Xue, Xue, Xue, Xue, Xue, Xue, Xue, Xue
Xue, Xue, Xue, Qxua, Uu^Ufi, Qxua, Qxua, Uu^Ufi, Xue, Ur, Xue, Uu^Ufi, Uh, Xue, Xue, Xue, Xue, Ur^Ii, Xue, Xue, Xue, Qxua, Qxua, Xue, Xue, Xue, Uh^Ii, Ur, Ur, Ur^Ii, Uh^Ii, Ur, Xue, Ur, Ur^Ii, Xue, Xue, Ur, Xue, Ur, Ur, Uh, Ur, Uue^Ii, Xue, Xue, Xue, Xue, Xue, Xue, Xue, Xue, Xue, Xue, Xue, Xue, Xue, Xue, Xue, Xue
Xue, Xue, Xue, Uh, Uu^Ufi, Qxua, Ur, Uu^Ufi, Ur, Ur^Ii, Ur, Uu^Ufi, Uu^Ufi, Xue, Ur^Ii, Uu^Ufi, Ur^Ii, Uue, Xue, Xue, Xue, Xue, Qxua, Qxua, Qxua, Xue, Xue, Uu^Ufi, Ur^Ii, Uh, Uh^Ii, Uu^Ufi, Uue^Ii, Uue, Xue, Ur^Ii, Ur^Ii, Ur, Uue^Ii, Ur, Uue^Ii, Ur^Ii, Uue, Ur, Ur, Xue, Xue, Xue, Xue, Xue, Xue, Xue, Xue, Xue, Xue, Xue, Xue, Xue, Xue, Xue
Xue, Xue, Xue, Xue, Uue, Uue, Ur, Ur^Ii, Ur^Ii, Ur, Qxua, Ur, Qxua, Ur, Qxua, Ur^Ii, Ur^Ii, Xue, Uue, Ur, Ur, Xue, Xue, Qxua, Qxua, Qxua, Xue, Uh^Ii, Uue, Ur, Uue, Xue, Uue^Ii, Uue, Uue, Xue, Xue, Ur, Qxua, Uue, Uue, Xue, Xue, Uue, Ur, Uu^Ufi, Uu^Ufi, Xue, Xue, Xue, Xue, Xue, Xue, Xue, Xue, Xue, Xue, Xue, Xue, Xue
Xue, Xue, Xue, Xue, Uh, Uu^Ufi, Uu^Ufi, Ur, Ur^Ii, Uu^Ufi, Qxua, Uue^Ii, Uue^Ii, Uue, Qxua, Uu^Ufi, Ur, Uue, Uue^Ii, Xue, Xue, Uue, Ur, Xue, Xue, Qxua, Xue, Uh^Ii, Uue, Ur^Ii, Ur^Ii, Uue, Xue, Xue, Uu^Ufi, Uue, Uue, Uue^Ii, Uue^Ii, Qxua, Uue^Vcl, Uue, Uu^Uf, Xue, Uu^Ufi, Ur, Ur, Xue, Xue, Xue, Xue, Xue, Xue, Xue, Xue, Xue, Xue, Xue, Xue, Xue
Xue, Xue, Xue, Xue, Xue, Uh, Uh, Uue^Vcl, Xue, Ur, Ur, Uue, Uue^Ii, Uu^Vcl, Qxua, Xue, Uue^Vcl, Ur, Xue, Uu^Ufi, Xue, Xue, Xue, Uue, Xue, Qxua, Qxua, Xue, Xue, Uue^Vcl, Ur^Ii, Uue, Uue^Ii, Xue, Xue, Qxua, Qxua, Qxua, Uue, Qxua, Qxua, Uue, Xue, Xue, Xue, Ur, Ur, Xue, Xue, Xue, Xue, Xue, Xue, Xue, Xue, Xue, Xue, Xue, Xue, Xue
Xue, Xue, Xue, Xue, Xue, Xue, Xue, Uu^Ufi, Uu^Ufi, Uue, Ur^Ii, Uue^Ii, Xue, Qxua, Uh, Xue, Uue^Ii, Uue^Ii, Ur^Ii, Xue, Uu^Ufi, Xue, Xue, Uue, Xue, Qxua, Qxua, Qxua, Qxua, Xue, Uue, Ur, Xue, Uue^Ii, Uue^Ii, Xue, Qxua, Qxua, Uue, Qxua, Xue, Uue, Uue, Xue, Xue, Uu^Ufi, Uu^Ufi, Ur, Uue, Xue, Qxua, Qxua, Qxua, Xue, Uh, Xue, Xue, Xue, Xue, Xue
Xue, Xue, Xue, Xue, Xue, Xue, Xue, Uu^Ufi, Qxua, Uue, Ur^Ii, Uue, Xue, Uh, Uu^Ufi, Xue, Xue, Qxua, Ur, Xue, Xue, Uue^Ii, Uue^Vcl, Ur^Ii, Xue, Qxua, Qxua, Qxua, Xue, Xue, Uue, Ur, Uue, Xue, Xue, Uue, Uue, Uue, Uu^Ufi, Xue, Xue, Xue, Uue, Xue, Xue, Xue, Xue, Ur, Ur, Uu^Vud, Uue, Qxua, Uue, Uu^Uf, Uu^Uf, Uu^Uf, Uue, Xue, Xue, Xue
Xue, Xue, Xue, Xue, Xue, Xue, Xue, Uh, Uh^Ii, Qxua, Ur^Ii, Ur, Uu^Ufi, Uu^Ufi, Xue, Xue, Xue, Xue, Ur, Uue, Ur^Ii, Ur, Qxua, Uu^Ufi, Xue, Qxua, Qxua, Xue, Xue, Xue, Uue, Ur^Ii, Xue, Uue^Vcl, Xue, Xue, Xue, Xue, Xue, Xue, Xue, Xue, Xue, Uue, Uue, Uue, Uue, Uue, Ur, Ur, Ur, Uue, Ur, Uue, Uue, Uue, Uu^Uf, Uue, Uu^Uf, Xue
Xue, Xue, Xue, Xue, Xue, Xue, Xue, Uh^Ii, Ur, Ur, Uue^Vcl, Ur^Ii, Ur, Xue, Xue, Xue, Xue, Xue, Uue^Ii, Uue^Ii, Uu^Ufi, Qxua, Qxua, Xue, Xue, Qxua, Qxua, Xue, Xue, Uu^Ufi, Ur^Ii, Ur^Ii, Xue, Uue, Uu^Ufi, Xue, Xue, Xue, Xue, Xue, Xue, Xue, Xue, Xue, Xue, Xue, Xue, Xue, Xue, Ur, Uu^Vud, Ur, Uue, Cdr, Ur, Uue, Uh, Uu^Uf, Uu^Vud, Xue
Xue, Xue, Xue, Xue, Xue, Xue, Ur, Ur, Qxua, Uue, Uh, Uu^Ufi, Xue, Ur, Xue, Xue, Ur, Ur, Qxua, Uu^Ufi, Xue, Xue, Qxua, Xue, Qxua, Qxua, Qxua, Xue, Xue, Ur, Xue, Xue, Xue, Uue, Uue^Ii, Xue, Xue, Xue, Xue, Xue, Xue, Xue, Xue, Xue, Xue, Xue, Xue, Xue, Qxua, Ur, Ur, Cdr, Cdr, Cdr, Cdr, Cdr, Uh, Uh, Uh, Xue
Xue, Xue, Xue, Xue, Ur^Ii, Ur^Ii, Qxua, Uu^Ufi, Uh, Qxua, Xue, Uu^Ufi, Uue, Ur, Ur^Ii, Ur, Uh, Qxua, Qxua, Uh^Ii, Xue, Qxua, Qxua, Qxua, Qxua, Qxua, Qxua, Qxua, Xue, Ur^Ii, Ur^Ii, Xue, Xue, Xue, Uue^Ii, Xue, Xue, Xue, Xue, Xue, Xue, Xue, Xue, Xue, Xue, Xue, Xue, Qxua, Qxua, Uu^Uf, Ur, Uue, Cdr, 2 Kdr, Cdr, Uue, Uh, Uh, Uu^Uf, Xue
Xue, Xue, Xue, Uue, Ur, Qxua, Xue, Uu^Ufi, Xue, Qxua, Xue, Xue, Xue, Uue, Uue, Ur^Ii, Ur^Ii, Uh, Uu^Ufi, Xue, Xue, Xue, Xue, Qxua, Qxua, Qxua, Qxua, Qxua, Xue, Uue^Ii, Uue^Ii, Ur, Uu^Ufi, Uue^Ii, Xue, Xue, Xue, Xue, Xue, Xue, Xue, Xue, Xue, Xue, Xue, Xue, Xue, Qxua, Qxua, Ur, Ur, Cdr, Uue, Cdr, Uue, Cdr, Uue, Uu^Uf, Uu^Uf, Xue
Xue, Xue, Xue, Uue^Ii, Ur, Uu^Ufi, Uh, Xue, Xue, Qxua, Qxua, Qxua, Qxua, Xue, Xue, Uue, Uue, Ur, Ur, Uu^Ufi, Xue, Xue, Xue, Xue, Xue, Xue, Xue, Qxua, Xue, Xue, Uue, Ur^Ii, Uu^Ufi, Uue^Ii, Xue, Xue, Xue, Xue, Xue, Xue, Xue, Xue, Xue, Xue, Xue, Xue, Uu^Uf, Xue, Uh, Ur, Uue, Qxua, Qxua, Cdr, Uue, Uue, Uue, Uue, Uue, Xue
Xue, Xue, Xue, Uue^Ii, Ur^Ii, Uu^Ufi, Uu^Ufi, Xue, Xue, Qxua, Qxua, Qxua, Qxua, Qxua, Xue, Uh^Ii, Uue^Ii, Uue^Ii, Ur, Ur, Ur^Ii, Uu^Ufi, Uue, Uue, Uue^Ii, Xue, Xue, Qxua, Qxua, Xue, Uue, Ur, Ur, Uue, Xue, Xue, Xue, Xue, Xue, Xue, Xue, Xue, Uu^Uf, Xue, Xue, Uh, Ur, Ur, Xue, Uu^Vud, Uue, Qxua, Uu^Uf, Uu^Uf, Uu^Uf, Uu^Uf, Uu^Uf, Uu^Vud, Xue, Xue
Xue, Xue, Xue, Uue^Vcl, Uue^Ii, Ur, Ur, Uu^Ufi, Uu^Ufi, Xue, Xue, Qxua, Qxua, Qxua, Qxua, Xue, Uh^Ii, Xue, Xue, Ur, Ur, Uue^Ii, Xue, Xue, Xue, Uue^Ii, Uue^Ii, Xue, Qxua, Qxua, Uu^Ufi, Uu^Ufi, Uue, Uh, Uh^Ii, Xue, Xue, Xue, Xue, Xue, Xue, Xue, Ur, Uu^Uf, Xue, Uu^Uf, Ur, Xue, Xue, Xue, Uue, Uue, Uu^Uf, Uh, Uh, Uh, Uh, Uh, Xue, Xue
Xue, Xue, Xue, Xue, Uue, Uue, Ur, Ur, Uu^Ufi, Uu^Ufi, Uh^Ii, Xue, Xue, Qxua, Qxua, Xue, Uh, Uh, Xue, Xue, Ur, Uue^Ii, Uu^Ufi, Xue, Xue, Xue, Uh^Ii, Uue, Uue^Vcl, Qxua, Uue^Ii, Uue^Ii, Uue^Ii, Uue^Vcl, Uue, Qxua, Qxua, Xue, Xue, Xue, Xue, Ur, Xue, Ur, Uh, Uu^Uf, Ur, Uh, Uh, Xue, Uue, Xue, Xue, Uh, Uh, Uh, Xue, Xue, Xue, Xue
Xue, Xue, Xue, Xue, Uh^Ii, Uu^Ufi, Uu^Ufi, Ur, Ur, Uu^Ufi, Xue, Xue, Qxua, Qxua, Qxua, Xue, Uue, Uue, Uue, Uu^Ufi, Uu^Ufi, Ur^Ii, Ur, Ur, Ur, Uh, Uh, Uue^Ii, Uue, Uue^Ii, Uue^Cov, Uue^Cov, Uue^Cov, Uh^Ii, Uh, Qxua, Qxua, Xue, Xue, Uu^Uf, Uh, Ur, Xue, Uh, Ur, Uh, Xue, Uh, Ur, Uue, Uue, Xue, Xue, Xue, Xue, Xue, Xue, Xue, Xue, Xue
Xue, Xue, Xue, Xue, Uh^Ii, Uu^Ufi, Uu^Ufi, Uh^Ii, Ur^Ii, Xue, Qxua, Qxua, Xue, Xue, Xue, Qxua, Qxua, Uue^Ii, Uue^Ii, Xue, Uu^Ufi, Ur, Xue, Xue, Xue, Ur, Ur, Uue^Ii, Uh^Ii, Uh^Ii, Uue^Cov, Uue^Kov, Uue^Cov, Uh^Ii, Uh^Ii, Uu^Ufi, Uu^Ufi, Xue, Xue, Ur, Xue, Uh, Uu^Vud, Xue, Ur, Uh, Xue, Xue, Ur, Xue, Uue, Xue, Xue, Xue, Xue, Xue, Xue, Xue, Xue, Xue
Xue, Xue, Xue, Xue, Uh^Ii, Xue, Uh^Ii, Xue, Xue, Ur^Ii, Ur, Xue, Xue, Xue, Ur^Ii, Qxua, Ur, Uue^Vcl, Ur^Ii, Ur, Ur, Ur, Xue, Xue, Xue, Xue, Uu^Ufi, Uue^Vcl, Uh^Ii, Uue^Cov, Uue^Kov, Uue^Vs, Uue^Kov, Uue^Cov, Uue^Ii, Uue^Vcl, Uu^Ufi, Xue, Xue, Ur, Xue, Xue, Xue, Xue, Ur, Uu^Uf, Uu^Uf, Uu^Uf, Ur, Xue, Uue, Xue, Xue, Xue, Xue, Xue, Xue, Xue, Xue, Xue
Xue, Xue, Xue, Xue, Xue, Uh^Ii, Xue, Uh^Ii, Xue, Xue, Uue^Ii, Ur, Ur, Ur^Ii, Xue, Ur^Ii, Ur, Ur, Uu^Ufi, Uu^Ufi, Uue, Uue^Ii, Uue, Xue, Uu^Ufi, Xue, Uu^Ufi, Uue^Ii, Uh^Ii, Uue^Cov, Uue^Cov, Uue^Cov, Uue^Cov, Uue^Cov, Uue^Ii, Uue^Ii, Qxua, Xue, Xue, Uh, Ur, Xue, Xue, Xue, Uh, Uh, Xue, Xue, Xue, Ur, Uue, Uu^Uf, Uu^Uf, Xue, Xue, Xue, Xue, Xue, Xue, Xue
Xue, Xue, Xue, Xue, Xue, Xue, Xue, Xue, Xue, Uh^Ii, Xue, Uue^Vcl, Uu^Ufi, Ur, Xue, Xue, Uue^Ii, Xue, Xue, Uu^Ufi, Uue, Uue^Ii, Xue, Uue, Uue, Xue, Uue^Ii, Uue^Ii, Uue^Vcl, Uh^Ii, Uue^Cov, 3 Uue^Kov, Uue^Cov, Uh^Ii, Uue^Vcl, Qxua, Qxua, Xue, Xue, Xue, Xue, Ur, Ur, Xue, Uh, Xue, Xue, Xue, Xue, Xue, Xue, Uu^Uf, Uu^Uf, Xue, Xue, Xue, Xue, Xue, Xue, Xue
Xue, Xue, Xue, Xue, Xue, Xue, Xue, Xue, Xue, Xue, Xue, Uh^Ii, Xue, Uu^Ufi, Uu^Ufi, Xue, Xue, Uue^Ii, Uue, Uue, Uh^Ii, Xue, Xue, Xue, Xue, Uue^Ii, Uue, Uue^Ii, Uu^Ufi, Uue^Ii, Uue^Ii, Uue^Cov, Uh^Ii, Uh^Ii, Qxua, Qxua, Qxua, Xue, Xue, Xue, Xue, Xue, Uh, Uu^Uf, Uh, Uh, Xue, Xue, Xue, Xue, Uh, Uh, Xue, Xue, Xue, Xue, Xue, Xue, Xue, Xue
Xue, Xue, Xue, Xue, Xue, Xue, Xue, Xue, Xue, Xue, Xue, Xue, Xue, Uh^Ii, Xue, Uue^Ii, Uue^Vcl, Uue^Ii, Xue, Uh^Ii, Xue, Xue, Xue, Xue, Xue, Xue, Xue, Qxua, Qxua, Uu^Ufi, Uue, Uue^Ii, Uue^Ii, Uue^Vcl, Qxua, Qxua, Xue, Xue, Xue, Xue, Xue, Xue, Uh, Uh, Xue, Uu^Uf, Xue, Xue, Xue, Xue, Uh, Uh, Xue, Xue, Xue, Xue, Xue, Xue, Xue, Xue
Xue, Xue, Xue, Xue, Xue, Xue, Xue, Xue, Xue, Xue, Xue, Xue, Xue, Xue, Xue, Xue, Xue, Xue, Xue, Xue, Xue, Xue, Xue, Xue, Xue, Xue, Xue, Xue, Qxua, Uu^Ufi, Uue, Uue^Ii, Uue, Uue^Ii, Xue, Xue, Xue, Xue, Xue, Xue, Xue, Xue, Xue, Xue, Xue, Uu^Uf, Uu^Uf, Xue, Uu^Uf, Uu^Uf, Xue, Xue, Xue, Xue, Xue, Xue, Xue, Xue, Xue, Xue
Xue, Xue, Xue, Xue, Xue, Xue, Xue, Xue, Xue, Xue, Xue, Xue, Xue, Xue, Xue, Xue, Xue, Xue, Xue, Xue, Xue, Xue, Xue, Xue, Xue, Xue, Xue, Xue, Qxua, Uue^Ii, Uue^Ii, Uue^Ii, Uue, Uue^Ii, Xue, Xue, Xue, Xue, Xue, Xue, Xue, Xue, Xue, Xue, Xue, Uh, Uh, Uh, Uh, Xue, Xue, Xue, Xue, Xue, Xue, Xue, Xue, Xue, Xue, Xue
Xue, Xue, Xue, Xue, Xue, Xue, Xue, Xue, Xue, Xue, Xue, Xue, Xue, Xue, Xue, Xue, Xue, Xue, Xue, Xue, Xue, Xue, Xue, Xue, Xue, Xue, Xue, Xue, Xue, Qxua, Uu^Ufi, Uue, Uue^Ii, Uu^Ufi, Xue, Xue, Xue, Xue, Xue, Xue, Xue, Xue, Xue, Xue, Xue, Uh, Xue, Xue, Xue, Xue, Xue, Xue, Xue, Xue, Xue, Xue, Xue, Xue, Xue, Xue
Xue, Xue, Xue, Xue, Xue, Xue, Xue, Xue, Xue, Xue, Xue, Xue, Xue, Xue, Xue, Xue, Xue, Xue, Xue, Xue, Xue, Xue, Xue, Xue, Xue, Xue, Xue, Xue, Xue, Xue, Uu^Ufi, Uue^Ii, Uue, Uu^Ufi, Uu^Ufi, Xue, Xue, Xue, Xue, Xue, Xue, Xue, Xue, Xue, Xue, Xue, Xue, Xue, Xue, Xue, Xue, Xue, Xue, Xue, Xue, Xue, Xue, Xue, Xue, Xue
Xue, Xue, Xue, Xue, Xue, Xue, Xue, Xue, Xue, Xue, Xue, Xue, Xue, Xue, Xue, Xue, Xue, Xue, Xue, Xue, Xue, Xue, Xue, Xue, Xue, Xue, Xue, Xue, Xue, Uu^Ufi, Uue, Uue^Ii, Uu^Ufi, Uue, Uu^Ufi, Xue, Xue, Xue, Xue, Xue, Xue, Xue, Xue, Xue, Xue, Xue, Xue, Xue, Xue, Xue, Xue, Xue, Xue, Xue, Xue, Xue, Xue, Xue, Xue, Xue
Xue, Xue, Xue, Xue, Xue, Xue, Xue, Xue, Xue, Xue, Xue, Xue, Xue, Xue, Xue, Xue, Xue, Xue, Xue, Xue, Xue, Xue, Xue, Xue, Xue, Xue, Xue, Xue, Uh^Ii, Uh^Ii, Uue^Ii, Uh^Ii, Uh^Ii, Uue, Xue, Xue, Xue, Xue, Xue, Xue, Xue, Xue, Xue, Xue, Xue, Xue, Xue, Xue, Xue, Xue, Xue, Xue, Xue, Xue, Xue, Xue, Xue, Xue, Xue, Xue
Xue, Xue, Xue, Xue, Xue, Xue, Xue, Xue, Xue, Xue, Xue, Xue, Xue, Xue, Xue, Xue, Xue, Xue, Xue, Xue, Xue, Xue, Xue, Xue, Xue, Xue, Xue, Xue, Uh^Ii, Uu^Ufi, Uue, Uue, Uue, Uue^Ii, Uh^Ii, Xue, Xue, Xue, Xue, Xue, Xue, Xue, Xue, Xue, Xue, Xue, Xue, Xue, Xue, Xue, Xue, Xue, Xue, Xue, Xue, Xue, Xue, Xue, Xue, Xue
Xue, Xue, Xue, Xue, Xue, Xue, Xue, Xue, Xue, Xue, Xue, Xue, Xue, Xue, Xue, Xue, Xue, Xue, Xue, Xue, Xue, Xue, Xue, Xue, Xue, Xue, Xue, Xue, Xue, Uu^Ufi, Uue, Xue, Uue, Uue, Uu^Ufi, Uh^Ii, Xue, Xue, Xue, Xue, Xue, Xue, Xue, Xue, Xue, Xue, Xue, Xue, Xue, Xue, Xue, Xue, Xue, Xue, Xue, Xue, Xue, Xue, Xue, Xue
Xue, Xue, Xue, Xue, Xue, Xue, Xue, Xue, Xue, Xue, Xue, Xue, Xue, Xue, Xue, Xue, Xue, Xue, Xue, Xue, Xue, Xue, Xue, Xue, Xue, Xue, Xue, Xue, Xue, Xue, Uue, Xue, Uue^Ii, Uue, Uh^Ii, Uh^Ii, Xue, Xue, Xue, Xue, Xue, Xue, Xue, Xue, Xue, Xue, Xue, Xue, Xue, Xue, Xue, Xue, Xue, Xue, Xue, Xue, Xue, Xue, Xue, Xue
Xue, Xue, Xue, Xue, Xue, Xue, Xue, Xue, Xue, Xue, Xue, Xue, Xue, Xue, Xue, Xue, Xue, Xue, Xue, Xue, Xue, Xue, Xue, Xue, Xue, Xue, Xue, Xue, Xue, Uu^Ufi, Uu^Ii, Uue^Ii, Uue, Uu^Ufi, Uh^Ii, Uh^Ii, Xue, Xue, Xue, Xue, Xue, Xue, Xue, Xue, Xue, Xue, Xue, Xue, Xue, Xue, Xue, Xue, Xue, Xue, Xue, Xue, Xue, Xue, Xue, Xue
Xue, Xue, Xue, Xue, Xue, Xue, Xue, Xue, Xue, Xue, Xue, Xue, Xue, Xue, Xue, Xue, Xue, Xue, Xue, Xue, Xue, Xue, Xue, Xue, Xue, Xue, Xue, Xue, Xue, Uh^Ii, Uh, Uue, Uue, Uu^Ufi, Xue, Xue, Xue, Xue, Xue, Xue, Xue, Xue, Xue, Xue, Xue, Xue, Xue, Xue, Xue, Xue, Xue, Xue, Xue, Xue, Xue, Xue, Xue, Xue, Xue, Xue
