Md, Md, Md, Md, Md, Md, Md, Md, Md, Md, Md, Md, Md, Md, Hhd^Fts, Hhd^Fts, Gd^Fts, Gd^Fts, Gd^Fts, Gd^Fts, Gd^Fts, Gs, Gd, Gs, Gd, Gs, Gd^Fts, Gs, Gd^Fts, Gs, Gd, Gs, Gs^Es, Gd^Fts, Gd, Gs, Gs, Gs, Gd^Fts, Gs, Gs, Gs, Gd, Gs, Gd^Es, Gd, Gs, Gd, Gs, Gs, Gd, Gs, Gd^Es, Gs, Gs, Gs, Rmo, Gs, Gs^Es, Gs, Gs, Gs, Gd, Gs, Gs, Gs, Gd, Gs, Gs, Gd, Gs, Gs, Gs, Gs, Gs, Gs, Gs^Gvs, Gs^Gvs, Gs^Gvs, Gs, Gs, Gs, Hhd^Fts, Hhd^Fts, Hhd^Fts, Hhd^Fts, Hhd^Fts, Hhd^Fts
Md, Md, Md, Md, Md, Md, Md, Md, Md, Md, Md, Md, Hhd^Fts, Hhd^Fts, Hhd^Fts, Hhd^Fts, Gd^Fts, Gd^Fts, Gd^Fts, Gd^Fts, Gd^Fts, Gd^Fts, Gd^Fts, Gd^Fts, Gd^Fts, Gd^Fts, Gd, Gd, Gd, Gd^Fts, Gs, Gd^Es, Gd^Fts, Gs^Es, Gd, Gd^Fts, Gd^Fts, Gd^Fts, Gd, Gs, Gs, Gs^Es, Gs, Gd, Gs, Gd, Gs^Es, Gs, Gs^Es, Gs, Gd^Es, Gs^Es, Gs, Gs, Wwt, Gs, Rmo, Gs, Wwt, Gs^Es, Gs, Gs^Es, Gd^Es, Gs^Es, Gd, Gd, Gs, Gs^Es, Gd, Gs^Es, Gs, Gs^Es, Gd^Es, Gd, Gs, Gs^Gvs, Gs^Gvs, Gs^Gvs, Gs^Gvs, Gd^Gvs, Gs, Gd, Gs, Hhd^Fts, Gd, Hhd^Fts, Hhd^Fts, Hhd^Fts
Md, Md, Md, Md, Md, Md, Md, Md, Md, Md, Md, Md, Hhd^Fts, Hhd^Fts, Hhd^Fts, Hhd^Fts, Hhd^Fts, Gd^Fts, Gd^Fts, Gd^Fts, Gd^Fts, Gd, Gs, Gs, Gs, Gd^Fts, Gd, Gs, Gd, Gd^Fts, Gs, Gd, Gd^Fts, Gd, Gs^Es, Gd^Fts, Gd, Gd, Gs^Es, Gd, Gs, Gd, Gs, Gs, Gs, Gs, Gs, Gd, Gd, Gs, Gd, Gs, Gs, Wwt, Car, Wwt, Wwt^Bw|, Wwt, Car, Wwt, Gs, Gs, Gs, Gd, Gs, Gs^Es, Gd, Gs, Gd, Gd, Gs, Gs, Gs, Gd, Gs, Gs^Es, Gd, Gd^Gvs, Gs, Gs, Gd^Gvs, Gs^Es, Gs, Gs, Gd, Gd, Hhd^Fts, Hhd^Fts
Md, Md, Md, Md, Md, Md, Md, Md, Md, Md, Md, Md, Md, Hhd^Fts, Hhd^Fts, Hhd^Fts, Hhd^Fts, Gd^Fts, Gd^Fts, Gd^Fts, Gd^Fts, Gd^Fts, Gd^Fts, Gs, Gs^Es, Gs, Gs, Gd^Fts, Gs, Gd^Es, Gd^Fts, Gd^Fts, Gd^Fts, Gd^Fts, Gd, Gd^Es, Gd, Gs^Es, Gs, Gs, Gs, Gs, Wwt, Wwt, Wwt, Gs, Wwt, Gs, Wwt, Gs, Wwt, Gs, Wwt, Wwt, Car, Gd, Rmo, Gs, Car, Wwt, Wwt, Gs, Wwt, Gs, Wwt, Gs, Wwt, Gs, Wwt, Wwt, Wwt, Gs, Gs, Gd, Gs, Gs, Gs, Gd, Gd^Gvs, Gs^Gvs, Gs^Gvs, Gd^Gvs, Gs^Gvs, Gs^Es, Gd, Gd, Hhd^Fts, Hhd^Fts
Md, Md, Md, Md, Md, Md, Md, Md, Md, Md, Md, Md, Md, Md, Hhd^Fts, Hhd^Fts, Hhd^Fts, Gd^Fts, Gd^Fts, Gd^Fts, Gd^Fts, Gd^Fts, Gd^Fts, Gs^Es, Gs, Gs, Gd^Fts, Gs, Gs^Es, Gd, Gd^Fts, Gd, Gs, Gd^Fts, Gs, Gs, Gd, Gs, Gs, Gs, Wwt, Wwt, Car, Car, Car, Wwt, Car, Wwt, Car, Wwt, Car, Wwt, Car, Car, Gd, Gs, Rmo, Gd, Gs, Car, Car, Wwt, Car, Wwt, Car, Wwt, Car, Wwt, Car, Car, Car, Wwt, Wwt, Gs, Gs, Gs^Es, Gs^Es, Gs, Gs, Gs^Gvs, Gs^Gvs, Gs^Gvs, Gd, Gs^Es, Gd^Gvs, Gs, Gd, Gs
Md, Md, Md, Md, Md, Md, Md, Md, Md, Md, Md, Md, Md, Md, Hhd^Fts, Hhd^Fts, Hhd^Fts, Hhd^Fts, Gd^Fts, Gd^Fts, Gd^Fts, Gd^Fts, Gd^Fts, Gs^Es, Gd, Gd^Fts, Gd^Fts, Gd, Gs^Es, Gd^Fts, Gd, Gd^Fts, Gd, Gd^Fts, Gs, Gd, Gs, Gs, Wwt, Wwt, Car, Car, Gd, Gd, Gs, Car, Rmo, Car, Gs, Car, Gd, Car, Gs, Gd, Rmo, Rmo, Rmo, Rmo, Rmo, Gd, Gd, Car, Gs, Car, Gs, Car, Rmo, Car, Gd, Gd, Gs, Car, Car, Wwt, Wwt, Gs, Gs, Gd, Gs^Es, Gs, Gd, Gd, Gd^Gvs, Gs^Gvs, Gs^Gvs, Gd^Gvs, Gd^Gvs, Gs
Md, Md, Md, Md, Md, Md, Md, Md, Md, Md, Md, Md, Hhd^Fts, Hhd^Fts, Hhd^Fts, Hhd^Fts, Hhd^Fts, Gd^Fts, Gd^Fts, Gd^Fts, Gd^Fts, Gd^Fts, Gd, Gd^Fts, Gd^Es, Gs, Gd, Gd^Fts, Gs, Gs^Es, Gd, Gd^Fts, Gs, Gd^Fts, Gs, Gd, Gs, Wwt, Car, Car, Gs, Gd, Wwg, Wwg, Wwg, Gs, Wwg^Bw|, Gs, Wwg, Gs, Gd, Gs, Rmo, Rmo, Gs, Gd, Rmo, Gs, Gs, Rmo, Rmo, Gd, Gd^Xfw, Gs, Gd, Gd, Rmo, Gs, Wwg, Wwg, Wwg, Gs, Gd, Car, Car, Wwt, Gs, Gd, Gd, Gs^Es, Gd^Gvs, Gd, Gd^Es, Gs^Gvs, Gd^Gvs, Gs^Gvs, Gs, Gs
Md, Md, Md, Md, Md, Md, Md, Md, Md, Md, Md, Md, Hhd^Fts, Hhd^Fts, Hhd^Fts, Hhd^Fts, Hhd^Fts, Gd^Fts, Gd^Fts, Gd^Fts, Gd^Fts, Gd^Fts, Gd, Gs, Gd^Fts, Gd^Fts, Gd, Gd^Fts, Gs, Gd^Es, Gd^Es, Gs, Gs, Gd, Gs^Es, Gd^Es, Gs, Wwt, Car, Gs, Gd, Wwg, Car, Car, Car, Wwg, Rmo, Wwg, Rmo, Wwg, Wwg, Rmo, Gd, Gs, Gd^Var, Gd, Rmo, Gd, Gd^Var, Gd, Gd, Rmo, Rmo, Gd, Rmo, Gd^Var, Rmo, Wwg, Car, Car, Car, Wwg, Gs, Gs, Car, Wwt, Gd, Gs, Gd^Gvs, Gs^Gvs, Gs^Gvs, Gd^Gvs, Gs^Gvs, Gs, Gd, Gd^Es, Gs^Gvs, Gs^Gvs
Md, Md, Md, Md, Md, Md, Md, Md, Md, Md, Md, Md, Md, Hhd^Fts, Hhd^Fts, Hhd^Fts, Hhd^Fts, Hhd^Fts, Hhd^Fts, Gd^Fts, Gd^Fts, Gd^Fts, Gd^Fts, Gs, Gd^Fts, Gs, Gs, Gd, Gd, Gs, Gs, Gs^Es, Gs, Gd, Gs, Gd, Gs, Wwt, Car, Gd, Gd, Wwg, Car, Kar, Car, Wwg^Bw/, Gs, Rmo, Gs, Rmo, Gs, Wwg, Wwg, Gd, Gs, Gs, Kar, Gs, Gs, Gs, Wwg, Gs, Rmo, Rmo, Wwg, Rmo, Gd, Wwg^Bw\, Car, Kar, Car, Wwg, Gd, Gd, Car, Wwt, Gd^Es, Gs, Gd, Gs^Gvs, Gs^Gvs, Gs^Gvs, Gs, Gd, Gs, Gs^Gvs, Gs^Gvs, Gs^Gvs
Md, Md, Md, Md, Md, Md, Md, Md, Md, Md, Md, Md, Md, Md, Md, Hhd^Fts, Hhd^Fts, Hhd^Fts, Hhd^Fts, Hhd^Fts, Gd^Fts, Gd^Fts, Gd^Fts, Gd^Fts, Gd^Fts, Gs, Gd^Fts, Gd, Gd^Fts, Gd^Fts, Gd^Es, Gs^Es, Gs^Es, Gd, Gd, Gs, Wwt, Wwt, Car, Gs, Gd, Wwg, Wwg, Car, Wwg, Wwg, Arrw, Arrw, Gd^Fts, Rmo, Rmo, Gd, Gd^Xfw, Wwg, Car, Car, Wwg^Bw|, Car, Car, Wwg, Rmo, Wwg^Bw/, Wwg, Wwg^Bw\, Rmo, Wwg, Wwg, Wwg, Wwg, Car, Wwg, Wwg, Gd, Gd, Car, Wwt, Wwt, Gd, Gs, Gd, Gd, Gs^Es, Gs^Gvs, Gd^Gvs, Gs^Gvs, Gd, Gs^Es, Gs^Gvs
Md, Md, Md, Md, Md, Md, Md, Md, Md, Md, Md, Md, Md, Md, Md, Md, Hhd^Fts, Hhd^Fts, Hhd^Fts, Hhd^Fts, Hhd^Fts, Gd^Fts, Gd^Fts, Gd^Fts, Gd^Fts, Gs, Gs, Gs, Gs, Gs^Es, Gd, Gs, Gs, Gs, Wwt, Wwt, Car, Car, Gd, Gs, Wwg, Wwg, Gs, Wwg^Bw|, Gs, Gd^Fts, Arrw, Gd^Fts, Gd^Var, Gs, Rmo, Gs, Wwg, Wwg, Gd, Wwg, Rmo, Wwg, Gs, Gs, Rmo, Rmo, Wwg, Gd, Gd, Rmo, Rmo, Wwg, Gd, Wwg, Gs, Gd, Gd^Var, Gs, Gs, Car, Car, Wwt, Wwt, Gs, Gs, Gs^Gvs, Gd^Gvs, Gs^Gvs, Gs^Gvs, Gd^Gvs, Gs, Gs
Md, Md, Md, Md, Md, Md, Md, Md, Md, Md, Md, Md, Md, Md, Md, Md, Md, Hhd^Fts, Hhd^Fts, Hhd^Fts, Hhd^Fts, Gd^Fts, Gd^Fts, Gd^Fts, Gd^Fts, Gd^Fts, Gd^Fts, Gd^Fts, Gd, Gd^Es, Gs^Es, Gs, Gs, Wwt, Car, Car, Gs, Gd, Gs, Gs, Wwg, Gs, Rmo, Rmo, Rmo, Gd^Fts, Gd^Fts, Arrw, Gs, Gs, Wwg, Wwg^Bw\, Rmo, Gs, Gd, Wwg, Rmo, Wwg, Gs, Gd, Rmo, Gd, Wwg, Gs, Gd, Gs, Rmo, Rmo, Rmo, Wwg, Gs, Gs, Gd, Gd, Gs, Gd, Gs, Car, Car, Wwt, Gs, Gs, Gd^Es, Gs^Gvs, Gs, Gd^Es, Gs, Gs
Md, Md, Md, Md, Md, Md, Md, Md, Md, Md, Md, Md, Md, Md, Md, Md, Md, Md, Md, Hhd^Fts, Hhd^Fts, Gd^Fts, Gd^Fts, Gd^Fts, Gs, Gd^Fts, Gd, Gs, Gs, Gs, Gs, Gd, Gs, Wwt, Car, Rmo, Rmo, Gd, Gs, Wwg, Gd^Fts, Rmo, Gd, Gd^Var, Gs, Rmo, Rmo, Gs, Car, Car, Gs, Gd, Gd^Var, Rmo, Rmo, Wwg^Bw/, Wwg^Bsb|, Wwg^Bw\, Rmo, Gd^Xfw, Rmo, Gs, Gd, Car, Car, Gs, Rmo, Gd^Fts, Gd, Wwg^Bw\, Rmo, Rmo, Rmo, Rmo, Rmo, Gd, Rmo, Rmo, Car, Wwt, Gs, Gs, Gs, Gd^Es, Gd, Gs, Gd, Gs
Md, Md, Md, Md, Md, Md, Md, Md, Md, Md, Md, Md, Md, Md, Md, Md, Md, Md, Md, Hhd^Fts, Hhd^Fts, Gd^Fts, Gd^Fts, Gd^Fts, Gs, Gd^Fts, Gs, Gd^Fts, Gs, Gs, Gd, Gd^Es, Gs, Wwt, Car, Gs, Gd^Xfw, Gs, Gd^Var, Wwg, Wwg, Wwg^Bw|, Wwg, Arrw, Arrw, Gd, Gs, Kar, Rmo, Wwg, Wwg, Gd, Rmo, Rmo, Wwg, Wwg, Kar, Wwg, Wwg, Rmo, Rmo, Gd, Wwg, Wwg, Rmo, Kar, Gs, Gd, Gs, Wwg, Wwg, Wwg^Bw|, Wwg, Gs, Gs, Rmo, Gs, Gs, Car, Wwt, Gs, Gs, Gd, Gs, Gd^Es, Gd, Gs^Es, Gd
Md, Md, Md, Md, Md, Md, Md, Md, Md, Md, Md, Md, Md, Md, Md, Md, Md, Md, Hhd^Fts, Hhd^Fts, Hhd^Fts, Gd^Fts, Gd^Fts, Gd^Fts, Gd^Fts, Gd^Fts, Gs, Gd, Gd^Fts, Gs, Gs^Es, Gs, Gs, Wwt, Car, Gd, Rmo, Gd, Gd, Wwg, Car, Car, Car, Wwg, Arrw, Gd, Gs, Car, Wwg, Rmo, Rmo, Wwg^Bw/, Wwg, Wwg, Kar, Car, Rmo, Car, Kar, Wwg, Wwg, Wwg^Bw\, Rmo, Rmo, Wwg, Car, Gs, Gd^Xfw, Gs, Wwg, Car, Car, Car, Wwg, Gd, Gd, Gd, Gs, Car, Wwt, Gs, Gs^Es, Gs, Gs, Gs, Gd^Es, Gs, Gs
Md, Md, Hhd^Fts, Md, Hhd^Fts, Md, Md, Md, Md, Md, Md, Md, Hhd^Fts, Md, Md, Md, Md, Md, Hhd^Fts, Hhd^Fts, Gd^Fts, Gd^Fts, Re^Vct, Gd^Fts, Gd^Fts, Gd, Gd, Gd^Fts, Gs, Gs, Gd^Es, Gd, Gs, Wwt, Car, Gd, Rmo, Gs, Wwg, Wwg, Car, Kar, Car, Wwg, Arrw, Gd, Gs, Car, Gs, Wwg, Wwg^Bw|, Wwg^Bsb\, Rmo, Rmo, Rmo, Car, Car, Rmo, Wwg^Bsb\, Wwg, Rmo, Wwg^Bsb/, Wwg^Bw|, Wwg, Gs, Car, Gs, Gd, Gs, Wwg, Car, Kar, Car, Wwg, Gd, Gd^Fts, Gd^Fts, Gs, Car, Wwt, Wwt, Gs, Gs^Es, Gs, Gd, Gs, Gs, Gs
Hhd^Fts, Hhd^Fts, Hhd^Fts, Hhd^Fts, Hhd^Fts, Hhd^Fts, Hhd^Fts, Hhd^Fts, Hhd^Fts, Hhd^Fts, Hhd^Fts, Hhd^Fts, Hhd^Fts, Hhd^Fts, Hhd^Fts, Hhd^Fts, Hhd^Fts, Hhd^Fts, Hhd^Fts, Hhd^Fts, Ce, Gd^Fts, Gd^Fts, Gd^Fts, Gd^Fts, Gd^Fts, Gd^Fts, Gd^Fts, Gs, Gd, Gs, Gd^Es, Gs, Wwt, Car, Gs, Wwg, Wwg^Bw\, Rmo, Wwg, Wwg, Car, Wwg, Wwg, Gd, Gs, Gs, Wwg, Gd, Gs, Rmo, Wwg, Kar, Rmo, Car, Rmo, Car, Rmo, Wwg, Rmo, Kar, Wwg, Rmo, Gs, Gd^Fts, Wwg, Gs, Gd^Var, Gd^Fts, Wwg, Wwg, Car, Wwg, Wwg, Gs, Gd^Var, Gd, Gs, Car, Wwt, Car, Wwt, Wwt, Gs, Gd, Gs, Gd^Es, Gd
Hhd^Fts, Hhd^Fts, Md, Md, Md, Hhd^Fts, Md, Hhd^Fts, Hhd^Fts, Hhd^Fts, Md, Md, Md, Md, Hhd^Fts, Hhd^Fts, Hhd^Fts, Hhd^Fts, Hhd^Fts, Ce, 1 Ke, Ce, Gd^Fts, Gd^Fts, Re^Vct, Gd^Fts, Gd^Fts, Gd^Fts, Gs, Gd^Fts, Gd, Gs^Es, Gs, Wwt, Wwg, Wwg, Gs, Gd, Gd^Fts, Rmo, Gd, Wwg^Bw|, Gs, Gs, Arrw, Gd, Gs, Wwg, Gd^Xfw, Gd, Rmo, Wwg, Car, Rmo, Rmo, 2 Kar, Wwg^Bsb\, Wwg, Rmo, Rmo, Car, Wwg, Rmo, Gd, Gd^Fts, Wwg, Gd, Gd^Fts, Gs, Wwg, Gd, Wwg^Bw|, Gs, Gs, Rmo, Gs, Gd, Gs, Gs, Car, Gs, Car, Wwt, Gs, Gs, Gd, Gs, Gs
Hhd^Fts, Hhd^Fts, Hhd^Fts, Md, Hhd^Fts, Md, Md, Md, Hhd^Fts, Hhd^Fts, Hhd^Fts, Hhd^Fts, Hhd^Fts, Md, Hhd^Fts, Hhd^Fts, Hhd^Fts, Hhd^Fts, Hhd^Fts, Ce, Ce, Ce, Gd^Fts, Gd^Fts, Gd^Fts, Gd, Gd^Fts, Gd^Fts, Gd, Gd^Fts, Gd, Gs, Gs, Wwt, Car, Gs, Gd, Gs, Rmo, Rmo, Rmo, Rmo, Gs, Arrw, Gd^Var, Gs, Gd, Wwg, Gs, Gd, Rmo, Wwg, Kar, Car, Car, Car, Wwg, Kar, Car, Car, Kar, Wwg, Rmo, Gd^Fts, Gs, Wwg, Gd, Gs, Gs, Wwg, Gd, Rmo, Rmo, Rmo, Gs, Rmo, Rmo, Rmo, Rmo, Rmo, Rmo, Rmo, Wwt^Bw/, Rmo, Rmo, Rmo, Rmo, Rmo
Md, Hhd^Fts, Hhd^Fts, Hhd^Fts, Hhd^Fts, Hhd^Fts, Hhd^Fts, Hhd^Fts, Hhd^Fts, Hhd^Fts, Md, Hhd^Fts, Md, Hhd^Fts, Md, Hhd^Fts, Hhd^Fts, Hhd^Fts, Hhd^Fts, Hhd^Fts, Gd^Fts, Gd^Fts, Gd^Fts, Re^Vct, Gd^Fts, Gd^Fts, Gd^Fts, Gs, Gs^Es, Gd, Gd, Gs, Gs, Wwt, Car, Gs, Gd^Xfw, Rmo, Gd^Fts, Rmo, Gd^Fts, Rmo, Gs, Arrw, Arrw, Gs, Gd, Wwg, Gs, Gd, Wwg^Bw|, Wwg, Rmo, Rmo, Wwg^Bsb|, Wwg, Kar, Car, Rmo, Rmo, Rmo, Wwg, Wwg^Bw|, Gd, Gd, Wwg, Gs, Gd^Xfw, Gd, Wwg, Gs, Rmo, Gd, Gs, Gd^Xfw, Gs, Gs, Gs, Gs, Rmo, Gd, Rmo, Wwt, Gs, Gs, Gs, Gs^Es, Gs
Md, Md, Md, Hhd^Fts, Md, Hhd^Fts, Md, Hhd^Fts, Md, Md, Md, Md, Md, Md, Md, Md, Md, Hhd^Fts, Wwt, Hhd^Fts, Ww^Ewf, Re^Vct, Gd^Fts, Gd^Fts, Gd^Fts, Gd^Fts, Gd^Fts, Gd, Gd^Fts, Gd, Gd, Gs^Es, Gs, Wwt, Car, Rmo, Gd, Gd, Rmo, Rmo, Wwg, Wwg^Bw|, Wwg, Gd, Gs, Arrw, Gs, Car, Wwg, Wwg, Rmo, Wwg^Bsb/, Wwg, Wwg, Kar, Rmo, Car, Rmo, Kar, Rmo, Wwg, Wwg^Bsb\, Rmo, Wwg, Wwg, Car, Gs, Gd, Gd, Wwg, Wwg, Wwg^Bw|, Wwg, Gd, Gd, Gd, Gd^Fts, Gd, Car, Car, Car, Car, Wwt, Gs, Gs^Es, Gs, Gs, Gs
Md, Md, Md, Md, Md, Md, Md, Md, Md, Md, Md, Md, Md, Md, Md, Md, Wwt, Wwt, Md, Ww^Ewf, Hhd^Fts, Ww^Ewf, Wwt, Gd^Fts, Gd^Fts, Gd^Fts, Gd^Fts, Gd^Fts, Gd^Fts, Gs, Gd, Gs^Es, Gs, Wwt, Car, Gs, Gd^Var, Gd, Rmo, Wwg, Car, Car, Car, Wwg, Rmo, Arrw, Gs, Car, Rmo, Rmo, Wwg, Wwg^Bw\, Rmo, Wwg, Wwg, Car, Kar, Car, Wwg, Wwg, Rmo, Wwg^Bw/, Wwg, Rmo, Rmo, Car, Gs, Gs, Gd, Wwg, Car, Car, Car, Wwg, Gs, Gd^Fts, Gd^Fts, Gs, Car, Wwt, Wwt, Wwt, Gs, Gs^Es, Gd, Gd, Gs, Gs
Md, Md, Md, Md, Md, Md, Md, Md, Md, Md, Md, Md, Md, Md, Md, Md, Md, Md, Md, Hhd^Fts, Hhd^Fts, Hhd^Fts, Gd^Fts, Ww^Ewf, Ww^Ewf, Gd, Gd^Fts, Gd^Fts, Gs, Gs, Gs, Gs, Wwt, Wwt, Wwg, Gs, Gd, Gs, Rmo, Wwg, Car, Kar, Car, Wwg, Gs, Rmo, Rmo, Kar, Car, Wwg, Gs, Gs, Gs, Rmo, Rmo, Wwg, Wwg^Bsb|, Wwg, Rmo, Rmo, Gs, Gs, Gs, Wwg, Car, Kar, Rmo, Gd, Rmo, Wwg^Bw/, Car, Kar, Car, Wwg, Gs, Gd^Var, Gd, Gs, Car, Wwt, Gs, Gs, Gd^Es, Gd, Gs, Gd, Gs^Es, Gs
Md, Md, Md, Md, Md, Md, Md, Md, Md, Md, Md, Md, Md, Md, Md, Md, Md, Md, Hhd^Fts, Hhd^Fts, Hhd^Fts, Hhd^Fts, Gd^Fts, Gd^Fts, Gd^Fts, Wwt, Wwt, Gs, Ww^Ewf, Ww^Ewf, Ww^Ewf, Wwt, Gd, Wwt, Car, Wwg, Wwg, Gd, Rmo, Wwg, Wwg, Car, Wwg^Bw\, Wwg, Gd, Rmo, Gs, Gs, Gs, Car, Wwg, Gs, Gd^Xfw, Gs, Gs, Wwg^Bw\, Rmo, Wwg^Bw/, Gs, Gs, Gd^Xfw, Gs, Wwg, Car, Gs, Gs, Gs, Rmo, Rmo, Wwg, Wwg, Car, Wwg, Wwg, Gd, Gs, Gs, Gs, Car, Wwt, Gs, Gd, Gs, Gs^Es, Gs, Gd, Gs^Es, Gs
Md, Md, Md, Md, Md, Md, Md, Md, Md, Md, Md, Md, Md, Md, Md, Md, Md, Md, Hhd^Fts, Hhd^Fts, Hhd^Fts, Hhd^Fts, Gd^Fts, Gd^Fts, Gd^Fts, Gd^Fts, Gd^Fts, Wwt, Gd, Ww^Ewf, Gd, Gd, Gs, Wwt, Car, Gd, Rmo, Wwg^Bw/, Wwg, Gs, Gd, Wwg, Gs, Rmo, Gs, Rmo, Gd, Gd^Var, Gd, Gs, Wwg, Wwg, Wwg, Gs, Gs, Wwg, Rmo, Wwg, Gs, Gs, Wwg, Wwg, Wwg, Gs, Gs, Gs, Gs, Rmo, Gs, Rmo, Wwg^Bw\, Wwg, Gs, Gd, Rmo, Rmo, Rmo, Gs, Car, Wwt, Gs, Gd, Gs^Es, Gs, Gs, Gs, Gs, Gs
Md, Md, Md, Md, Md, Md, Md, Md, Md, Md, Md, Md, Md, Md, Md, Md, Md, Hhd^Fts, Hhd^Fts, Hhd^Fts, Hhd^Fts, Hhd^Fts, Gd^Fts, Gd^Fts, Gd^Fts, Gd^Fts, Gd, Gd^Fts, Gd^Fts, Wwt, Gs, Gs^Es, Gd, Wwt, Car, Rmo, Gs, Gs, Gd, Wwg, Wwg, Gd^Xfw, Gd, Rmo, Wwg^Bw\, Wwg^Bw|, Wwg, Gs, Wwg, Wwg, Gs, Gs, Gs, Wwg, Car, Wwg, Rmo, Wwg, Car, Wwg, Gd, Gs, Gd, Wwg, Wwg, Gs, Wwg, Wwg^Bw|, Wwg, Gs, Wwg, Rmo, Rmo, Rmo, Gd, Gs, Gs, Rmo, Car, Wwt, Gs, Gd, Gd^Es, Gs, Gd, Gd, Gs^Es, Gs
Md, Md, Md, Md, Md, Md, Md, Md, Md, Md, Md, Md, Md, Md, Md, Md, Md, Hhd^Fts, Hhd^Fts, Hhd^Fts, Hhd^Fts, Gd^Fts, Gd^Fts, Gd^Fts, Gd^Fts, Gd^Fts, Gd, Gd^Fts, Gd, Ww^Ewf, Gs, Gs^Es, Gs, Wwt, Wwt, Car, Car, Gd, Gs, Gs, Gs, Wwg, Wwg, Wwg, Car, Car, Car, Wwg, Gs, Gd^Xfw, Gd, Gd^Var, Gd, Gd, Gs, Car, Kar, Car, Gd, Gd, Gd, Gd^Var, Gs, Gd^Xfw, Gs, Wwg, Car, Car, Car, Wwg, Wwg, Gs, Gd, Gd, Gs, Gd, Car, Car, Wwt, Wwt, Gs, Gd, Gs, Gs, Gs, Gs, Gs^Es, Gs
Md, Md, Md, Md, Md, Md, Md, Md, Md, Md, Md, Md, Md, Md, Md, Md, Md, Hhd^Fts, Hhd^Fts, Hhd^Fts, Hhd^Fts, Gd^Fts, Gd^Fts, Gd^Fts, Gd^Fts, Gd^Fts, Gd^Fts, Gd^Fts, Wwt, Ww^Ewf, Gs, Gd, Gd, Gs, Gs, Wwt, Wwt, Car, Car, Gd, Gd^Var, Gd, Gs, Wwg, Car, Kar, Car, Wwg^Bw\, Rmo, Gs, Rmo, Gs, Rmo, Gs, Gd, Gd, Rmo, Gs, Gd, Gd, Rmo, Gs, Rmo, Gd, Rmo, Wwg^Bw/, Car, Kar, Car, Wwg, Gd, Gd^Var, Gd^Fts, Gs, Car, Car, Wwt, Wwt, Gs, Gs, Gs, Gd, Gs, Gd^Es, Gd, Gs, Gs^Es, Gs
Md, Md, Md, Md, Md, Md, Md, Md, Md, Md, Md, Md, Md, Md, Md, Md, Md, Md, Hhd^Fts, Hhd^Fts, Hhd^Fts, Gd^Fts, Gd^Fts, Gd^Fts, Gd^Fts, Gd^Fts, Gd^Fts, Gd, Ww^Ewf, Gs, Gd^Fts, Gs, Gd, Gs^Es, Gs, Gs, Gs, Wwt, Car, Gs, Gs, Gs, Rmo, Wwg^Bw/, Wwg, Car, Wwg^Bw|, Wwg, Gs, Rmo, Gs, Rmo, Gs, Rmo, Rmo, Gs, Rmo, Gs, Rmo, Rmo, Gs, Rmo, Gs, Rmo, Gs, Wwg, Wwg, Car, Wwg, Wwg^Bw\, Rmo, Gs, Gd, Gd, Car, Wwt, Gs^Es, Gs, Gs, Gs^Es, Gd, Gd, Gs, Gs, Gd, Gs, Gs, Gs
Md, Md, Md, Md, Md, Md, Md, Md, Md, Md, Md, Md, Md, Md, Md, Md, Md, Md, Hhd^Fts, Hhd^Fts, Hhd^Fts, Hhd^Fts, Gd^Fts, Gd^Fts, Gd^Fts, Gd^Fts, Gd^Fts, Gd^Fts, Ww^Ewf, Gd^Fts, Gd^Fts, Gs, Gd, Gd^Es, Gd^Es, Gs, Gs, Wwt, Car, Gd, Rmo, Rmo, Gs, Gd, Gs, Wwg, Rmo, Gs, Gd^Var, Gs, Gd^Fts, Gs, Gd^Fts, Gs, Gs, Rmo, Rmo, Rmo, Gs, Gd, Gd, Gd, Gd^Fts, Gs, Gd^Fts, Gs, Gs, Wwg^Bw|, Gd, Gs, Gs, Rmo, Rmo, Gs, Car, Wwt, Gs^Es, Gs, Gd, Gd, Gs, Gd^Fts, Gs, Gs, Gd, Gs, Gs, Gs^Es
Md, Md, Md, Md, Md, Md, Md, Md, Md, Md, Md, Md, Md, Md, Md, Md, Md, Md, Hhd^Fts, Hhd^Fts, Hhd^Fts, Hhd^Fts, Hhd^Fts, Gd^Fts, Gd^Fts, Gd^Fts, Gd^Fts, Gd, Wwt, Gd^Fts, Gd, Gd^Fts, Gs, Gs, Gd^Es, Gs, Gs, Wwt, Car, Rmo, Gs, Gs, Gd, Gd^Var, Gd, Gs, Rmo, Gd, Gd, Gd, Gs, Gd^Fts, Gd^Var, Gd^Fts, Gd, Gs, Rmo, Gs, Gd, Gd^Var, Gs, Gs, Gd^Fts, Gd^Var, Gs, Gd, Gs, Rmo, Gs, Gd^Fts, Gd^Fts, Gd, Gs, Rmo, Car, Wwt, Gs, Gs, Gd^Fts, Gs, Gd^Es, Gd^Es, Gd^Es, Gd, Gs, Gd^Es, Gs, Gs
Md, Md, Md, Md, Md, Md, Md, Md, Md, Md, Md, Md, Md, Md, Md, Md, Md, Md, Md, Hhd^Fts, Hhd^Fts, Hhd^Fts, Hhd^Fts, Hhd^Fts, Gd^Fts, Gd^Fts, Gd^Fts, Gd^Fts, Wwt, Gd^Fts, Gd^Fts, Gs, Gd^Fts, Gs, Gd, Gs, Gs, Wwt, Wwt, Car, Car, Gd, Gs, Gs, Gd, Gs, Rmo, Gs, Gs, Gd, Gs, Gs, Gs, Gd^Fts, Gd, Gs, Rmo, Gd, Gs, Gs, Gd, Gd, Gs, Gs, Gs, Gd, Gs, Rmo, Gs, Gd^Fts, Gs, Gd, Car, Car, Wwt, Wwt, Gs, Gs, Gs, Gs, Gs, Gd, Gs, Gd, Gs, Gs, Gs^Es, Gs
Md, Md, Md, Md, Md, Md, Md, Md, Md, Md, Md, Md, Md, Md, Md, Md, Md, Md, Md, Md, Md, Hhd^Fts, Hhd^Fts, Hhd^Fts, Hhd^Fts, Gd^Fts, Ww^Ewf, Ww^Ewf, Gd^Fts, Gd^Fts, Gd^Fts, Gd^Fts, Gs, Gd, Gd^Es, Gs, Gs^Es, Gd, Gd, Wwt, Wwt, Car, Car, Gs, Car, Car, Car, Car, Car, Car, Car, Car, Car, Gs, Gd, Gs, Rmo, Gs, Gd, Gd, Car, Car, Car, Car, Car, Car, Car, Car, Car, Gd, Car, Car, Wwt, Wwt, Gs, Gs, Gs, Gd^Fts, Gd, Gs, Gd^Fts, Gs, Gd^Fts, Gs, Gs, Gd^Es, Gs, Gs
Md, Md, Md, Md, Md, Md, Md, Md, Md, Md, Md, Md, Md, Md, Md, Md, Md, Md, Md, Md, Md, Hhd^Fts, Hhd^Fts, Hhd^Fts, Hhd^Fts, Gd^Fts, Ww^Ewf, Gd^Fts, Gd^Fts, Gd^Fts, Gd, Gs, Gd, Gs, Gd, Gd, Gd, Gd, Gs, Gs, Gs, Wwt, Wwt, Car, Wwt, Wwt, Wwt, Wwt, Wwt, Wwt, Wwt, Wwt, Wwt, Car, Car, Gs, Rmo, Gs, Car, Car, Wwt, Wwt, Wwt, Wwt, Wwt, Wwt, Wwt, Wwt, Wwt, Car, Wwt, Wwt, Gs, Gs, Gs^Es, Gs^Es, Gs^Es, Gd, Gd^Fts, Gs^Es, Gs^Es, Gd, Gd, Gs, Gd^Fts, Gd, Gd, Gd^Fts
Md, Md, Md, Md, Md, Md, Md, Md, Md, Md, Md, Md, Md, Md, Md, Md, Md, Md, Md, Md, Hhd^Fts, Hhd^Fts, Hhd^Fts, Hhd^Fts, Gd^Fts, Gd^Fts, Wwt, Gd^Fts, Gd^Fts, Gd^Fts, Gd^Fts, Gd, Gd, Gd, Gs, Gd^Es, Gd, Gd, Gs^Es, Gd, Gs, Gs, Gd, Wwt, Gs, Gs, Gs, Gs, Gs, Gd, Gd, Gs, Gs, Wwt, Car, Gs, Rmo, Gs, Car, Wwt, Gs, Gs, Gd, Gd, Gd, Gs, Gs, Gd, Gs, Wwt, Gs, Gs^Es, Gd^Es, Gs, Gd, Gd^Es, Gd^Es, Gd, Gd^Fts, Gs, Gs, Gs, Gd^Fts, Gd^Fts, Gd, Gd^Es, Gd, Gs
Md, Md, Md, Md, Md, Md, Md, Md, Md, Md, Md, Md, Md, Md, Md, Md, Md, Md, Md, Md, Hhd^Fts, Hhd^Fts, Hhd^Fts, Hhd^Fts, Ww^Ewf, Ww^Ewf, Gd^Fts, Gd^Fts, Gd^Fts, Gs, Gd^Fts, Gs, Gd, Gd, Gd, Gd, Gd, Gd, Gd, Gd^Es, Gs, Gs, Gs, Gs, Gs^Es, Gs, Gd, Gd, Gd, Gs, Gd^Es, Gd, Gs, Wwt, Wwt, Wwt, Wwt^Bw|, Wwt, Wwt, Wwt, Gd, Gd, Gd, Gs^Es, Gd^Fts, Gd, Gs, Gd^Es, Gd, Gs, Gs^Es, Gs^Es, Gd^Fts, Gd, Gs, Gd, Gs, Gd, Gs, Gd, Gd, Gs, Gd^Fts, Gd^Es, Gs, Gd^Es, Gs, Gs
Md, Md, Md, Md, Md, Md, Md, Md, Md, Md, Md, Md, Md, Md, Md, Md, Md, Md, Hhd^Fts, Hhd^Fts, Hhd^Fts, Hhd^Fts, Wwt, Ww^Ewf, Gd^Fts, Gd^Fts, Gd, Gd^Fts, Gd^Fts, Gs, Gd^Fts, Gs, Gs^Es, Gs, Gs, Gs^Es, Gs, Gd^Fts, Gd^Fts, Gd, Gd, Gd, Gd, Gd^Es, Gd, Gs, Gd^Fts, Gd^Fts, Gs, Gs, Gd, Gd, Gs, Gs, Gs^Es, Gs, Rmo, Gs, Gd^Fts, Gs, Gd, Gd^Fts, Gd^Fts, Gd^Es, Gd, Gd^Fts, Gd, Gd, Gs, Gd, Gs, Gs^Es, Gs, Gd, Gs, Gs^Es, Gs, Gd, Gd, Gs^Es, Gd, Gd^Fts, Gd, Gd, Gd^Fts, Gs, Gd^Fts, Gd^Fts
Md, Md, Md, Md, Md, Md, Md, Md, Md, Md, Md, Md, Md, Md, Md, Md, Hhd^Fts, Hhd^Fts, Wwt, Ww^Ewf, Ww^Ewf, Ww^Ewf, Hhd^Fts, Hhd^Fts, Gd^Fts, Gd, Gd, Gd^Fts, Gd, Gd^Fts, Gd^Fts, Gs, Gs, Gd^Es, Gd, Gs, Gd, Gd^Fts, Gd, Gd^Fts, Gd^Fts, Gd, Gd^Fts, Gs, Gs, Gd^Fts, Gs^Es, Gd, Gd, Gd^Fts, Gd^Fts, Gs, Gs^Es, Gs, Gs^Es, Gs, Rmo, Gs, Gd^Fts, Gd^Es, Gs^Es, Gd, Gs, Gd^Fts, Gd, Gd^Fts, Gs, Gs, Gd^Es, Gd^Fts, Gs, Gd, Gd^Fts, Gd, Gs, Gd, Gd^Es, Gd, Gd^Fts, Gs^Es, Gs, Gd, Gd^Fts, Gs, Gd^Fts, Gd^Fts, Hhd^Fts, Hhd^Fts
Md, Md, Md, Md, Md, Md, Md, Md, Md, Md, Md, Md, Md, Wwt, Wwt, Wwt, Wwt, Wwt, Hhd^Fts, Hhd^Fts, Hhd^Fts, Hhd^Fts, Gd^Fts, Gd^Fts, Gd^Fts, Gd^Fts, Gd^Fts, Gs, Gs, Gd^Fts, Gs, Gd^Fts, Gd, Gs, Gs^Es, Gd, Gs, Gd, Gd^Fts, Gd, Gd^Fts, Gd^Fts, Gd^Fts, Gd, Gs, Gd^Fts, Gd^Fts, Gd^Fts, Gd^Es, Gd, Gs, Gd, Gd, Gd^Fts, Gs, Gs, Rmo, Gs, Gs^Es, Gd^Fts, Gd, Gd, Gd^Es, Gs, Gd^Fts, Gd^Es, Gd^Fts, Gd^Fts, Gs^Es, Gs^Es, Gd^Es, Gs, Gd, Gd, Gd^Es, Gs^Es, Gd^Es, Gs, Gd^Fts, Gd, Gd^Fts, Gd^Fts, Gd^Fts, Gd^Fts, Hhd^Fts, Hhd^Fts, Hhd^Fts, Hhd^Fts
Md, Md, Md, Md, Md, Md, Md, Md, Md, Md, Md, Md, Md, Md, Md, Hhd^Fts, Hhd^Fts, Hhd^Fts, Hhd^Fts, Hhd^Fts, Hhd^Fts, Gd^Fts, Gd^Fts, Gd^Fts, Gd^Fts, Gd^Fts, Gd^Fts, Gd, Gd^Fts, Gd^Fts, Gd^Fts, Gd^Fts, Gs, Gd, Gd^Es, Gd, Gd^Fts, Gs, Gs, Gd^Fts, Gs, Gd, Gs, Gs, Gd, Gs, Gd, Gd, Gs, Gd^Fts, Gd^Fts, Gd, Gs, Gd, Gs^Es, Gs, Rmo, Gs, Gs, Gs, Gd^Fts, Gs, Gs, Gs, Gd, Gd, Gd^Fts, Gs, Gs, Gd^Es, Gd, Gd, Gd, Gs, Gd, Gd, Gs, Gd, Gd^Fts, Gd^Fts, Gd, Gd^Fts, Gd^Fts, Hhd^Fts, Hhd^Fts, Hhd^Fts, Hhd^Fts, Hhd^Fts
Md, Md, Md, Md, Md, Md, Md, Md, Md, Md, Md, Md, Md, Md, Md, Md, Md, Hhd^Fts, Hhd^Fts, Hhd^Fts, Hhd^Fts, Hhd^Fts, Gd^Fts, Gd^Fts, Gd^Fts, Gd^Fts, Gd^Fts, Gd^Fts, Gs, Gd^Fts, Gs, Gs, Gs, Gs, Gs^Es, Gd^Fts, Gd, Gs, Gs, Gs, Gd^Fts, Gs, Gd^Fts, Gd, Gs, Gd^Es, Gs, Gs, Gd^Fts, Gs, Gs, Gd^Fts, Gd^Fts, Gs, Gd^Es, Gd, Rmo, Gs, Gs^Es, Gd^Es, Gd, Gd, Gd^Fts, Gd^Fts, Gd^Fts, Gd^Fts, Gd, Gd^Fts, Gd, Gs, Gd, Gs, Gs, Gd^Fts, Gs, Gs, Gd^Fts, Gd^Fts, Gd^Fts, Gd^Fts, Gd^Fts, Gd^Fts, Hhd^Fts, Hhd^Fts, Hhd^Fts, Hhd^Fts, Hhd^Fts, Hhd^Fts
Md, Md, Md, Md, Md, Md, Md, Md, Md, Md, Md, Md, Md, Md, Md, Md, Md, Md, Md, Hhd^Fts, Hhd^Fts, Hhd^Fts, Hhd^Fts, Gd^Fts, Gd^Fts, Gd^Fts, Gd^Fts, Gd^Fts, Gd^Fts, Gd^Fts, Gs, Gs^Es, Gs, Gs, Gs, Gs, Gd, Gd^Fts, Gs, Gd^Fts, Gd^Fts, Gs, Gs, Gd^Fts, Gs, Gs, Gs, Gs, Gd^Fts, Gs, Gd^Fts, Gd^Fts, Gd^Fts, Gd, Gs, Gs, Rmo, Gs, Gs, Gs^Es, Gs, Gs, Gd^Fts, Gd^Fts, Gs, Gs, Gs, Gd, Gs, Gd^Fts, Gd^Fts, Gs, Gs, Gs, Gs, Gd^Fts, Gs, Gs, Gs, Gd^Fts, Gd^Fts, Hhd^Fts, Hhd^Fts, Hhd^Fts, Gs, Hhd^Fts, Hhd^Fts, Hhd^Fts
