Gs, Gd, Gs, Gs, Gs, Gs, Gd, Gs, Gs, Gs, Rb, Rb, Rb, Gs, Gd, Gd, Gd, Gs, Gs, Gs, Gd^Fts, Gs, Gs, Wwf, Wwg, Wwf, Gs, Gs, Gs^Es, Gs, Gd^Fts, Gs, Gd^Fts, Gd^Fts, Gd, Gs, Gd, Gd, Gd, Gd, Gd, Gd, Gd, Gs, Gs, Gs, Gd, Gs, Gs, Gd^Es, Gd, Gd, Gd^Fts, Gd, Gs
Gd, Gs, Gd^Fts, Gd^Fts, Gd^Fts, Gd, Gs, Gd, Gd, Gs, Gs, Rb, Rb, Rb, Rb, Gs, Kar, Gs^Es, Gs, Gd^Fts, Gd^Fts, Gd^Fts, Gs, Wwf, Wwf, Wwf, Wwf, Gs, Gs, Gd^Fts, Gd, Gd^Fts, Gd, Gd^Fts, Gs, Gd, Gd, Gd^Es, Gd, Gs^Es, Gd^Es, Gs, Gd, Gd, Gd^Fts, Gs, Gd^Fts, Gd^Es, Gd, Gs, Arrw, Gd, Gs, Gd^Fts, Gd
Gd^Es, Gs, Gs^Es, Gs, Gd, Gd^Fts, Gs, Gs, Gd, Gd^Es, Gd^Es, Gd, Gd, Rb, Rb, Rb, Rmo, Car, Car, Car, Car, Car, Car, Kar, Wwf, Wwg, Wwf, Kar, Car, Car, Car, Car, Car, Car, Car, Car, Car, Gs, Gd, Gs, Gs, Gs, Gs, Gd, Gd, Arrw, Gd^Fts, Gd^Fts, Gd, Arrw, Gs, Gs, Gd^Es, Gd, Gd
Gs, Gd^Es, Gd, Gd, Gd, Arrw, Arrw, Gd, Gs, Gd, Gd^Es, Gs, Gd, Gs, Kar, Rmo, Rmo, Gd^Fts, Gd, Gd^Fts, Gd^Fts, Gd^Fts, Gd, Gd^Fts, Wwf, Wwg, Wwg, Wwf, Gd^Fts, Gd, Gd^Fts, Rmo, Gd, Gd^Fts, Gd^Fts, Rmo, Car, Gs, Gd^Fts, Gs, Gs, Gd^Var, Gd, Gd, Gd^Fts, Arrw, Arrw, Gd^Fts, Arrw, Arrw, Gs, Gd, Gd^Fts, Gd^Es, Gd
Gd, Gs, Gd, Gs, Arrw, Arrw, Arrw, Arrw, Gd^Fts, Gs, Gd, Gs, Gs, Gs, Car, Gd^Fts, Rmo, Rmo, Rmo, Gs, Car, Car, Rmo, Rmo, Wwf, Wwg, Wwg, Wwf, Gd^Fts, Gs^Var, Gs, Rmo, Gs^Var, Gd^Fts, Rmo, Rmo, Car, Gd, Gd^Fts, Gd, Gs, Gd, Gs, Gs, Gd^Fts, Gd, Gd, Arrw, Gd^Fts, Gs, Gd, Gd^Fts, Gd, Gs, Gd
Gd^Fts, Gd, Gd, Gs, Arrw, Arrw, Arrw, Arrw, Gd^Fts, Gs, Gd, Gs, Gs, Car, Rmo, Gd^Fts, Rmo, Rmo, Gd, Rmo, Rmo, Rmo, Rmo, Kar, Wwf, Wwg, Wwg, Wwf, Gd^Fts, Gd^Fts, Gd, Rmo, Rmo, Rmo, Gd, Gd^Fts, Gd^Fts, Car, Gd^Fts, Gd^Fts, Gd, Gd, Gd, Gd, Gd, Gd^Es, Gs^Es, Gd, Gs, Gd, Gd^Es, Gs, Gd, Gd, Gd^Es
Gs, Gd, Gd, Gd, Arrw, Arrw, Gd^Fts, Gd, Gd, Gs, Gs, Gd^Fts, Gs, Car, Car, Rmo, Rmo, Rmo, Gd^Fts, Car, Rmo, Kar, Car, Car, Car, Kar, Wwg, Wwf, Wwg^Bw/, Gs, Rmo, Rmo, Rmo, Gd^Fts, Hhd^Fts, Gs^Var, Hhd^Fts, Car, Gd, Gd^Fts, Gs, Gd, Gd^Es, Gd, Gs, Gs, Gs, Gd, Gd, Gs, Gs, Gd^Es, Gd, Gd, Gs
Gs, Gd^Fts, Gd^Fts, Gs, Gs, Gd, Gs, Gs, Gs, Gs^Es, Gs^Es, Gd^Fts, Gd^Fts, Gd, Car, Gs^Var, Rmo, Rmo, Gd^Fts, Car, Rmo, Rmo, Car, 3 Kar, Car, Wwf, Wwf, Wwg, Wwg^Bw/, Kar, Gs, Gd, Gs^Var, Rmo, Gd^Fts, Hhd^Fts, Gd^Fts, Car, Kar, Gs, Rb, Gd, Rb, Gs, Rb, Gd^Var, Rb, Gs, Rb, Gs, Rb, Gd, Rb, Gs, Rb
Gs, Gs, Gd, Gd^Fts, Gd, Gs^Es, Gd, Gs, Gd, Gs^Es, Gd, Gd^Fts, Gd^Fts, Car, Rmo, Gd^Fts, Rmo, Rmo, Gd^Fts, Car, Rmo, Kar, Rmo, Car, Rmo, Kar, Wwf, Wwf, Wwg, Wwg^Bw/, Wwf, Gd, Rmo, Rmo, Rmo, Gs, Rmo, Rmo, Rmo, Rb, Rb, Rb, Rb, Rb, Rb, Rb, Rb, Rb, Rb, Rb, Rb, Rb, Rb, Rb, Rb
Gs, Gd, Gs, Gd, Gs^Es, Gd, Gs, Gd^Fts, Gd^Fts, Gs, Gs, Gd^Fts, Gs, Car, Car, Rmo, Rmo, Rmo, Rmo, Rmo, Car, Rmo, Rmo, Kar, Rmo, Rmo, Car, Wwg, Wwg, Wwf, Wwg^Bw/, Rmo, Car, Car, Car, Rmo, Rmo, Rmo, Rmo, Rb, Gs, Rb, Gd, Rb, Gd, Rb, Gs, Rb, Gs, Rb, Gs, Rb, Gs, Rb, Gs
Gs, Gd, Gs, Gd^Es, Gd, Gd, Gs, Gd, Gd^Fts, Gd, Gs, Gs, Gs, Gs, Car, Gd^Fts, Rmo, Rmo, Gd^Fts, Gd^Fts, Hhd^Fts, Car, Car, Rmo, Car, Car, Gd^Fts, Wwf, Wwg^Bw/, Wwg^Bw/, Wwg^Bw/, Rmo, Car, 1 Kar, Car, Rmo, Gd, Gs, Kar, Gs, Gd, Gd, Gs, Gd, Gs, Gs, Gd, Gd, Gd, Gs, Gd^Es, Gs, Gd, Gd^Es, Gs
Gs, Gd^Fts, Gd, Gs, Gs, Gd, Gs, Gs, Gd, Gd^Fts, Gd, Gs, Gs, Car, Rmo, Gd^Fts, Rmo, Rmo, Rmo, Hhd^Fts, Hhd^Fts, Gd^Fts, Gd^Fts, Rmo, Gd^Fts, Gd^Fts, Rmo, Wwg^Bw/, Wwg^Bw/, Wwg^Bw/, Wwf, Rmo, Rmo, Car, Rmo, Rmo, Gd^Fts, Car, Gs, Gd, Gs, Gs, Gs^Es, Gs, Gd, Gd^Es, Gs, Gs, Gs, Gs, Gd, Gd, Gd, Gs, Gd
Gs, Gd, Gd^Es, Gd^Fts, Gd^Fts, Gd^Fts, Gd, Gd^Fts, Gs, Gd^Fts, Gd, Gd^Fts, Gd^Fts, Car, Car, Rmo, Gd^Fts, Rmo, Rmo, Rmo, Rmo, Gs^Var, Gd^Fts, Rmo, Rmo, Rmo, Rmo, Wwg^Bw/, Wwg, Wwg, Wwf, Gd^Fts, Gd, Rmo, Gs^Var, Gd^Fts, Car, Car, Gd, Gd, Gd, Gs^Es, Gd, Gd, Gd, Gs, Gs, Gd, Gd, Gd, Gs, Gd, Gd, Gd, Gs
Gs, Gd, Gd, Gs, Gd, Gd, Gd, Gs, Gs, Gd, Gs, Gd, Gd^Fts, Gd^Fts, Car, Gd^Fts, Gd^Fts, Gs^Var, Rmo, Rmo, Rmo, Rmo, Rmo, Rmo, Rmo, Rmo, Gd^Fts, Wwf, Wwg, Wwg, Wwf, Gd^Fts, Gs^Var, Rmo, Rmo, Gd^Fts, Car, Gd, Gd, Gd, Gs, Gd, Gd, Gs, Gs, Gs, Gd, Gd, Arrw, Gs, Arrw, Gd, Gd, Gd^Fts, Gs
Gd, Gd, Gd^Fts, Gd^Es, Gs, Gd, Gd^Fts, Gd, Gd, Gd, Gd, Gd, Gs, Car, Rmo, Gd, Rmo, Rmo, Gd^Fts, Gd^Fts, Gd^Fts, Rmo, Rmo, Rmo, Rmo, Gd^Fts, Gd^Fts, Wwf, Wwg, Wwg, Wwf, Gd, Gd^Fts, Gd^Fts, Gd^Fts, Rmo, Gd, Car, Gs, Gs^Es, Gd^Es, Gs, Gd, Gd, Gd, Arrw, Arrw, Arrw, Arrw, Arrw, Arrw, Gs, Gd, Gs, Gd^Fts
Gd, Gs, Gd, Gd, Gd, Gd, Gd^Es, Gd^Fts, Gd, Gs, Gd, Gs, Gd, Car, Car, Rmo, Gd^Fts, Rmo, Gd, Hhd^Fts, Gd^Fts, Rmo, Gd, Gd^Fts, Gd^Fts, Rmo, Gd^Fts, Wwf, Wwf, Wwg, Wwg, Wwf, Wwf, Kar, Car, Rmo, Car, Car, Gs, Gd, Gs, Gs^Es, Gd, Gd, Gd, Gs, Gs, Gd^Fts, Gs, Arrw, Arrw, Arrw, Gs, Gd, Gs
Gs, Gs, Gs, Gs, Gd^Fts, Gs, Gs, Gd, Gd, Gd, Gs, Gs, Gd, Gd, Gs, Car, Car, Rmo, Gd^Fts, Gd^Fts, Gd, Rmo, Gd, Hhd^Fts, Gd^Fts, Rmo, Car, Kar, Gd, Wwf, Wwf, Wwg, Wwg, Wwf, Car, Rmo, Car, Gs, Gs, Gd, Gd, Gs, Gd, Gd, Gd^Fts, Gd^Fts, Gs, Gd, Gs, Arrw, Arrw, Arrw, Gd^Es, Gd, Gd
Gs, Gd^Es, Gd, Gd^Fts, Gd^Var, Gs, Gs, Gd^Es, Gd, Gd, Gs, Gs, Gs, Gd, Gs, Gs, Car, Rmo, Car, Gd^Fts, Gs, Rmo, Gs, Gd^Fts, Car, Rmo, Car, Gs, Gd, Gd, Gs, Wwf, Wwg, Wwf, Wwf, Car, Gs, Gs, Gs^Es, Gd, Gd^Fts, Gd, Gs, Gd, Gd^Fts, Gs, Gs, Gs^Es, Gs^Es, Gd^Var, Arrw, Arrw, Arrw, Gd^Es, Gs
Gs, Gd, Gd^Es, Gd^Fts, Gs, Gs, Gs, Gs, Gd, Gs, Gs, Gd, Arrw, Gs, Gs, Gs, Gs, Car, Gs, Car, Rmo, Rmo, Rmo, Car, Gs, Car, Gs, Gs, Gd^Es, Gd, Gd, Wwf, Wwf, Wwg, Wwg, Wwf, Gd, Gd, Gs, Gd^Es, Gd, Gd, Gd^Var, Gs, Gs, Gd^Fts, Gd^Fts, Gs, Gd, Gs, Arrw, Arrw, Arrw, Gs, Gd^Fts
Gd, Gd, Gd^Es, Gd, Gd, Gd, Gd, Gd, Gs, Gd, Arrw, Arrw, Arrw, Arrw, Gd^Fts, Gs, Gd, Gd, Gd, Kar, Rb, Rb, Rb, Kar, Gd, Gs, Gd, Gs, Gd, Gs^Es, Gd, Gs, Rd, Wwf, Wwg, Wwf, Sm, Gd, Rd, Gd^Fts, Gd, Gs, Gs, Gs, Gs, Gs, Gd, Gs, Gd, Gd, Arrw, Arrw, Gd, Gs, Gd
Gd, Gs, Gs, Gd, Gs, Gs, Gs^Es, Gs^Es, Gd^Fts, Gd, Arrw, Arrw, Arrw, Arrw, Gd^Fts, Gd, Gd, Gd, Gd, Gs, Rb, Rb, Gd, Gd, Gs, Gs, Gs, Gd^Fts, Gd, Gs^Es, Rd, Rd, Ss, Wwf, Wwg, Wwf, Wwf, Sm, Sm, Rd, Gd, Gd, Gs, Gs^Es, Gd, Gd^Es, Gd, Gd, Arrw, Arrw, Arrw, Arrw, Gd, Gs, Gs
Gs, Gd^Es, Gs, Gd^Fts, Gd, Gd, Gs, Gd^Fts, Gs, Gs, Gd, Gd^Var, Arrw, Arrw, Gs, Gd, Gs, Gd, Gs, Gd, Rb, Rb, Gs, Gd, Gd^Fts, Gs, Gs^Es, Gd, Gs, Rd, Rd, Ss, Sm, Wwf, Wwg, Wwg, Wwg, Wwf, Sm, Rd, Gd^Fts, Gd, Gd^Fts, Gd, Gd, Gd, Gs, Gs, Gd, Arrw, Gd, Gs, Gs, Gd^Es, Gs
Wwf, Gs, Ss, Rd, Rd, Gd, Rd, Gd^Fts, Gd, Gs, Gs, Gd^Fts, Gd^Fts, Gs, Gd^Fts, Gs, Gd, Gd, Gd, Gd, Rb, Rb, Gs, Gd^Fts, Gd^Fts, Gs, Gd, Gd^Es, Sm, Sm, Rd, Ss, Sm, Wwf, Wwf, Wwg, Wwg, Wwf, Wwf, Rd, Rd, Gd, Ss, Gd^Fts, Gd, Gd, Gd^Fts, Gd^Fts, Gd, Gd, Gs, Gd, Gd, Gd^Es, Gd
Wwg, Wwf, Wwf, Sm, Ss, Sm, Rd, Rd, Rd, Gd, Gs, Gd^Fts, Gd, Gs, Gd, Gd, Gd^Fts, Gd^Fts, Gd, Gs, Rb, Rb, Gd, Gd, Gd, Gd, Gs, Gd^Es, Rd, Rd, Rd, Rd, Ss^Vhs, Sm, Wwf, Wwg, Wwg, Wwf, Wwf, Sm, Sm, Ss, Rd, Rd, Rd, Rd, Ss, Gs, Gs, Gd, Gd^Fts, Gd^Fts, Gd^Fts, Gs, Gs
Wwg, Wwg, Wwf, Wwf, Wwf, Ss, Ss, Ss, Sm, Rd, Sm, Gs, Gd^Es, Gd^Es, Gs, Gd^Fts, Gd, Gd, Rb, Rb, Rb, Rb, Gd, Gs, Gd, Gd^Fts, Gd^Fts, Ss, Ss, Ss, Rd, Rd, Sm, Sm, Wwf, Wwg, Wwf, Wwg, Wwf, Sm, Sm, Rd, Rd, Ss, Rd, Ss, Rd, Rd, Rd, Rd, Sm, Rd, Rd, Gd^Fts, Gd^Fts
Wwf, Wwg, Wwf, Wwg, Wwg, Wwf, Wwf, Wwf, Wwf, Rd, Rd, Gd, Gd^Es, Gs, Gd, Gd, Rb, Rb, Rb, Rb, Gs, Gs, Gd^Es, Gd, Gs, Gd^Var, Rd, Rd, Sm, Sm, Sm, Sm, Ds, Wwf, Wwg, Wwg, Sm, Wwg, Wwg, Wwf, Wwf, Sm, Sm, Rd, Ss^Vhs, Rd, Sm, Ss, Rd, Rd, Ss, Sm, Rd, Rd, Gd
Gs, Wwf, Sm, Wwf, Wwf, Wwf, Wwg, Wwg, Wwf, Sm, Rd, Gs, Gs, Gd, Rb, Rb, Rb, Rb, Gd, Gd, Gd, Gd^Es, Rd, Ss, Rd, Gs, Rd, Ss, Rd, Sm, Sm, Sm, Wwf, Wwf, Wwg, Wwg, Ds, Sm, Wwg, Wwf, Wwf, Sm, Sm, Sm, Ds, Ds, Sm, Sm, Ds, Ds, Wwf, Ds, Ds, Rd, Sm
Rb, Rd, Rd, Ss, Ss, Wwf, Wwf, Wwg, Wwf, Sm, Wwf, Gs, Rb, Rb, Rb, Rb, Gs^Es, Gs^Es, Gd, Gd^Fts, Gd^Fts, Gs, Gd^Es, Sm, Rd, Ss, Sm, Rd, Ds, Ds, Wwf, Wwf, Wwg, Wwg, Wwf, Wwg, Ds, Wwg, Wwg, Wwg, Wwg, Wwf, Wwf, Wwf, Wwf, Wwf, Wwf, Sm, Wwf, Wwf, Wwg, Wwf, Wwf, Ss, Sm
Rb, Rb, Rb, Sm, Sm, Sm, Rd, Wwf, Wwf, Wwf, Wwg^Bw/, Rb, Rb, Rb, Rb, Rb, Rb, Gd^Es, Gd, Gd^Fts, Gd, Gd, Gs^Es, Rd, Rd, Rd, Rd, Rd, Wwf, Wwf, Wwg, Wwg, Wwf, Wwf, Sm, Sm, Ss^Vhs, Sm, Wwf, Wwg, Wwf, Wwf, Wwg, Wwf, Wwg, Wwg, Wwg, Wwf, Wwg, Wwg, Wwg, Wwg, Wwf, Wwf, Wwf
Gs, Rb, Rb, Rb, Rb, Rd, Rd, Rd, Wwg^Bw/, Wwg^Bw/, Wwg^Bw/, Wwg^Bw/, Gs, Rd, Rd, Rb, Rb, Rb, Rb, Gd, Gd, Gs, Gs, Gs, Gd^Fts, Rd, Sm, Sm, Wwf, Wwg, Sm, Wwf, Ds, Sm, Sm, Sm, Sm, Wwf, Sm, Wwf, Sm, Wwf, Wwf, Wwg, Wwg, Wwg, Wwg, Wwf, Wwf, Wwf, Wwf, Wwf, Wwf, Wwg, Wwg
Gs, Gs^Es, Gd, Rb, Rb, Rb, Rb, Rb, Rb, Wwg^Bw/, Wwg, Wwf, Wwf, Ss, Sm, Rd, Rd, Rb, Rb, Rb, Rb, Gs, Gd^Var, Gd^Fts, Sm, Sm, Wwf, Wwf, Wwf, Sm, Rd, Ds, Rd, Rd, Rd, Ss, Rd, Ds, Ss, Sm, Rd, Sm, Sm, Wwf, Wwf, Wwf, Wwf, Wwf, Sm, Sm, Ds, Wwf, Ss, Wwf, Wwf
Gs, Gd, Gd, Gd^Es, Gd, Rb, Rb, Rb, Gs, Wwf, Wwf, Wwg, Wwg, Wwf, Sm, Rd, Ss, Rd, Gs, Rb, Rb, Rb, Rb, Wwf, Wwf, Wwf, Wwf, Wwf, Sm, Rd, Sm, Ss, Rd, Ss, Ss, Rd, Rd, Sm, Sm, Rd, Rd, Ss^Vhs, Sm, Ds, Ds, Ss, Sm, Sm, Sm, Rd, Rd, Ds, Rd, Sm, Sm
Gs, Gs, Gd^Fts, Gs, Gd, Gs, Gs^Es, Gs, Gs, Gd, Ss^Vhs, Wwf, Wwf, Wwf, Wwf, Sm, Ds, Rd, Rd, Sm, Ds, Rb, Wwg^Bw\, Wwg^Bw\, Wwg^Bw\, Wwf, Sm, Sm, Rd, Rd, Rd, Rd, Sm, Rd, Sm, Rd, Rd, Ss, Ss, Sm, Rd, Rd, Rd, Rd, Rd, Sm, Rd, Rd, Rd, Rd, Rd, Ss, Gs, Sm, Sm
Gd, Gd^Fts, Gd^Fts, Gd, Gs, Gd, Gd, Gd^Es, Gs, Rd, Rd, Ds, Sm, Wwf, Wwf, Wwf, Wwf, Sm, Ss^Vhs, Wwf, Wwf, Ds, Wwf, Wwg^Bw\, Wwg^Bw\, Wwg^Bw\, Rb, Gs, Gs, Gs^Es, Gd^Es, Rd, Gd, Sm, Rd, Sm, Sm, Rd, Rd, Ss, Ss, Sm, Ss, Sm, Ss, Sm, Rd, Rd, Sm, Sm, Sm, Gs, Gd^Fts, Gd^Fts, Gs
Gd^Es, Gs, Gd^Fts, Gd^Fts, Gd^Es, Gd^Es, Gd^Es, Gd, Gd, Ss, Ss, Sm, Rd, Sm, Ds, Wwf, Wwf, Wwf, Wwf, Wwf, Wwg, Wwf, Wwf, Wwf, Sm, Rb, Rb, Rb, Rb, Gs, Gd, Gd, Gd, Rd, Sm, Rd, Ss, Rd, Sm, Sm, Gd, Gs, Gs, Sm, Rd, Rd, Rd, Sm, Ss, Sm, Gd, Gd, Gd^Fts, Gd^Fts, Gs
Gd^Es, Gs, Gd^Fts, Gd, Gd, Gd^Es, Gs, Gd, Gs, Sm, Rd, Ss, Rd, Rd, Rd, Ds, Wwf, Wwf, Wwg, Wwg, Wwf, Wwf, Sm, Ss, Rd, Sm, Gs, Rb, Rb, Rb, Rb, Gd, Gs, Gd, Gs, Gs, Gd^Es, Sm, Ss, Gs, Gd, Gs^Es, Gd^Fts, Rd, Gd, Sm, Gs^Es, Gs, Gs, Gd, Gs, Gd^Fts, Gd, Gs^Es, Gs
Arrw, Gd, Gs, Gd, Gs, Gs, Gs, Gd^Es, Gs, Gd^Fts, Gd, Rd, Sm, Rd, Sm, Sm, Wwf, Wwf, Wwf, Wwf, Sm, Sm, Rd, Sm, Rd, Ss, Gs^Es, Gs, Gs, Rb, Rb, Rb, Rb, Gs, Gd^Es, Gd^Es, Gs, Gd, Gd^Fts, Gs, Gd^Es, Gd^Fts, Gd^Fts, Gd, Gs, Gs, Gd^Fts, Gd^Es, Gd^Es, Gd, Gs, Gd, Gd, Gs^Es, Gs
Arrw, Arrw, Gd^Fts, Gd, Gs, Re^Vct, Gs, Gd, Gd, Gd^Fts, Gd^Fts, Ss, Rd, Rd, Ss, Wwf, Wwg, Wwg, Wwf, Sm, Sm, Rd, Ss, Rd, Rd, Gd, Gs, Gd^Var, Gs, Gs^Es, Gs^Es, Rb, Rb, Rb, Gd, Gs, Gs, Arrw, Arrw, Gd^Fts, Gd, Gd, Gd^Fts, Gs, Gd^Fts, Gd^Fts, Arrw, Gd, Arrw, Gd^Fts, Gd^Fts, Gd, Gd^Fts, Gs, Gs
Arrw, Arrw, Arrw, Gd^Fts, Gd, Gs, Ce, Gs, Gd, Re^Vct, Gd, Gd^Fts, Rd, Sm, Wwf, Wwf, Wwf, Wwg, Wwf, Sm, Rd, Rd, Rd, Rd, Gd^Es, Gd^Es, Gd, Gs, Gd, Gd^Fts, Gd^Fts, Gs, Rb, Rb, Gs, Gs, Gd, Arrw, Arrw, Gs^Var, Gs, Gd, Gs, Gd^Es, Arrw, Arrw, Arrw, Arrw, Arrw, Arrw, Gd^Fts, Gd^Fts, Gd^Fts, Gs, Arrw
Arrw, Arrw, Arrw, Gd^Fts, Gd, Ce, 4 Ke, Ce, Gd, Gs, Gd, Gd^Fts, Ss, Wwf, Wwg, Wwg, Wwf, Wwf, Sm, Sm, Rd, Sm, Rd, Sm, Gs, Gd^Es, Gd^Fts, Gd^Fts, Arrw, Arrw, Gd, Gs, Rb, Rb, Gs, Gs, Gd^Es, Gd^Fts, Gs, Arrw, Gd, Gd, Gs, Gs, Gd^Fts, Arrw, Arrw, Arrw, Arrw, Arrw, Arrw, Gd^Fts, Arrw, Arrw, Arrw
Arrw, Arrw, Gs, Gd^Fts, Gs, Ce, Ce, Ce, Gd, Re^Vct, Gs, Sm, Rd, Sm, Sm, Wwf, Wwf, Ss^Vhs, Ss, Rd, Sm, Rd, Rd, Sm, Gs, Gd, Gd^Fts, Arrw, Arrw, Arrw, Gd^Fts, Gd^Es, Rb, Rb, Gd, Gd^Es, Gd, Gd^Fts, Gs, Gd, Gd, Gd^Es, Gd, Gd^Fts, Gd, Gd, Gd^Fts, Arrw, Arrw, Arrw, Arrw, Arrw, Arrw, Arrw, Arrw
Arrw, Gd^Fts, Gs, Gs^Es, Gd, Gd, Gs, Gs, Gs, Sm, Sm, Rd, Rd, Ss, Sm, Wwf, Sm, Sm, Sm, Rd, Sm, Rd, Sm, Gs, Gd^Var, Gs, Gs, Gd^Fts, Arrw, Arrw, Gd^Fts, Gd^Es, Rb, Rb, Gd, Gs, Gs, Gd, Gs, Gd, Gs, Gs, Gs, Gs, Gd, Gs, Gs, Gd^Fts, Arrw, Arrw, Arrw, Arrw, Arrw, Arrw, Arrw
Gd^Fts, Gd^Fts, Gd, Gd^Es, Gd^Fts, Gs, Gs, Gd, Gs, Sm, Rd, Rd, Rd, Sm, Wwf, Wwf, Wwf, Sm, Ss, Rd, Rd, Rd, Gd^Fts, Gs, Gs, Gd, Gd^Fts, Gd, Re^Vct, Gd^Fts, Gd, Gs, Rb, Rb, Gd, Gs^Es, Rb, Gd, Gd, Gd^Es, Gs, Gs, Gd, Gd, Gs, Re^Vct, Gd, Gs, Gd, Arrw, Arrw, Arrw, Arrw, Arrw, Gd
Gd, Gs, Gs^Es, Gs, Gd, Gd^Fts, Gd^Fts, Gs, Gs, Ss, Rd, Rd, Rd, Sm, Wwf, Wwg, Wwf, Sm, Rd, Rd, Sm, Gd, Gd, Gs, Gd, Gd^Fts, Gs, Gs^Es, Gs, Gs, Rb, Rb, Rb, Rb, Rb, Rb, Rb, Rb, Rb, Gd, Rb, Gs, Gs, Gd, Gd^Es, Gs, Gd, Gd^Fts, Ce, Gs, Gd^Fts, Arrw, Re^Vct, Gd^Fts, Gd
Gd^Fts, Gd^Fts, Gd^Fts, Gs^Es, Gs, Gd, Gd^Fts, Gd^Fts, Gd, Sm, Sm, Ss, Sm, Sm, Wwf, Wwf, Sm, Ss, Rd, Sm, Gd^Fts, Gs, Gd, Gs, Gs, Gd^Fts, Gs, Gs, Rb, Rb, Rb, Rb, Gs, Rb, Rb, Rb, Gs, Rb, Rb, Rb, Rb, Rb, Rb, Gs, Gd^Es, Gs, Gs, Ce, 5 Ke, Ce, Gd, Gd^Fts, Gd, Gd, Gd
Gd^Fts, Gd, Gd^Fts, Gd, Gd^Fts, Gd^Fts, Gs, Gs, Gs, Gd, Wwf, Ss, Wwf, Wwf, Wwg, Wwf, Gs, Rd, Gd, Gd, Gs, Gd^Es, Gs, Gs^Es, Gd, Gd^Fts, Gs, Rb, Rb, Rb, Gs, Ce, Gd, Gs, Gs, Gs, Gd, Gd, Gs, Rb, Gd, Rb, Rb, Rb, Rb, Gd^Es, Gd, Ce, Ce, Ce, Gd^Fts, Gd, Gd, Gd, Gs
Gs, Gd^Fts, Gs, Gs, Gd^Es, Gs, Gd^Es, Gd, Wwf, Wwf, Wwf, Wwf, Wwg, Wwg, Wwf, Wwf, Gs, Gd^Fts, Gs, Gd^Es, Gs^Var, Gd, Gd, Gd^Es, Re^Vct, Gs, Gs, Rb, Rb, Ce, Ce, Ce, Ce, Ce, Gd, Gd, Re^Vct, Gd, Gd, Gd, Gs, Gd, Gd, Rb, Rb, Re^Vct, Gd, Gd, Gs, Gs, Gs, Gd, Re^Vct, Gd, Gd
Gd^Fts, Gd, Gs, Gd, Gs, Gs^Es, Wwf, Wwf, Wwg, Wwg, Wwg, Wwf, Wwf, Wwg, Wwf, Gd, Gs, Gd^Fts, Gs, Gs^Es, Gs^Es, Gd, Gd^Es, Gd, Gd, Gs, Gs, Rb, Rb, Gd, Ce, 2 Ke, Ce, Gs, Gd^Es, Gd, Gd, Gd^Es, Gd^Es, Gd, Gd^Fts, Gs, Gs, Rb, Rb, Rb, Rb, Rb, Rb, Rb, Rb, Gd, Gd, Gd, Gd
Gd, Gd^Fts, Gd, Gd, Wwf, Wwf, Wwg, Wwg, Wwg, Wwg, Wwf, Wwf, Gd, Wwf, Gs, Gs, Gd, Gd^Fts, Gd^Fts, Gs, Gs, Gd, Gs^Es, Gd^Es, Gs, Gs, Rb, Rb, Rb, Ce, Gd, Ce, Gs, Ce, Gd, Gd, Gd^Fts, Gd, Gd, Gd^Es, Gd, Gd, Gd, Gs, Gs, Rb, Rb, Rb, Rb, Rb, Rb, Rb, Rb, Gd, Gd
Wwf, Gd, Wwf, Wwf, Wwg, Wwf, Wwf, Wwg, Wwf, Wwf, Gd, Gd, Gs, Gs, Gd^Fts, Gd, Gd^Fts, Gs, Gd^Fts, Gs, Gd, Gd, Gs, Gs^Es, Gs, Rb, Rb, Rb, Gs, Gs, Gd^Fts, Ce, Gd, Gs, Gs, Re^Vct, Gd, Gd, Gs, Gs, Gs, Gd^Fts, Gd^Fts, Gd, Gs, Gs, Gd, Gd, Gd, Gs, Gd, Rb, Rb, Gs, Gs
Wwg, Wwf, Wwg, Wwg, Wwg, Wwg, Wwf, Wwf, Gs, Gd, Gs, Gd, Gd, Gd^Fts, Gs, Gs, Gs, Gs, Gs, Gs, Gd, Gd, Gs, Gs, Gs, Rb, Rb, Gs, Gs, Gs, Gd^Fts, Gd^Fts, Gs, Gs, Gs, Gs, Gs, Gd^Fts, Gd, Gs^Es, Gs, Gd, Gs, Gd^Fts, Gs, Gs, Gs, Gs, Gd, Gs, Gs, Rb, Rb, Rb, Gs
