Gs^Fms, Gll, Gll, Gll, Gs^Fms, Gll, Gll, Gll, Gs^Fms, Gs^Fms, Gs^Fms, Gll, Gs^Fms, Gll, Gll, Gs^Fms, Gll, Gll, Gs^Fms, Gs^Fms, Gs^Fms, Gll, Gll, Gll, Gll, Gll, Gs^Fms, Gs^Fms, Gll, Gll, Gll, Gll, Gs^Fms, Gs^Fms, Gs, Gg, Rr, Gg, Gg, Gg, Gg, Gs, Gs^Fms, Gs^Fms, Gs^Fms, Gll, Gs^Fms, Gll, Ww, Ww
Gs^Fms, Gll, Gs^Fms, Gs^Fms, Gs^Fms, Gll, Gll, Gs^Fms, Gll, Gs^Fms, Gs^Fms, Gll, Gs^Fms, Gs^Fms, Gs^Fms, Gs^Fms, Gs^Fms, Gs^Fms, Gs^Fms, Gll, Gs^Fms, Gs^Fms, Gs^Fms, Gs^Vl, Gs^Fms, Gll, Gs^Fms, Gs^Fms, Gs^Fms, Gs^Fms, Gs^Fms, Gll, Gs^Fms, Gs, Gg, Gg^Es, Rr, Gg, Gg^Es, Gg^Es, Gs, Gs, Gs^Fms, Gll, Gs^Fms, Gll, Gs^Fms, Gll, Ww, Ww
Gll, Gs^Fms, Gs^Fms, Gll, Gs^Fms, Gll, Gs^Fms, Gs^Fms, Gs^Fms, Gs^Fms, Gs^Fms, Gll, Gs^Fms, Gll, Gll, Gs^Vl, Gll, Gs^Fms, Hh^Fms, Hh^Fms, Hh^Fms, Hh^Fms, Hh^Fms, Gs^Fms, Gs^Fms, Gll, Gll, Gs^Fms, Gs^Fms, Gs^Fms, Gll, Gs^Fms, Gs, Gs, Gg^Es, Gg, Rr, Gg, Gs^Es, Gs, Gs^Fms, Gs^Fms, Gs^Fms, Gll, Gll, Gs^Fms, Gll, Ww, Ww, Ww
Gll, Gs^Fms, Gs^Fms, Gs^Fms, Gs^Fms, Gs^Fms, Gs^Fms, Gs^Fms, Gll, Gs^Fms, Gs^Fms, Gs^Fms, Gll, Gs^Fms, Gs^Fms, Gs^Fms, Hh^Fms, Hh^Fms, Md, Md, Md, Md, Hh^Fms, Gs^Fms, Gs^Fms, Gs^Fms, Gs^Fms, Gs^Fms, Gs^Fms, Gs^Fms, Gs^Fms, Gs^Fms, Gg, Gg, Rr, Rr, Gs, Gg, Gs, Gs^Fms, Gs^Fms, Gll, Gs^Fms, Gs^Fms, Gs^Fms, Gs^Fms, Ww, Ww, Wo, Wo
Gs^Fms, Gll, Gs^Fms, Gs^Fms, Gs^Fms, Gll, Gs^Vl, Gs^Fms, Gs^Fms, Gs^Fms, Gs^Fms, Gs^Fms, Gs^Fms, Gs^Fms, Gs^Fms, Hh^Fms, Md, Md, Md^Cov, Md^Cov, Md^Cov, Md, Md, Hh^Fms, Gll, Gs^Fms, Gll, Gs, Gs, Gs, Gs, Gg, Rr, Rr, Gg, Gs, Gs^Fms, Gs, Gs^Fms, Gll, Gll, Gs^Fms, Gs^Fms, Gs^Fms, Ww, Gs, Ww, Wo, Ww, Ww
Gs^Fms, Gll, Gs^Fms, Gs^Fms, Gs^Fms, Gll, Gs^Fms, Gs^Fms, Gs^Fms, Gs^Fms, Gs^Fms, Gs^Fms, Gs^Fms, Gs^Fms, Gs^Fms, Hh^Fms, Hh^Fms, Md, Md^Cov, Md^Kov, Md^Cov, Md, Md, Hh^Fms, Gs^Fms, Gll, Gs, Gg, Gg, Gg^Es, Rr, Rr, Gg, Gg, Gg^Gvs, Gs, Gg, Gs^Fms, Gs^Fms, Gs^Fms, Gll, Gs^Fms, Ww, Ww, Wo, Ww, Wo, Wo, Ww, Gg
Gll, Gll, Gs^Fms, Gll, Gll, Gs^Fms, Gs^Fms, Gs^Fms, Gll, Gs^Fms, Gs^Fms, Gll, Gll, Gs^Fms, Gs^Fms, Gll, Hh^Fms, Md, Md, Md^Cov, Md, Md, Hh^Fms, Hh^Fms, Gs^Fms, Gs^Fms, Gg, Gg^Es, Rr, Rr, Gg, Gg, Gs^Vh, Gg^Gvs, Gs^Gvs, Gg^Gvs, Gs^Gvs, Gll, Gs^Fms, Gll, Ww, Ww, Wo, Wo, Ww, Wo, Ww, Ww, Gs, Gs
Gs, Gs, Gs, Gs^Fms, Gll, Gs^Fms, Gs^Fms, Gll, Gs^Fms, Gs^Fms, Gs^Fms, Gs^Fms, Gs^Fms, Gs^Vl, Gs^Fms, Gll, Hh^Fms, Md, Md, Md, Md, Md, Hh^Fms, Gll, Gs^Fms, Gg, Rr, Rr, Gg, Gg, Gg, Gs, Gs^Fms, Gs^Gvs, Gg^Gvs, Gs^Gvs, Gs^Fms, Gll, Gs^Fms, Ww, Wo, Wo, Ww, Ww, Gg, Ww, Gg, Gg, Gg^Es, Gg
Ss, Ss, Ss, Gs, Gs, Gs, Gll, Gs^Fms, Gs^Fms, Gs^Fms, Gs^Fms, Gs^Fms, Gll, Gs^Fms, Gs^Fms, Gll, Gs^Fms, Hh^Fms, Hh^Fms, Hh^Fms, Hh^Fms, Hh^Fms, Gs^Fms, Gs^Fms, Gs, Gg, Rr, Gg, Gg, Gg^Es, Gg, Gs, Ww, Gs^Fms, Ww, Gs, Gs, Gs^Fms, Ww, Wwf, Wwf, Ww, Gs, Gs, Gs^Es, Gg, Gs, Gg, Gg, Gg
Ss, Ds, Wwg, Ss, Gs, Ss, Ss, Gll, Gs, Gll, Gll, Gll, Gll, Gll, Gll, Gs^Fms, Gll, Gs^Fms, Gs^Fms, Gs^Fms, Gs^Fms, Gs^Fms, Gs^Fms, Gs, Gg, Gg^Es, Rr, Gg, Ww, Ww, Ww, Ww, Wo, Ww, Wo, Ww, Wwf, Ww, Wo, Wo, Ww, Gs, Gs, Gs, Gg, Gs, Gg, Gs, Gs, Gg
Gg, Wwg, Ss, Ss, Ss, Ds, Ds, Ss, Ss, Gs, Ss, Ss, Ss, Gs, Gs, Gs, Gs, Gll, Gs, Gll, Gs, Gll, Gg, Gs, Gg, Gg, Rr, Gg, Ww, Ww, Ww, Wo, Ww, Wo, Ww, Wo, Wwf, Wo, Ww, Ww, Gg, Gg, Gs, Gs^Es, Gg, Gg, Gs, Gs, Gs^Fms, Gs
Ds, Ss, Ds, Ss, Gs, Ss, Wwg, Wwg, Ss, Ss, Wwf, Gs, Ds, Ss, Gs, Gs, Ss, Gs, Gg^Es, Gg, Ww, Gg^Es, Ww, Gg^Es, Ww, Gs^Vh, Ww^Bsb|, Ww, Wo, Wo, Ww, Ww, Gg, Ww, Gg, Ww, Wwf, Ww, Gg, Gg, Gs, Gg, Gs, Gs, Gs^Fms, Gs, Gs^Fms, Gg, Gg^Es, Gg
Ww, Ds, Ww, Ds, Ds, Ds, Ds, Ss, Ss, Wwg, Wwf, Ss, Ss, Ds, Ss, Ss, Gs^Vh, Gs, Ww, Ww, Wo, Ww, Wo, Ww, Wo, Ww, Ww^Bsb|, Ww, Ww, Ww, Gg, Gs, Gs, Gs^Es, Gs, Gg, Gg, Gg, Gs, Gg, Gg^Es, Gg, Gs, Gs, Gs^Es, Gs, Gs, Gg, Gg, Gg
Wo, Ww, Ww, Ww, Ww, Ds, Ww, Ds, Ds, Ss, Wwf, Ds, Wwf, Ss, Ww, Ss, Ww, Ww, Wo, Wo, Ww, Ww, Ww, Wo, Ww, Ww, Ww^Bsb|, Ww, Gg, Gg, Gs^Vh, Gs, Gg, Gg^Es, Gs, Gg, Gg, Gg, Gs^Fms, Gs, Gs, Gs, Gs^Fms, Gs^Fms, Gs, Gs, Gs^Es, Gg, Gg, Gg
Wo, Ww, Ww, Wo, Wo, Ww, Ww, Ww, Ds, Wwg, Ds, Ss, Ss, Ww, Wo, Ww, Wo, Wo, Ww, Ww, Gg, Gg, Gg, Ww, Gg, Ww, Rr, Gg, Gg^Gvs, Gg^Gvs, Gg^Gvs, Gg^Gvs, Gg^Gvs, Gg, Gs^Fms, Gs, Gs, Gll, Gs, Gs, Gs, Gs^Fms, Gs^Fms, Gll, Gg, Gs^Fms, Gg^Es, Gs, Gs, Gg
Wo, Ww, Ww, Wo, Wo, Wo, Ww, Ww, Ds, Ds, Ww, Ds, Wwf, Ww, Ww, Wo, Ww, Ww, Ss, Gs, Gg, Gg^Es, Gg, Gg, Gg, Gg, Rr, Gg, Gg, Gg^Gvs, Gg^Gvs, Gg^Gvs, Gg, Gs, Gs^Fms, Gll, Gs^Fms, Gs^Fms, Gll, Gg, Gll, Gs^Fms, Gll, Gll, Gs, Gg, Gs, Gs, Gs^Fms, Gg
Ds, Ds, Ds, Ww, Ww, Wo, Wo, Ww, Ww, Ww, Ww, Wwf, Wwf, Wwf, Ss, Ww, Ss, Ss, Gs, Gg, Gg, Gg, Gg^Gvs, Gs^Vh, Gg^Gvs, Gg, Rr, Gg, Gs, Gg, Gs^Fms, Gg, Gll, Gs, Gll, Gs^Fms, Gs^Fms, Gll, Gs, Gs^Fms, Gll, Gs^Fms, Gs^Fms, Gg, Gs^Fms, Gs, Gs^Fms, Gs^Fms, Gs, Gg
Gs^Fms, Gs^Fms, Gs^Fms, Ds, Ds, Ww, Ww, Wo, Wo, Wo, Ww, Wwf, Wwf, Wwf, Ds, Ss, Ss, Ss, Gs, Gg, Gg, Gg^Gvs, Gg^Gvs, Gg^Gvs, Gg^Gvs, Gg^Gvs, Rr, Gs, Gs^Fms, Gs^Fms, Hh^Fms, Gs^Fms, Gll, Gs^Fms, Gs^Fms, Gll, Gll, Gs^Fms, Gs, Gs, Gs^Fms, Gll, Gg, Gs, Gs^Es, Gs^Fms, Gll, Gg, Gs^Es, Gg
Gs^Fms, Gs^Vh, Gs^Fms, Gs^Fms, Ds, Ww, Ww, Wo, Ww, Ww, Ds, Ds, Ds, Ds, Gs, Ss, Gs, Gs, Gg^Gvs, Gs^Vh, Gg^Gvs, Gg, Gg, Gg^Gvs, Gg, Gg, Rr, Gs^Fms, Hh^Fms, Hh^Fms, Hh^Fms, Gs^Fms, Gs^Fms, Gll, Gs^Fms, Gs, Gs^Fms, Gll, Gs^Fms, Gs, Gs^Vh, Gll, Gs^Fms, Gg, Gs, Gs, Gs^Fms, Gg, Gg, Gg
Ds, Gs^Fms, Ds, Gs^Fms, Ds, Ww, Wo, Wo, Ww, Ds, Ss, Ss, Gs, Gs, Gg, Gs, Gs^Fms, Gg^Gvs, Gg^Gvs, Gg^Gvs, Gg^Gvs, Gg^Gvs, Gg, Gg, Gg, Gg, Rr, Gs^Fms, Gs^Fms, Hh^Fms, Hh^Fms, Hh^Fms, Gs^Fms, Gs^Fms, Hh^Fms, Hh^Fms, Hh^Fms, Gs^Fms, Gs^Fms, Gs, Gll, Gs^Fms, Gs^Fms, Gs, Gs, Gg, Gll, Gs^Fms, Gs, Gg^Es
Ww, Ds, Ww, Ds, Ww, Ww, Ww, Ww, Ww, Ds, Ds, Ss, Gs, Gg, Gs^Fms, Gs^Fms, Gll, Gs^Fms, Gs^Fms, Gg^Gvs, Gs^Fms, Gg, Gs, Gg, Gg, Gs, Rr, Gll, Gs^Fms, Gs^Fms, Gs^Fms, Hh^Fms, Gs^Fms, Gs^Fms, Hh^Fms, Hh^Fms, Hh^Fms, Hh^Fms, Gs^Fms, Gs, Gll, Gs^Fms, Gs^Fms, Gs, Gs^Fms, Gll, Gs^Fms, Gg, Gs, Gg^Es
Wo, Ww, Ww, Ww, Wo, Ww, Wo, Ww, Ww, Ww, Ds, Ss, Gs, Gs, Gs^Fms, Gs^Fms, Hh^Fms, Hh^Fms, Hh^Fms, Gs^Fms, Gs^Fms, Gll, Cski, Gs, Kski, Gg, Rr, Gg, Kski, Gs^Fms, Cski, Gs^Fms, Gll, Gs^Fms, Hh^Fms, Hh^Fms, Hh^Fms, Hh^Fms, Hh^Fms, Gs^Fms, Gs^Fms, Gs^Fms, Gs, Gs, Gg, Gs^Fms, Gg, Gg, Gs, Gs
Wo, Wo, Ww, Wo, Ww, Ww, Wo, Wo, Ww, Ww, Ds, Gs, Gs^Fms, Gs^Fms, Gs^Fms, Hh^Fms, Hh^Fms, Hh^Fms, Hh^Fms, Hh^Fms, Cski, Cski, Gg, Cski, Gg, Gg, Rr, Gg, Gg, Cski, Gg, Cski, Cski, Gs^Fms, Gs^Fms, Gs^Fms, Gs^Fms, Hh^Fms, Hh^Fms, Gs^Fms, Gll, Gg, Gs, Gs, Gs, Gs, Gs^Es, Gs, Gg^Es, Gg
Ww, Ww, Ds, Ww, Ds, Ww, Ww, Ww, Ww, Ds, Gs, Gs, Gg, Gs^Fms, Hh^Fms, Hh^Fms, Hh^Fms, Hh^Fms, Cski, Cski, Gg, Gg, Gs, Gg, Gg, Gs, Rr, Gg, Rr^Vhc, Gg, Gg, Gg, Gg, Cski, Cski, Gs^Fms, Gll, Gs^Fms, Gs^Fms, Gs^Fms, Gs^Fms, Gs^Fms, Gs^Es, Gg^Es, Gs^Fms, Gll, Gs^Fms, Gs^Fms, Gs, Gg
Ds, Ds, Ss, Ds, Ss, Ds, Ds, Ww, Ww, Ds, Gs, Gg, Gg, Gs^Fms, Gll, Hh^Fms, Gs^Fms, Cski, Gs, Gs, Gg, Gg, Cski, Gs, Rr^Vhc, Gg, Rr, Gg, Gs, Gs, Rr^Vhc, Gs, Gs, Gg, Rr, Cski, Gs^Fms, Gs^Fms, Hh^Fms, Gs^Fms, Gs^Fms, Gs^Es, Gs, Gs, Gll, Gs^Fms, Gs, Gs, Gs, Gg
Ss, Ss, Wwg, Ss, Ds, Ss, Ds, Ww, Ww, Ds, Gs, Gs, Gs^Fms, Gll, Gs^Fms, Hh^Fms, Cski, Cski, Gs, Gg, Cski, 3 Kski, Cski, Gg, Gg, Gs, Rr, Gg, Gg, Gs, Gg, Gs, Rr, Rr, Gg, Cski, Cski, Gs^Fms, Hh^Fms, Hh^Fms, Gs^Fms, Gs^Fms, Gll, Gg, Gll, Gs^Fms, Gs, Gs, Gs^Fms, Gs
Ds, Ds, Ds, Ss, Ss, Ss, Ds, Ww, Ds, Ds, Gs, Gs^Fms, Gs^Fms, Gs^Fms, Hh^Fms, Hh^Fms, Cski, Gg, Gs, Gs, Gg, Cski, Rr, Gg, Gg, Gg, Gg, Rr, Gs, Gg, Gs, Rr, Gg, Gg, Rr^Vhc, Gg, Cski, Gs^Fms, Gs^Fms, Hh^Fms, Gs^Fms, Gs^Fms, Gs, Gs^Fms, Gs^Fms, Gs^Fms, Gs, Gg, Gg, Gs^Fms
Ss^Bsb\, Ss, Ss, Ds, Ss, Gs, Gs, Ds, Gs, Gs, Gg, Gg, Gs^Fms, Hh^Fms, Hh^Fms, Gs^Fms, Cski, Gg, Gs, Rr^Vhc, Gg, Gg, Gg, Rr, Gg, Gg, Cski, Rr, Cski, Gg, Gg, Rr, Gs, Gg, Gg, Gg, Cski, Gs^Fms, Hh^Fms, Hh^Fms, Gs^Fms, Gll, Gs, Gll, Gs, Gs, Gg^Es, Gg^Es, Gg, Gg
Ss, Ds^Bsb\, Ds^Bsb\, Ss, Ss, Ss, Ss, Gs, Gg, Gs^Es, Gg, Gs^Fms, Gs^Fms, Hh^Fms, Hh^Fms, Hh^Fms, Hh^Fms, Cski, Gg, Gg, Gs, Rr^Vhc, Gg, Rr, Rr, Cski, Kski, Cski, Kski, Cski, Rr, Rr, Gs, Rr^Vhc, Gg, Cski, Gs^Fms, Hh^Fms, Hh^Fms, Hh^Fms, Gs^Fms, Gll, Gg, Gs^Fms, Gs, Gg^Es, Gs, Gg, Gs, Gg
Ss, Ss, Ss, Ds^Bsb\, Ss^Bsb\, Wwg, Ss, Gs, Gs, Gg, Gs, Gs, Gll, Gs^Fms, Gs^Fms, Hh^Fms, Gs^Fms, Kski, Gg, Gg, Rr, Gg, Rr, Gg, Cski, Cski, Cski, Cski, Cski, Cski, Cski, Gg, Gg, Gs, Gg, Kski, Gs^Fms, Hh^Fms, Gs^Fms, Gs^Fms, Gs, Gs^Vh, Gg, Gg, Gs, Gs, Ds, Gs, Ds, Gs
Ss, Wwg, Wwg, Ss, Wwg, Ss^Bsb\, Rr, Gs, Gs, Gg, Rr, Rr, Rr, Rr, Rr, Rr, Rr, Rr, Rr, Rr, Gs, Rr, Gg, Rr, Cski, Kski, Cski, 2 Kski, Cski, Kski, Cski, Rr, Rr, Rr, Rr, Rr, Rr, Gs^Fms, Rr, Gg, Rr, Gg, Rr, Gs, Ch, Ds, Ww, Ds, Ww, Ds
Ds, Ss, Ss, Ss, Ss, Ss, Ss, Rr, Rr, Rr, Gg, Gg, Gs^Fms, Gs^Fms, Hh^Fms, Gs^Fms, Gs^Fms, Gs, Gg, Gg, Wwb, Gg, Gs, Gg, Rr, Cski, Kski, Cski, Kski, Cski, Gg, Gg, Rr, Gs, Gg, Gg, Gs^Fms, Rr, Hh^Fms, Rr, Gg, Rr, Gs, Rr, Kh, Ww^Bsb\, Ww^Bsb\, Ww, Ww, Ww
Ss, Ss, Ss, Ss, Gs, Ss, Ss, Gs, Gs, Gg, Gg^Es, Gs, Gs^Fms, Hh^Fms, Hh^Fms, Gs^Fms, Gll, Kski, Gg, Wwb, Wwb, Wwb, Gg, Rr, Gg, Cski, Cski, Cski, Cski, Cski, Gg, Gg, Rr, Gs, Gg, Kski, Gs^Fms, Hh^Fms, Hh^Fms, Gg, Gg, Gs, Ds, Ch, Ww^Bsb\, Ww^Bsb\, Ww^Bsb\, Ww, Wo, Ww
Gs, Gs, Gs, Ss, Ss, Gs, Gs, Gs, Gg, Gg, Gs^Es, Gg, Gs^Fms, Hh^Fms, Hh^Fms, Hh^Fms, Gs^Fms, Cski, Gg, Wwb, Wwb, Wwb, Gg, Rr, Rr, Gg, Gg, Rr, Gg, Gg, Gs, Gg, Rr, Gg, Gg, Cski, Gs^Fms, Hh^Fms, Hh^Fms, Gs^Fms, Gs^Fms, Gs, Ds, Ww, Ww, Ww^Bsb\, Wo, Wo, Wo, Wo
Ds, Ds, Ds, Ss, Gs, Ss, Gs, Gs, Gg, Gs, Gs, Gg, Gs^Fms, Hh^Fms, Hh^Fms, Gs^Fms, Gs^Fms, Cski, Cski, Gg, Gg, Gs, Rr^Vhc, Gs, Rr, Gg, Rr^Vhc, Rr, Rr^Vhc, Gs, Rr, Rr, Gg, Gg, Cski, Cski, Gs^Fms, Gs^Fms, Hh^Fms, Hh^Fms, Gs^Fms, Gs, Ds, Ww, Ww, Ww, Wo, Wo, Wo, Wo
Ww, Ww, Ww, Ds, Ds, Gs, Gs, Gg, Gg, Gs^Vh, Gg, Gg, Gs^Fms, Gs^Fms, Hh^Fms, Hh^Fms, Gs^Fms, Gs^Fms, Gs^Fms, Cski, Rr, Rr, Rr, Rr, Rr^Vhc, Gg, Gg, Rr, Rr, Rr, Gg, Rr, Rr, Cski, Gll, Gs^Fms, Gs^Fms, Gs^Fms, Gs^Fms, Gs^Fms, Gs, Gs, Ds, Ww, Ww, Ww, Wo, Wo, Wo, Wo
Ww, Ww, Ww, Ww, Ds, Gs, Gs, Gg, Gs, Gs^Es, Gg, Gs, Gg, Gs^Fms, Hh^Fms, Hh^Fms, Hh^Fms, Gs^Fms, Gs^Fms, Cski, Cski, Gg, Rr^Vhc, Rr, Rr, Rr, Rr, Rr, Rr, Gg, Rr^Vhc, Gs, Cski, Cski, Gs^Fms, Gs^Fms, Hh^Fms, Hh^Fms, Gs^Fms, Gs, Ds, Ds, Ww, Ww, Ww, Wo, Wo, Wo, Wo, Wo
Wo, Ww, Ww, Ww, Ww, Ds, Gs, Gg, Gg, Gg, Gs, Gg, Gg, Gs^Fms, Gs^Fms, Hh^Fms, Gll, Gs^Fms, Gs, Gg, Cski, Gg, Gg, Gs, Rr, Gg, Gg, Rr^Vhc, Rr, Gg, Gg, Gs, Cski, Gs^Fms, Hh^Fms, Hh^Fms, Hh^Fms, Hh^Fms, Gs^Fms, Gs, Ds, Ww, Ww, Ww, Wo, Wo, Wo, Wo, Wo, Wo
Wo, Ww, Ww, Ww, Ww, Ds, Ds, Gs, Gg, Gg, Gg, Gs, Gg, Gs, Gs, Gs^Fms, Gs^Fms, Gs^Fms, Gs^Fms, Gg, Gg, Cski, Cski, Gg, Rr, Gg, Cski, Gg, Rr, Gg, Cski, Cski, Gs^Fms, Hh^Fms, Hh^Fms, Hh^Fms, Gs^Fms, Gs^Fms, Gll, Gs, Ds, Ww, Ww, Wo, Wo, Wo, Wo, Wo, Wo, Wo
Wo, Wo, Ww, Ww, Ww, Ww, Ds, Gs, Gs, Gg, Gg, Gg^Es, Gg, Gs^Fms, Gs^Fms, Gll, Gs^Fms, Gs, Gs^Fms, Gs, Gll, Gs, Gg, Cski, Cski, Cski, Gs^Fms, Cski, Cski, Cski, Gs^Fms, Gs^Fms, Gll, Hh^Fms, Hh^Fms, Hh^Fms, Gs^Fms, Gll, Gg, Gs, Ds, Ds, Ww, Ww, Wo, Wo, Wo, Wo, Wo, Wo
Wo, Wo, Wo, Ww, Ww, Ww, Ww, Ds, Ds, Gs, Gs, Gg, Gg, Gg, Gs, Gs^Fms, Gs^Fms, Gll, Gs^Fms, Gll, Gs^Fms, Gs, Gs, Gg, Gs, Gll, Gs^Fms, Gs, Gll, Gll, Gs^Fms, Gll, Hh^Fms, Hh^Fms, Hh^Fms, Gll, Gs^Fms, Gll, Gs, Gs, Ds, Ww, Ww, Ww, Wo, Wo, Wo, Wo, Wo, Wo
Wo, Wo, Wo, Ww, Ww, Ww, Ww, Ww, Ww, Ds, Ds, Gs, Gs, Gg, Gg, Gg, Gs^Fms, Gs^Fms, Gs^Fms, Gs^Fms, Hh^Fms, Gs^Fms, Gs^Fms, Gs, Gs^Fms, Gs^Fms, Gll, Gs^Fms, Gs^Fms, Gs, Hh^Fms, Gll, Gs, Gll, Gs^Fms, Gs^Fms, Gs^Fms, Gll, Gs^Es, Ds, Ww, Ww, Ww, Ww, Wo, Wo, Wo, Wo, Wo, Wo
Wo, Wo, Wo, Wo, Ww, Ww, Ww, Ww, Ww, Ww, Ww, Ds, Gs, Gg, Gs^Es, Gs, Gs^Fms, Gll, Gs^Fms, Hh^Fms, Hh^Fms, Gs^Fms, Hh^Fms, Gs, Gll, Gs, Gs^Fms, Gs, Gs^Fms, Hh^Fms, Hh^Fms, Gs^Fms, Gs^Fms, Gs^Fms, Gs^Vh, Gs^Fms, Gs^Fms, Gs^Fms, Gs, Ds, Ww, Ww, Ww, Wo, Wo, Wo, Wo, Wo, Wo, Wo
Wo, Wo, Wo, Wo, Wo, Ww, Wo, Ww, Ww, Ww, Ds, Ds, Gs, Gg, Gs^Es, Gs, Gs, Gs^Fms, Gll, Hh^Fms, Hh^Fms, Hh^Fms, Hh^Fms, Gs^Fms, Gs^Fms, Gll, Gs^Fms, Gs^Fms, Hh^Fms, Hh^Fms, Hh^Fms, Hh^Fms, Gll, Gg, Gs^Fms, Gs^Fms, Gs^Fms, Gll, Gs, Ds, Ww, Ww, Wo, Wo, Wo, Wo, Wo, Wo, Wo, Wo
Wo, Wo, Wo, Wo, Wo, Wo, Wo, Wo, Ww, Ww, Ds, Gs, Gs, Gg, Gs, Gg, Gs^Fms, Gs^Fms, Gs^Fms, Gs^Fms, Gs^Fms, Hh^Fms, Gs^Fms, Gs, Gll, Gg, Gs^Fms, Hh^Fms, Hh^Fms, Hh^Fms, Hh^Fms, Gs^Fms, Gll, Gs^Es, Gs^Fms, Gll, Gg, Gs, Ds, Ds, Ww, Ww, Ww, Wo, Wo, Wo, Wo, Wo, Wo, Wo
Wo, Wo, Wo, Wo, Wo, Wo, Wo, Wo, Ww, Ww, Ww, Ds, Gs, Gg, Gs, Gs^Fms, Gll, Gll, Gll^Es, Gs^Fms, Gs^Fms, Gs^Fms, Gs^Fms, Gs^Fms, Gll, Gll, Gs^Fms, Gs^Fms, Gs^Fms, Hh^Fms, Gs^Fms, Gs^Fms, Gs^Fms, Gs^Fms, Gs, Gg, Gg, Gs, Ds, Ds, Ww, Ww, Wo, Wo, Wo, Wo, Wo, Wo, Wo, Wo
Wo, Wo, Wo, Wo, Wo, Wo, Wo, Wo, Ww, Ww, Ww, Ds, Gs, Gg, Gg, Gs^Fms, Gs^Fms, Gg, Gs, Gll^Es, Gs^Fms, Gs^Fms, Gs^Fms, Gs^Fms, Gs^Fms, Gll, Gs^Fms, Gll, Gll, Gs^Fms, Gs^Fms, Gll, Gs^Fms, Gs, Gg^Es, Gs, Gs, Gs, Ds, Ds, Ds, Ww, Ww, Wo, Wo, Wo, Wo, Wo, Wo, Wo
Wo, Wo, Wo, Wo, Wo, Wo, Wo, Wo, Ww, Ww, Ww, Ds, Ds, Gs, Gs, Gg^Es, Gg, Gs^Fms, Gg, Gs, Gs^Fms, Gs^Fms, Gs^Fms, Gll, Gs^Fms, Gs^Fms, Gll, Gs^Fms, Gll, Gs^Fms, Gs^Fms, Gs^Fms, Gg, Gg, Gs, Gs, Ds, Ds, Ww, Ds, Ds, Ww, Ww, Wo, Wo, Wo, Wo, Wo, Wo, Wo
Wo, Wo, Wo, Wo, Wo, Wo, Wo, Wo, Ww, Ww, Ww, Ww, Ww, Ds, Gs, Gg, Gg, Gs, Gs, Gs^Fms, Gs, Gs^Fms, Gll, Gs^Fms, Gs^Fms, Re^Vct, Gg, Gs^Fms, Gg, Gs^Fms, Gs, Gs, Gs, Gs^Es, Gs, Ds, Ww, Ww, Ww, Ww, Ds, Ds, Ww, Ww, Wo, Wo, Wo, Wo, Wo, Wo
Wo, Wo, Wo, Wo, Wo, Wo, Wo, Wo, Wo, Ww, Ww, Ww, Ww, Ds, Ds, Gs, Gs, Gg^Es, Gg^Es, Gs, Gs, Gs^Fms, Gll, Gs^Fms, Gs^Fms, Gll, Gs, Gs, Gs, Gg, Gg, Gs, Gs, Gs, Ds, Ds, Ww, Ww, Ww, Ww, Ww, Ds, Ww, Ww, Ww, Wo, Wo, Wo, Wo, Wo
Wo, Wo, Wo, Wo, Wo, Wo, Wo, Wo, Wo, Wo, Wo, Ww, Ww, Ww, Ds, Ds, Gs, Gg, Gg, Gg^Es, Gs, Gs^Fms, Gs, Gg, Gg, Gs^Fms, Gs^Fms, Gg, Re^Vct, Gs, Gs, Gg^Es, Gs, Ds, Ds, Ww, Ww, Ww, Ww, Ww, Ww, Ds, Ww, Ww, Ww, Wo, Wo, Wo, Wo, Wo
Wo, Wo, Wo, Wo, Wo, Wo, Wo, Wo, Wo, Wo, Wo, Ww, Ww, Ww, Ww, Ds, Ds, Gs, Gg, Gs^Es, Gg, Gs^Fms, Gs^Fms, Gs, Ce, Ce, Ce, Gg, Gg, Gg, Gg^Es, Gg, Gs, Ds, Gs, Ds, Ww, Ww, Ww, Ww, Ds, Ww, Ww, Ww, Ww, Wo, Wo, Wo, Wo, Wo
Wo, Wo, Wo, Wo, Wo, Wo, Wo, Wo, Wo, Wo, Wo, Wo, Wo, Ww, Ww, Ww, Ds, Gs, Gg^Es, Gs, Gs, Gg, Re^Vct, Gs, Ce, 1 Ke, Ce, Gg, Gg, Gs, Gg, Gs, Gs^Fms, Gs, Gs, Ds, Ds, Ww, Ds, Ds, Ww, Ww, Ww, Ww, Wo, Wo, Wo, Wo, Wo, Wo
Wo, Wo, Wo, Wo, Wo, Wo, Wo, Wo, Wo, Wo, Wo, Wo, Wo, Ww, Ww, Ww, Ds, Gs, Gg, Gs, Gs, Gg, Gs, Gs, Gg, Ce, Gs, Gs, Re^Vct, Gg, Gs, Gs, Gg, Gs^Fms, Gg, Gs, Ds, Ww, Ds, Ds, Ww, Ww, Ww, Wo, Wo, Wo, Wo, Wo, Wo, Wo
Wo, Wo, Wo, Wo, Wo, Wo, Wo, Wo, Wo, Wo, Wo, Wo, Wo, Ww, Ww, Ww, Ds, Gs, Gs, Gg, Gs, Gs, Gg, Gg, Gs, Gs, Gg, Gg, Gs, Gs, Gs, Gs^Fms, Gs, Gg^Es, Gg, Gs, Ds, Ds, Ww, Ww, Ww, Ww, Wo, Wo, Wo, Wo, Wo, Wo, Wo, Wo
Wo, Wo, Wo, Wo, Wo, Wo, Wo, Wo, Wo, Wo, Wo, Wo, Wo, Ww, Ww, Ww, Ww, Ds, Ds, Gs, Ds, Gs, Gs, Gg, Gg^Es, Gg, Re^Vct, Gs, Gg, Gs, Gs^Fms, Gs, Hh^Fms, Gs^Fms, Gg, Gs, Ds, Ww, Ww, Ww, Ww, Wo, Wo, Wo, Wo, Wo, Wo, Wo, Wo, Wo
Wo, Wo, Wo, Wo, Wo, Wo, Wo, Wo, Wo, Wo, Wo, Wo, Wo, Ww, Ww, Ww, Ww, Ds, Ww, Ds, Ww, Ds, Ds, Gs, Gs, Gg, Gs, Gg, Gs, Gs, Hh^Fms, Hh^Fms, Hh^Fms, Gll, Gll, Gs^Fms, Gs, Ds, Ww, Ww, Ww, Wo, Wo, Wo, Wo, Wo, Wo, Wo, Wo, Wo
Wo, Wo, Wo, Wo, Wo, Wo, Wo, Wo, Wo, Wo, Wo, Wo, Wo, Wo, Wo, Ww, Ww, Ww, Ww, Ww, Ww, Ww, Ww, Ds, Ds, Gs, Gs, Gs^Fms, Gs, Gs^Fms, Hh^Fms, Hh^Fms, Hh^Fms, Hh^Fms, Gs^Fms, Gs^Fms, Gs, Ds, Ds, Ww, Ww, Ww, Wo, Wo, Wo, Wo, Wo, Wo, Wo, Wo
Wo, Wo, Wo, Wo, Wo, Wo, Wo, Wo, Wo, Wo, Wo, Wo, Wo, Wo, Wo, Wo, Wo, Ww, Ww, Ww, Ww, Ww, Ww, Ww, Ds, Gs, Gs, Gs^Fms, Gs, Gs^Fms, Gll, Hh^Fms, Gll, Gs^Fms, Gll, Gs, Gs, Gs, Ds, Ww, Ww, Ww, Wo, Wo, Wo, Wo, Wo, Wo, Wo, Wo
Wo, Wo, Wo, Wo, Wo, Wo, Wo, Wo, Wo, Wo, Wo, Wo, Wo, Wo, Wo, Wo, Wo, Wo, Wo, Ww, Wo, Ww, Ww, Ww, Ww, Ds, Gs, Gs^Fms, Gg, Gs^Fms, Gs^Fms, Gs^Fms, Gll, Gs, Gs^Fms, Gg, Gs, Ds, Ww, Ww, Ww, Ww, Wo, Wo, Wo, Wo, Wo, Wo, Wo, Wo
Wo, Wo, Wo, Wo, Wo, Wo, Wo, Wo, Wo, Wo, Wo, Wo, Wo, Wo, Wo, Wo, Wo, Wo, Wo, Wo, Wo, Ww, Ww, Ww, Ww, Ds, Gs, Gs, Gg, Gs, Gs, Gs^Fms, Gs^Fms, Gs^Fms, Gg, Gs, Ds, Ds, Ww, Ww, Ww, Ww, Wo, Wo, Wo, Wo, Wo, Wo, Wo, Wo
Wo, Wo, Wo, Wo, Wo, Wo, Wo, Wo, Wo, Wo, Wo, Wo, Wo, Wo, Wo, Wo, Wo, Wo, Wo, Wo, Wo, Ww, Ww, Ww, Ww, Ds, Ds, Gs, Gs, Gg, Gg, Gs, Gg, Gg, Gs, Gs, Ds, Ww, Ww, Ww, Ww, Wo, Wo, Wo, Wo, Wo, Wo, Wo, Wo, Wo
Wo, Wo, Wo, Wo, Wo, Wo, Wo, Wo, Wo, Wo, Wo, Wo, Wo, Wo, Wo, Wo, Wo, Wo, Wo, Wo, Wo, Wo, Wo, Ww, Ww, Ww, Ww, Ds, Ds, Gs, Gs, Gs, Gs, Gs, Ds, Ds, Ww, Ww, Ww, Ww, Ww, Wo, Wo, Wo, Wo, Wo, Wo, Wo, Wo, Wo
Wo, Wo, Wo, Wo, Wo, Wo, Wo, Wo, Wo, Wo, Wo, Wo, Wo, Wo, Wo, Wo, Wo, Wo, Wo, Wo, Wo, Wo, Wo, Ww, Ww, Ww, Ww, Ww, Ww, Ds, Ds, Ds, Ds, Ds, Ww, Ds, Ww, Ww, Ww, Ww, Wo, Wo, Wo, Wo, Wo, Wo, Wo, Wo, Wo, Wo
Wo, Wo, Wo, Wo, Wo, Wo, Wo, Wo, Wo, Wo, Wo, Wo, Wo, Wo, Wo, Wo, Wo, Wo, Wo, Wo, Wo, Wo, Wo, Wo, Ww, Ww, Ww, Ww, Ww, Ww, Ww, Ww, Ww, Ww, Ww, Ww, Ww, Ww, Ww, Ww, Wo, Wo, Wo, Wo, Wo, Wo, Wo, Wo, Wo, Wo
Wo, Wo, Wo, Wo, Wo, Wo, Wo, Wo, Wo, Wo, Wo, Wo, Wo, Wo, Wo, Wo, Wo, Wo, Wo, Wo, Wo, Wo, Wo, Wo, Wo, Wo, Wo, Ww, Ww, Ww, Ww, Ww, Ww, Ww, Ww, Ww, Ww, Ww, Wo, Ww, Wo, Wo, Wo, Wo, Wo, Wo, Wo, Wo, Wo, Wo
Wo, Wo, Wo, Wo, Wo, Wo, Wo, Wo, Wo, Wo, Wo, Wo, Wo, Wo, Wo, Wo, Wo, Wo, Wo, Wo, Wo, Wo, Wo, Wo, Wo, Wo, Wo, Wo, Wo, Ww, Ww, Ww, Ww, Ww, Wo, Ww, Wo, Wo, Wo, Wo, Wo, Wo, Wo, Wo, Wo, Wo, Wo, Wo, Wo, Wo
Wo, Wo, Wo, Wo, Wo, Wo, Wo, Wo, Wo, Wo, Wo, Wo, Wo, Wo, Wo, Wo, Wo, Wo, Wo, Wo, Wo, Wo, Wo, Wo, Wo, Wo, Wo, Wo, Wo, Wo, Wo, Wo, Wo, Wo, Wo, Wo, Wo, Wo, Wo, Wo, Wo, Wo, Wo, Wo, Wo, Wo, Wo, Wo, Wo, Wo
