border_size=1
usage=map

Mm, Mm, Mm, Mm, Mm, Mm, Mm, Mm, Mm, Mm, Mm, Mm, Mm, Mm, Mm, Mm, Hh^Fms, Hh^Fms, Gs^Fms, Gs^Fms, Gs, Gs^Es, Gll, Gll, Gs^Fms, Gll, Gs^Fms, Gg, Gs^Fms, Gll, Gs, Gll, Gs^Fms, Gg, Gs^Fms, Gs^Fms, Gs^Fms, Gs^Fms, Gll, Gs, Gs^Fms, Gs, Gg^Es, Gg, Gs, Gs^Fms, Gs^Fms, Gs^Fms, Hh^Fms, Hh^Fms, Mm, Mm, Mm, Mm, Mm, Mm
Mm, Mm, Mm, Mm, Mm^Xm, Mm, Mm, Mm, Mm, Mm, Mm, Mm, Mm, Mm, Mm, Mm, Hh^Fms, Hh^Fms, Gs^Fms, Gs^Fms, Gll, Gs, Gs^Fms, Gs^Fms, Gs, Gs, Gll, Gs^Fms, Gs^Fms, Gll, Gll, Gs^Es, Gs^Fms, Gs^Fms, Hh^Fms, Hh^Fms, Hh^Fms, Gs^Fms, Gs^Fms, Gs^Fms, Gs, Gs, Gs, Gg, Gs^Efm, Gs^Fms, Gs^Fms, Hh^Fms, Hh^Fms, Mm, Mm, Mm, Mm, Mm, Mm, Mm
Mm, Mm, Mm^Xm, Mm^Xm, Mm, Mm^Xm, Mm^Xm, Mm^Xm, Mm^Xm, Mm, Mm^Xm, Mm, Mm, Mm, Hh^Fms, Hh^Fms, Hh^Fms, Hh^Fms, Gs^Fms, Gs^Fms, Gs^Fms, Gs^Fms, Gs^Fms, Gll, Gs^Es, Gll, Gs^Fms, Gs^Fms, Gs^Fms, Gll, Gs^Fms, Gll, Gs^Fms, Hh^Fms, Hh^Fms, Mm, Mm, Hh^Fms, Hh^Fms, Gs^Fms, Gs, Gs^Es, Gs, Gg, Gs^Efm, Gs, Gs^Fms, Hh^Fms, Hh^Fms, Mm, Mm, Mm, Mm, Mm, Mm, Mm
Mm, Mm, Mm, Mm, Mm^Xm, Mm, Mm^Xm, Mm, Mm, Mm, Mm, Mm, Mm, Hh^Fms, Hh^Fms, Hh^Fms, Gs^Fms, Gs^Fms, Gll, Gs, Gll, Gll^Es, Gll, Gll, Gs^Fms, Gll^Es, Gll, Gll, Gs^Fms, Gs^Fms, Gll, Gs^Fms, Hh^Fms, Hh^Fms, Mm, Mm, Mm, Mm, Hh^Fms, Gs^Fms, Gg^Ve, Gg^Efm, Gs, Gg, Gs^Efm, Gs^Fms, Gs^Fms, Hh^Fms, Hh^Fms, Mm, Ww, Mm, Ww, Ww, Mm, Mm
Mm, Mm^Xm, Mm, Mm, Mm^Xm, Mm, Mm, Mm, Mm, Mm, Mm, Mm, Mm, Hh^Fms, Hh^Fms, Gs^Fms, Gs^Fms, Gs^Fms, Gs^Fms, Gs^Fms, Gs, Gs, Gs^Fms, Gs^Fms, Gg^Ve, Gs^Fms, Gs^Fms, Gll^Es, Gs^Fms, Gll^Es, Gll, Gs^Fms, Hh^Fms, Mm, Mm, Mm, Mm, Mm, Hh^Fms, Gs^Fms, Gs^Fms, Gs^Efm, Gg, Gs^Es, Gg, Gg^Ve, Gs^Es, Gs^Fms, Ww, Ww, Ww, Ww, Mm, Mm, Mm, Mm
Mm, Mm^Xm, Mm, Mm, Mm^Xm, Mm, Mm^Cov, Mm^Cov, Mm^Cov, Mm, Mm, Mm, Mm, Hh^Fms, Hh^Fms, Gs^Fms, Gs^Fms, Gs, Gll, Gs^Fms, Gs^Es, Gs^Fms, Gs^Fms, Gll, Gs^Es, Gll, Gs^Fms, Gs^Fms, Gll, Gs^Fms, Gs^Fms, Gs^Fms, Gs^Fms, Hh^Fms, Hh^Fms, Mm, Mm, Mm, Mm, Hh^Fms, Gs^Fms, Gs^Efm, Gg, Gs, Gg, Gg, Gs, Gs, Ww, Ww, Hh^Fms, Mm, Mm, Mm, Mm, Mm
Mm^Xm, Mm, Mm, Mm, Mm, Mm, Mm^Cov, 6 Mm^Kov, Mm^Cov, Mm, Mm, Mm, Mm, Hh^Fms, Hh^Fms, Gs^Fms, Gs^Fms, Gll, Gs^Fms, Gll, Gs, Gll, Gs^Fms, Gll^Es, Gs, Gs^Fms, Gs^Fms, Gll^Efm, Gs^Efm, Gll, Gs^Fms, Gll, Gll, Gs^Fms, Hh^Fms, Hh^Fms, Hh^Fms, Mm, Hh^Fms, Hh^Fms, Gs^Fms, Gs, Gg, Gg, Ww, Ww, Ww, Ww, Ww, Ww, Gs^Fms, Hh^Fms, Mm, Mm, Mm, Mm
Mm, Mm, Mm, Mm^Xm, Mm, Mm, Mm, Mm^Cov, Mm, Mm, Mm, Mm, Mm, Mm, Hh^Fms, Gs^Fms, Gs^Fms, Gs^Fms, Gll^Efm, Gs^Fms, Gll, Gs^Fms, Gll, Gs, Gll, Gs^Fms, Gs^Fms, Gs^Fms, Gll^Efm, Gll^Efm, Gs^Fms, Gll, Gll, Gs^Fms, Gg^Ve, Gs^Fms, Gs^Fms, Hh^Fms, Gs^Fms, Gs^Fms, Gs, Gs, Ww, Ww, Ww, Ww, Ww, Ww, Gs^Fms, Gs^Fms, Hh^Fms, Hh^Fms, Mm, Mm, Mm, Mm
Mm, Mm^Xm, Mm^Xm, Mm, Mm^Xm, Mm, Mm, Mm, Mm, Mm, Mm, Mm, Mm, Mm, Mm, Hh^Fms, Gs^Fms, Gll, Gg^Ve, Gs^Fms, Gs^Fms, Gs^Fms, Gs^Fms, Gs^Fms, Gs^Fms, Gs^Fms, Gs^Fms, Gll, Gs^Fms, Gs^Fms, Gs^Fms, Gs^Fms, Gs^Fms, Gll^Es, Gll, Gll, Gll, Gs^Fms, Cv, Gs, Gg^Efm, Gg, Ww, Ww, Gg^Ve, Gg^Es, Gg, Gs, Gs^Fms, Hh^Fms, Hh^Fms, Mm, Mm, Mm, Mm, Mm
Mm, Mm, Mm, Mm, Mm, Mm, Mm, Mm, Mm, Mm, Mm, Mm, Mm, Mm, Hh^Fms, Hh^Fms, Gs^Efm, Gll, Gs^Fms, Gs^Fms, Hh^Fms, Hh^Fms, Hh^Fms, Hh^Fms, Hh^Fms, Gs^Fms, Gs^Fms, Gs^Fms, Hh^Fms, Gs^Fms, Hh^Fms, Hh^Fms, Hh^Fms, Gs^Fms, Gs^Fms, Gll, Gg, Cv, 4 Kv, Cv, Gg, Gg, Ww, Ww, Ww, Gg, Gs, Gs, Gs^Fms, Hh^Fms, Mm, Mm, Mm, Mm, Mm, Mm
Mm, Mm, Mm, Mm, Mm, Mm, Mm, Mm, Mm, Mm, Mm, Mm, Mm, Hh^Fms, Gs, Gs, Gs, Gll^Efm, Gs^Fms, Hh^Fms, Mm, Mm, Mm, Mm, Mm, Hh^Fms, Hh^Fms, Hh^Fms, Mm, Hh^Fms, Mm, Mm, Mm, Hh^Fms, Hh^Fms, Gs^Fms, Gg, Cv, Cv, Cv, Gs^Fms, Gg, Gs^Efm, Ww, Ww, Gg, Gs^Efm, Gs^Fms, Hh^Fms, Hh^Fms, Mm, Mm, Mm, Mm, Mm, Mm
Hh^Fms, Mm, Hh^Fms, Hh^Fms, Hh^Fms, Hh^Fms, Hh^Fms, Hh^Fms, Hh^Fms, Hh^Fms, Hh^Fms, Mm, Hh^Fms, Hh^Fms, Wwf, Wwf, Wwf, Gs, Gs^Es, Hh^Fms, Mm, Mm, Mm, Mm, Mm, Hh^Fms, Mm, Mm, Mm, Mm, Mm, Mm, Mm, Mm, Hh^Fms, Gs^Fms, Gs^Fms, Gg^Efm, Gg, Gs^Fms, Gs^Fms, Gs, Gg^Efm, Ww, Ww, Gg^Efm, Gs, Gs^Fms, Hh^Fms, Hh^Fms, Mm, Mm, Mm, Mm, Mm, Mm
Ww, Hh^Fms, Ww, Ww, Ww, Gs^Fms, Gg^Ve, Hh^Fms, Gs^Fms, Gs^Fms, Gs^Fms, Hh^Fms, Ww, Ww, Hh^Fms, Gg, Gs, Ww, Ww, Hh^Fms, Hh^Fms, Mm, Mm, Mm, Mm, Mm, Mm, Mm, Mm, Mm, Mm, Mm, Mm, Mm, Mm, Hh^Fms, Gs^Fms, Gs^Efm, Gg^Efm, Gs^Fms, Gll, Gs^Fms, Gg, Ww, Ww, Gg^Efm, Gs, Gs^Fms, Gs^Fms, Hh^Fms, Hh^Fms, Mm, Mm, Mm, Mm, Mm
Ww, Ww, Gs^Fms, Gs^Fms, Gs^Fms, Ww, Ww, Ww, Ww, Ww, Ww, Ww, Hh^Fms, Hh^Fms, Hh^Fms, Hh^Fms, Hh^Fms, Gs^Es, Ww, Gg^Es, Hh^Fms, Mm, Mm, Mm, Mm, Mm, Mm, Mm, Mm, Mm, Hh^Fms, Hh^Fms, Hh^Fms, Mm, Hh^Fms, Hh^Fms, Gs^Fms, Gg^Efm, Gg^Ve, Gg, Gs^Fms, Gs^Fms, Ss, Ww, Ww, Gg, Gg, Gs^Efm, Gs^Fms, Hh^Fms, Mm, Mm, Mm, Mm, Mm, Mm
Hh^Fms, Hh^Fms, Hh^Fms, Hh^Fms, Hh^Fms, Gs^Fms, Gs^Fms, Ww, Gll^Efm, Gll^Efm, Hh^Fms, Gs^Fms, Hh^Fms, Mm, Mm, Mm, Hh^Fms, Gg, Ww, Ww, Gs^Fms, Hh^Fms, Hh^Fms, Mm, Mm, Mm, Mm, Mm, Hh^Fms, Hh^Fms, Hh^Fms, Hh^Fms, Gs^Fms, Hh^Fms, Gs^Fms, Gs^Fms, Gg, Gg^Es, Gs^Es, Gg^Es, Gs, Gs, Ss, Ss, Ww, Ww, Ss, Gs^Efm, Gs^Fms, Hh^Fms, Mm, Mm, Mm, Mm, Mm, Mm
Mm, Hh^Fms, Hh^Fms, Hh^Fms, Hh^Fms, Gs^Fms, Gs^Fms, Wwf, Gll^Efm, Gs^Fms, Hh^Fms, Hh^Fms, Mm, Mm, Mm, Hh^Fms, Hh^Fms, Gs, Ww, Ww, Gg, Gs^Fms, Gs^Fms, Hh^Fms, Hh^Fms, Hh^Fms, Hh^Fms, Hh^Fms, Gs^Fms, Gs^Fms, Gs^Fms, Gs^Fms, Ww, Ww, Ww, Ww, Ww, Gg, Gg^Efm, Gg, Ss, Ss, Ss, Ss, Ww, Ww, Ss, Gs, Gs^Fms, Hh^Fms, Mm, Mm, Mm, Mm, Mm, Mm
Mm, Mm, Mm, Mm, Mm, Hh^Fms, Gs^Fms, Wwf, Wwf, Hh^Fms, Hh^Fms, Mm, Mm, Mm, Hh^Fms, Hh^Fms, Ww, Ww, Ww, Ww, Ww, Gg, Gs, Gs^Fms, Gs^Fms, Gs^Fms, Gs^Fms, Gs^Fms, Gs, Gs, Gg^Ve, Ww, Ww, Ww, Ww, Ww, Ww, Ww, Ww, Gg^Efm, Ww, Ww, Ww, Ww, Ww, Ww, Ss, Gs, Gs^Fms, Hh^Fms, Hh^Fms, Mm, Mm, Mm, Mm, Mm
Mm, Mm, Mm, Mm, Mm, Hh^Fms, Hh^Fms, Gg^Es, Ww, Gg, Hh^Fms, Mm, Mm, Mm, Hh^Fms, Hh^Fms, Ww, Ww, Wo, Wo, Ww, Ww, Gg, Gs, Gs, Gs, Ww, Gg^Efm, Ww, Gg^Efm, Ww, Ww, Ww, Ww, Wo, Wo, Ww, Ww, Ww, Ww, Ww, Ww, Ww, Ww, Ww, Ss, Gg^Efm, Gs^Efm, Gs, Gs^Fms, Hh^Fms, Hh^Fms, Hh^Fms, Mm, Mm, Mm
Mm, Mm, Mm, Mm, Mm, Mm, Hh^Fms, Gg, Ww, Gs, Gll, Hh^Fms, Mm, Mm, Hh^Fms, Hh^Fms, Ww, Ww, Ww, Wo, Ww, Ww, Ww, Gg^Es, Gg, Ww, Ww, Ww, Ww, Wwf, Ww, Ww^Ewl, Ww^Ewl, Wo, Wo, Wo, Ww, Ww^Ewl, Ww, Ww^Ewl, Ww, Ww, Ww^Ewl, Ww, Ww, Ss, Gg, Gg, Gs^Es, Gg^Ve, Gs^Fms, Hh^Fms, Hh^Fms, Hh^Fms, Mm, Mm
Mm, Mm, Mm, Mm, Mm, Mm, Hh^Fms, Gg, Ww, Gs, Hh^Fms, Hh^Fms, Mm, Mm, Hh^Fms, Hh^Fms, Ww, Ww, Ww, Ww^Ewl, Wo, Ww, Ww, Ww, Ww, Ww, Wo, Ww, Ww, Wwf, Ww, Ww, Wo, Wo, Wo, Wo, Wo, Ww, Wo, Ww, Wo, Wo, Ww^Ewl, Ww, Ww, Ww, Ww, Gg, Gs^Es, Gs^Fms, Hh^Fms, Hh^Fms, Hh^Fms, Hh^Fms, Mm, Mm
Mm, Mm, Mm, Mm, Mm, Mm, Hh^Fms, Gs, Ww, Gg^Es, Hh^Fms, Hh^Fms, Mm, Mm, Mm, Hh^Fms, Hh^Fms, Ww, Ww, Wo, Wo, Ww, Ww^Ewl, Ww, Ww, Ww, Wo, Ww, Ww^Ewl, Wwf, Ww, Wo, Ww, Ww, Ww^Ewl, Ww, Wo, Wo, Ww, Wo, Wo, Wo, Wo, Ww, Ww^Ewl, Ww, Ww, Gg^Efm, Gs, Gs^Fms, Hh^Fms, Hh^Fms, Mm, Mm, Mm, Mm
Mm, Mm, Mm, Mm, Mm, Hh^Fms, Gs^Fms, Gs^Es, Ww, Gg, Gs^Fms, Hh^Fms, Mm, Mm, Mm, Hh^Fms, Hh^Fms, Hh^Fms, Ww, Ww, Ww, Ww, Ww, Ww, Wo, Wo, Wo, Ww, Ww, Wwf, Wwf, Ww^Ewl, Ww, Ww^Vm, Ww, Wo, Wo, Ww, Ww, Ww^Ewl, Ww, Wo, Wo, Wo, Wo, Ww, Ww, Gg^Efm, Gs^Efm, Gs^Fms, Hh^Fms, Mm, Mm, Mm, Mm, Mm
Mm, Mm, Mm, Mm, Mm, Hh^Fms, Hh^Fms, Gg, Ww, Gg, Hh^Fms, Hh^Fms, Mm, Mm, Mm, Hh^Fms, Ww, Ww, Ww, Ww^Ewl, Ww, Wo, Ww^Ewl, Ww^Ewl, Wo, Ww, Ww, Wo, Wo, Ww, Ww, Wwf, Ww, Wo, Wo, Wo, Ww^Ewl, Wo, Ww, Ww, Wo, Wo, Ww^Ewl, Ww, Wo, Ww, Ww, Gg, Gs^Es, Gs^Fms, Hh^Fms, Mm, Mm, Mm, Mm, Mm
Mm, Mm, Hh^Fms, Mm, Hh^Fms, Hh^Fms, Ww, Ww, Gs, Hh^Fms, Mm, Mm, Mm, Mm, Hh^Fms, Hh^Fms, Ww, Ww, Ww, Ww, Wo, Wo, Wo, Wo, Wo, Wo, Wo, Ww, Wo, Ww^Ewl, Ww, Wwf, Wwf, Ww, Wo, Ww, Ww, Wo, Wo, Ww, Wo, Ww, Wo, Wo, Wo, Ww^Ewl, Ww, Ww, Gs^Es, Gs^Fms, Hh^Fms, Hh^Fms, Mm, Mm, Mm, Mm
Hh^Fms, Hh^Fms, Hh^Fms, Hh^Fms, Gs^Fms, Gs^Fms, Ww, Gg^Es, Hh^Fms, Hh^Fms, Mm, Mm, Hh^Fms, Hh^Fms, Hh^Fms, Ww, Ww, Ww, Ww^Ewl, Ww^Ewl, Ww, Ww, Ww, Wo, Ww^Ewl, Wo, Wo, Ww^Ewl, Ww, Ww, Ww, Ww, Ds, Ww, Ww, Ww, Ww, Ww, Wo, Wo, Ww^Ewl, Ww, Wo, Ww, Ww, Ww^Ewl, Ww, Ww, Gs, Gs^Fms, Gs^Fms, Hh^Fms, Hh^Fms, Mm, Mm, Mm
Hh^Fms, Hh^Fms, Gs^Fms, Gs^Fms, Gs^Fms, Gs, Ww, Gg, Hh^Fms, Mm, Mm, Mm, Hh^Fms, Hh^Fms, Wwf, Ww, Ww, Ww, Wo, Wo, Ss, Ss, Gs^Es, Ww, Ss, Ww, Ww, Wo, Ww, Ww, Ds, Ds, Gs^Fms, Ds, Ds, Ds, Ds, Ww, Ww, Wo, Ww^Ewl, Wo, Wo, Ww^Ewl, Wo, Ww, Ww, Gg, Gs, Gll, Gs^Fms, Hh^Fms, Hh^Fms, Mm, Mm, Mm
Gs^Fms, Gs^Fms, Gs^Fms, Gs^Fms, Re^Vct, Gs^Es, Ww, Gs, Gs^Es, Hh^Fms, Mm, Hh^Fms, Hh^Fms, Hh^Fms, Ww, Wwf, Wwf, Ww, Ww, Ww^Ewl, Ss, Gs, Gs^Fms, Gs, Gs, Ss, Wwf, Ww, Wwf, Ds, Gg^Ve, Gs^Fms, Gs^Fms, Gs^Cov, Gs^Fms, Gg^Ve, Ds, Ww, Ww, Wo, Ww, Wo, Ww^Ewl, Wo, Ww, Ww, Gs, Gs, Gs^Fms, Gs^Fms, Gll, Gs^Fms, Hh^Fms, Hh^Fms, Hh^Fms, Mm
Gs^Fms, Gs^Fms, Gs^Fms, Gs^Fms, Gs^Efm, Gg, Wwf, Gg^Ve, Gs, Hh^Fms, Hh^Fms, Mm, Hh^Fms, Gg^Ve, Ww, Ww, Ww, Wwf, Wwf, Ww, Gll, Gg^Ve, Hh^Fms, Gs^Fms, Gs^Es, Wwf, Ww, Wwf, Ww, Ds, Gs^Es, Gs^Fms, Gll^Cov, 5 Gll^Kov, Gll^Cov, Gs^Fms, Gs^Es, Ds, Wwf, Ww, Wwf, Ww, Wwf, Ww, Ww, Ww, Gs, Gg^Ve, Gs^Fms, Gll, Gs^Fms, Gs^Fms, Gs^Fms, Hh^Fms, Hh^Fms, Hh^Fms
Gs^Fms, Gs^Fms, Gll, Gll, Gs^Efm, Gs^Efm, Ww, Ww, Ww, Gg, Gg, Hh^Fms, Ss, Ss, Ss, Ww, Ww^Ewl, Ww, Ss, Wwf, Gll, Hh^Fms, Hh^Fms, Gs^Fms, Ss, Ss, Wo, Ww, Ww, Ds, Ds, Gs^Fms, Gs, Gll^Cov, Gs^Fms, Gs^Fms, Ds, Ds, Ww, Wwf, Ww^Ewl, Wwf, Ww^Vm, Wwf, Wwf, Gg, Gs^Es, Gs^Fms, Gs^Fms, Gll, Gll, Gll^Es, Gs^Es, Gs^Fms, Gs^Fms, Hh^Fms
Gs^Fms, Gs^Fms, Gs^Fms, Gll, Ce, Gs, Gg, Ww, Ww, Ww, Ww, Ss, Ww, Ss, Ww, Ww, Wo, Ww, Ss, Gs, Gs^Fms, Hh^Fms, Hh^Fms, Gs^Fms, Ss, Wo, Ww^Ewl, Ww^Ewl, Ww, Ww, Ds, Gg^Ve, Ds, Gs, Ds, Ds, Ww, Ww, Ww, Ww, Wo, Ww, Wo, Ww, Ww, Ww, Ss, Gs, Gs^Fms, Gs^Fms, Gs^Fms, Gs, Gs, Gs, Gs, Gs^Fms
Gs^Fms, Gs^Fms, Gs^Fms, Ce, 2 Ke, Ce, Hh^Fms, Gg, Gg^Es, Ww, Ww, Ww, Ww, Ww, Ww, Ww^Ewl, Ww, Wo, Ss, Gs^Es, Gs^Fms, Hh^Fms, Hh^Fms, Gg^Ve, Ss, Ss, Wwf, Ww, Wwf, Wwf, Ww, Ds, Ww, Ds, Ww, Ww, Ww, Ww, Wo, Wo, Wo, Wo, Wo, Wo, Ww, Ww, Ss, Gs, Gs^Es, Gs^Fms, Gs^Fms, Gs, Ww, Ww, Ww, Gs
Gs^Fms, Re^Vct, Gs^Fms, Ce, Ce, Ce, Hh^Fms, Hh^Fms, Gs, Gg, Gg, Ww, Ww, Ww, Ww, Ww^Ewl, Ww, Wo, Ww^Ewl, Ss, Wwf, Gs^Fms, Gs^Fms, Gs^Fms, Wwf, Wwf, Ww, Wwf, Ww, Ww, Ww^Vm, Ww, Ww, Ww, Ww, Ww, Wo, Wo, Ww, Ww^Ewl, Ww^Ewl, Ww^Ewl, Wo, Wo, Ww, Ww, Ww, Ss, Ss, Ss, Ss, Ww, Ww, Wo, Wo, Ww
Gs^Fms, Gs^Fms, Hh^Fms, Hh^Fms, Hh^Fms, Hh^Fms, Hh^Fms, Gs^Fms, Gs^Fms, Gs^Fms, Gs^Fms, Ss, Ss, Ss, Ss, Ww, Wo, Ww, Ww, Ww, Wwf, Ss, Ss, Ss, Ww, Ww, Ww^Ewl, Ww, Ww^Ewl, Wo, Ww, Ww, Wo, Ww, Wo, Wo, Ww, Ww^Ewl, Wo, Ww^Ewl, Wo, Ww, Wo, Wo, Wo, Wo, Wo, Ww, Ww, Ww, Ww, Ww, Wo, Wo, Wo, Wo
Gg, Hh^Fms, Hh^Fms, Hh^Fms, Hh^Fms, Hh^Fms, Gs^Fms, Re^Vct, Gs^Fms, Gs, Gs^Fms, Gs^Fms, Ss, Ss, Ww, Ww, Wo, Wo, Ww, Wwf, Ww, Ww, Ww, Wo, Ww^Ewl, Wo, Ww, Wo, Wo, Ww^Ewl, Ww^Ewl, Wo, Wo, Ww, Wo, Ww^Ewl, Wo, Wo, Wo, Wo, Wo, Ww^Ewl, Wo, Ww^Ewl, Wo, Ww, Ww, Wo, Wo, Wo, Wo, Ww, Ww, Ww, Ww, Wo
Hh^Fms, Hh^Fms, Hh^Fms, Hh^Fms, Hh^Fms, Hh^Fms, Gs^Fms, Gs^Fms, Gs^Fms, Gs, Gs^Fms, Gs^Fms, Ss, Ww, Ww, Wo, Ww, Ww, Wwf, Wwf, Ww, Wo, Ww^Ewl, Wo, Wo, Ww, Wo, Ww, Wo, Wo, Ww, Ww^Ewl, Wo, Ww^Ewl, Ww, Ww, Ww, Ww^Ewl, Ww, Wo, Wo, Wo, Wo, Wo, Ww, Ww, Ss, Ww, Ww, Wo, Ww, Ww, Gs^Es, Gg, Gs, Ww
Hh^Fms, Hh^Fms, Hh^Fms, Hh^Fms, Hh^Fms, Hh^Fms, Hh^Fms, Gs^Fms, Gll, Gs^Fms, Gs^Efm, Gs^Fms, Ww, Ww, Ww^Ewl, Wo, Ww^Ewl, Ww, Wwf, Ww, Wo, Wo, Ww^Ewl, Ww, Wo, Wo, Ww^Ewl, Ww^Ewl, Wo, Wo, Wo, Ww, Ww^Ewl, Ww, Ww, Ww, Ww, Ww^Ewl, Ww, Ww, Ww, Ww, Ww, Ww, Ww, Ww, Ss, Ss, Ss, Ww, Gg, Gg, Gs^Fms, Gs, Gll, Gg
Hh^Fms, Hh^Fms, Gs^Fms, Hh^Fms, Hh^Fms, Hh^Fms, Hh^Fms, Gs^Fms, Gs^Fms, Gs^Fms, Ss, Gg^Es, Ww, Ww, Ww^Ewl, Wo, Ww, Ww, Wwf, Ww^Ewl, Ww, Ww, Ww, Ww^Ewl, Wo, Wo, Wo, Ww, Wo, Ww^Ewl, Wo, Ww^Ewl, Ww, Ww, Ww, Ww, Ww, Ww, Gs, Ww, Ww, Ww, Ww, Ww, Ww, Ss, Gg^Efm, Gg^Efm, Gs^Es, Ss, Gs^Fms, Gll, Gs^Fms, Gs^Fms, Gs^Fms, Gs^Fms
Hh^Fms, Hh^Fms, Gs^Fms, Gs^Fms, Gs^Fms, Hh^Fms, Hh^Fms, Hh^Fms, Ss, Ss, Ww, Ww, Wo, Ww, Ww^Ewl, Wo, Ww, Ww, Ww, Wwf, Ww, Ww, Ww, Wo, Wo, Wo, Wo, Ww, Wo, Wo, Ww, Ww, Ww, Ww, Gg, Gg, Gs, Gs, Gg^Es, Ww, Wwf, Wwf, Wwf, Ww, Gs, Gg, Gs^Efm, Gs, Gs^Fms, Gs^Fms, Gs^Fms, Gs^Fms, Hh^Fms, Hh^Fms, Hh^Fms, Hh^Fms
Gs^Fms, Gs^Fms, Gs^Fms, Gs^Fms, Gll^Es, Gll, Ww, Hh^Fms, Ww, Ww, Wo, Wo, Ww, Wo, Ww, Ww^Ewl, Ww, Ww, Ww, Wwf, Gg, Ww, Ww, Ww, Ww, Ww, Ww, Ww, Ww, Ww^Ewl, Ww, Ww, Ww, Ww, Gg, Gs^Efm, Gg^Efm, Gg^Es, Gs, Gg^Ve, Gs^Fms, Wwf, Ss, Ss, Gs, Gs, Gs^Fms, Gs^Fms, Gs^Fms, Gll, Gs^Fms, Hh^Fms, Hh^Fms, Hh^Fms, Mm, Hh^Fms
Gs^Fms, Gs^Fms, Gs, Gs, Ww, Ww, Wo, Ww, Wo, Wo, Ww, Ww, Ss, Ww, Ww, Ww, Ww, Ww, Gg, Gg, Gg^Es, Gg, Gg, Ww, Gg^Ve, Ww, Ww, Ww, Ww, Ww^Ewl, Ww, Ww, Gs, Gs, Gs, Gs, Gs^Efm, Gg, Gs, Gs^Fms, Gs^Fms, Wwf, Gg, Gs, Gs^Fms, Gll, Gs^Fms, Gll, Gs^Fms, Gs^Fms, Hh^Fms, Hh^Fms, Hh^Fms, Mm, Mm, Mm
Gs^Fms, Gs, Gg^Es, Ww, Ww, Wo, Wo, Wo, Ww, Ww, Hh^Fms, Ss, Hh^Fms, Ss, Gs, Ww, Gg, Gg, Re^Vct, Gs, Gs, Gs, Gs, Gs^Es, Gs, Gs, Gs^Es, Ww, Ww, Ww, Gs^Es, Gs, Gll, Gs^Fms, Gll, Gs^Fms, Gs^Fms, Gs, Gs^Efm, Gll, Gs, Wwf, Gs^Fms, Gll, Gg, Gs, Gs^Fms, Gg^Ve, Gs^Fms, Hh^Fms, Hh^Fms, Hh^Fms, Mm, Mm, Mm, Mm
Hh^Fms, Gll^Efm, Ww, Ww, Wo, Wo, Ww, Ww, Gg, Hh^Fms, Mm, Hh^Fms, Mm, Hh^Fms, Hh^Fms, Re^Vct, Gs, Gs, Gs^Fms, Gs^Fms, Gs^Fms, Gll, Gs^Fms, Gs^Fms, Gll, Gs^Fms, Gs^Fms, Gs, Gs, Gs, Gs^Fms, Gs^Fms, Gs^Fms, Gs^Fms, Gs^Fms, Gll, Gs^Fms, Gs, Gll, Gs^Fms, Gs^Fms, Wwf, Gs^Fms, Gs^Fms, Gg, Gs, Gll, Gs^Fms, Gs^Fms, Hh^Fms, Hh^Fms, Mm, Mm, Mm, Mm, Mm
Hh^Fms, Gg^Efm, Ww, Wo, Ww, Ww, Gs, Gs, Hh^Fms, Hh^Fms, Mm, Mm, Mm, Mm, Mm, Hh^Fms, Ce, Gs^Fms, Gs^Fms, Gs^Fms, Gs^Fms, Gll, Gs^Fms, Gs^Fms, Gs^Fms, Gll, Gs^Fms, Gs^Fms, Gs^Fms, Gs^Fms, Gs^Fms, Hh^Fms, Hh^Fms, Hh^Fms, Hh^Fms, Gs^Fms, Gs^Fms, Gs^Fms, Gll, Gll, Gs, Wwf, Wwf, Gg^Es, Gs, Gs^Fms, Gll, Gs^Fms, Gs^Fms, Hh^Fms, Hh^Fms, Mm, Mm, Mm, Mm, Mm
Hh^Fms, Hh^Fms, Ww, Wo, Ww, Gg, Gs^Es, Hh^Fms, Mm, Mm, Mm, Mm, Mm, Mm, Mm, Ce, 3 Ke, Ce, Hh^Fms, Re^Vct, Gs^Fms, Gs^Fms, Gs^Fms, Gll, Gll, Gs^Fms, Gll, Gs^Fms, Hh^Fms, Gs^Fms, Hh^Fms, Hh^Fms, Hh^Fms, Hh^Fms, Hh^Fms, Gs^Fms, Gg^Ve, Gs^Fms, Gg, Gs^Fms, Gs, Ss, Wwf, Gg^Es, Re^Vct, Gs^Fms, Gs^Fms, Gs^Fms, Gs^Fms, Hh^Fms, Mm, Mm, Mm, Mm, Mm, Mm
Hh^Fms, Hh^Fms, Ww, Wo, Ww, Gg, Gs^Fms, Hh^Fms, Hh^Fms, Mm, Mm, Mm, Mm, Mm, Mm, Ce, Ce, Ce, Hh^Fms, Hh^Fms, Hh^Fms, Gs^Fms, Gs, Gs^Fms, Gs^Fms, Gs^Fms, Gll^Es, Gs^Fms, Hh^Fms, Hh^Fms, Hh^Fms, Hh^Fms, Hh^Fms, Hh^Fms, Hh^Fms, Gs^Fms, Gs^Fms, Gg, Gs^Es, Gg, Gs^Fms, Gs^Fms, Wwf, Gg, Gg, Gs, Gs^Efm, Gs^Fms, Gs^Fms, Hh^Fms, Hh^Fms, Mm, Mm, Mm, Mm, Mm
Hh^Fms, Hh^Fms, Ww, Wo, Ww, Gg, Gs, Gs^Fms, Gs^Fms, Hh^Fms, Hh^Fms, Mm, Mm, Mm, Mm, Mm, Mm, Mm, Mm, Hh^Fms, Hh^Fms, Gs^Fms, Gs, Gs^Es, Gs, Gs^Fms, Gs, Gs^Fms, Gs^Fms, Hh^Fms, Hh^Fms, Hh^Fms, Hh^Fms, Hh^Fms, Gs^Fms, Gs^Fms, Gll, Gg, Gs, Gg, Gs^Fms, Gs^Fms, Wwf, Gg, Gg, Gs, Gs^Efm, Gs^Fms, Gll, Gs^Fms, Hh^Fms, Mm, Mm, Mm, Mm, Mm
Hh^Fms, Hh^Fms, Ww, Wo, Ww, Gg^Es, Gs, Gs^Fms, Gs^Fms, Gs^Fms, Hh^Fms, Mm, Mm, Mm, Mm, Mm, Mm, Mm, Mm, Mm, Hh^Fms, Gs^Fms, Gll, Gs^Fms, Gll, Gs^Fms, Gs^Fms, Gll, Gs^Fms, Hh^Fms, Gs^Fms, Hh^Fms, Gs^Fms, Gs^Fms, Gs^Fms, Gs^Fms, Gs^Fms, Gs, Gs^Fms, Gs^Fms, Gs^Fms, Ss, Wwf, Gs, Gs^Efm, Gg, Ce, Gs, Gs^Efm, Gs^Fms, Gs^Fms, Hh^Fms, Hh^Fms, Mm, Mm, Mm
Hh^Fms, Hh^Fms, Ww, Wo, Wo, Ww, Gg, Gs^Fms, Gs^Fms, Gs^Fms, Hh^Fms, Hh^Fms, Hh^Fms, Mm, Mm, Mm, Mm, Mm, Mm, Mm, Hh^Fms, Gs^Fms, Gll, Gs^Fms, Gs^Fms, Gll, Gs^Es, Gs^Fms, Gs^Fms, Gs^Fms, Gs^Fms, Gs^Fms, Gll, Gll, Gs^Fms, Gs^Fms, Gll, Gs, Gll, Gs^Fms, Gll, Wwf, Re^Vct, Gs^Fms, Gg^Es, Ce, 1 Ke, Ce, Gg, Gs^Efm, Gs^Fms, Hh^Fms, Hh^Fms, Hh^Fms, Hh^Fms, Mm
Hh^Fms, Hh^Fms, Gs^Fms, Ww, Wo, Ww, Ww, Gg, Gs^Es, Gll, Gs^Fms, Hh^Fms, Hh^Fms, Hh^Fms, Hh^Fms, Hh^Fms, Hh^Fms, Hh^Fms, Hh^Fms, Hh^Fms, Gs^Fms, Gs^Fms, Gs^Fms, Gs^Fms, Gs^Fms, Gs, Gg, Gs^Fms, Gs^Fms, Gg^Ve, Gs^Fms, Gs^Fms, Gll, Gs^Fms, Gll, Gs^Fms, Gll, Gg^Es, Gll, Gs^Fms, Gs^Fms, Wwf, Gs^Fms, Gll, Gs^Fms, Ce, Ce, Ce, Gg, Gs^Es, Gs, Gs^Fms, Hh^Fms, Hh^Fms, Hh^Fms, Hh^Fms
Hh^Fms, Hh^Fms, Gs^Fms, Ww, Ww, Wo, Wo, Ww, Ww, Gs^Es, Gs^Fms, Gs^Fms, Gs^Fms, Hh^Fms, Gs^Fms, Gs^Fms, Gs^Fms, Gs^Fms, Gs^Fms, Gs^Fms, Gs^Fms, Gs^Fms, Gs^Fms, Gs^Fms, Gs^Fms, Gs, Gs^Es, Gll, Gs^Fms, Gs^Fms, Gll, Gs^Fms, Gs, Gll, Gs^Fms, Gs^Fms, Gs^Fms, Gs^Fms, Gs^Fms, Gs^Fms, Hh^Fms, Wwf, Wwf, Gs^Fms, Hh^Fms, Gs^Fms, Gs^Fms, Gs, Gs^Efm, Gg, Re^Vct, Gs^Fms, Gs^Fms, Gs^Fms, Gs^Fms, Hh^Fms
Hh^Fms, Gs^Fms, Gs^Fms, Gs^Fms, Gs^Fms, Ww, Ww, Wo, Ww, Gg, Gg, Gs^Fms, Gs^Es, Gs^Fms, Gs^Fms, Gs^Fms, Gs^Fms, Gs^Fms, Gs^Fms, Gs^Fms, Gs, Gs, Gll, Gs^Fms, Gs^Fms, Gg, Gs^Fms, Gs^Fms, Gs, Gs^Fms, Gs^Fms, Gs, Gs, Gs^Fms, Gs^Fms, Gs^Fms, Hh^Fms, Gs^Fms, Hh^Fms, Hh^Fms, Mm, Hh^Fms, Wwf, Hh^Fms, Hh^Fms, Hh^Fms, Hh^Fms, Gs^Fms, Gs^Efm, Gs, Gs, Gs, Gs, Gg, Gg, Gs^Fms
Gs^Fms, Gs^Fms, Gs^Fms, Gs^Fms, Gs^Fms, Ww, Ww, Wo, Wo, Ww, Ww, Gs, Gs, Gs^Fms, Gs^Fms, Gs^Fms, Gs^Fms, Gll, Gll, Gs^Es, Gg, Gs^Es, Gs^Fms, Gll, Gs^Fms, Gll, Gs^Fms, Gs^Fms, Gs, Gs, Gs^Fms, Gs^Fms, Gll, Gs^Fms, Hh^Fms, Hh^Fms, Mm, Hh^Fms, Mm, Mm, Mm, Mm, Wwf, Mm, Mm, Hh^Fms, Hh^Fms, Hh^Fms, Hh^Fms, Gs^Fms, Gs, Gg, Gg^Es, Gg^Es, Gg, Gg
Gs^Fms, Gs^Fms, Hh^Fms, Gs^Fms, Hh^Fms, Gs^Fms, Gs^Fms, Ww, Ww, Wo, Ww, Gg, Gg, Gs, Gs^Es, Gll, Gs^Fms, Gll, Gs^Fms, Gs^Fms, Gs^Fms, Gll, Gs^Fms, Gll^Es, Gs, Gs^Fms, Gs^Fms, Gs^Fms, Gs, Gs^Es, Gs^Fms, Gs^Fms, Gs^Fms, Gs^Fms, Gs^Fms, Mm, Mm, Mm, Mm, Mm, Mm, Wwf, Mm, Mm, Mm, Mm, Mm, Hh^Fms, Hh^Fms, Gs^Fms, Gs^Fms, Gs, Gg, Gg, Gg, Gg
Hh^Fms, Hh^Fms, Hh^Fms, Hh^Fms, Hh^Fms, Hh^Fms, Hh^Fms, Gs^Fms, Ww, Wo, Wo, Ww, Gg, Gg, Gg, Gg, Gs^Fms, Gs^Fms, Gg, Gg, Gs^Fms, Gs^Fms, Gs^Fms, Gs, Gs^Fms, Gs^Fms, Gs^Fms, Gs^Fms, Gg, Gs^Fms, Gg, Gs, Gg, Gs^Fms, Hh^Fms, Hh^Fms, Mm, Mm, Mm, Mm, Gg, Mm, Mm, Mm, Mm, Mm, Mm, Mm, Hh^Fms, Hh^Fms, Gg, Gg, Gs, Gg, Gg, Gg
