border_size=1
usage=map

Mm, Mm, Mm, Mm, Mm^Xm, Mm, Mm^Xm, Mm, Mm^Xm, Mm, Mm^Xm, Mm, Mm^Xm, Mm^Xm, Mm^Xm, Mm^Xm, Mm^Xm, Mm, Mm^Xm, Mm, Mm, Mm, Mm^Xm, Mm^Xm, Mm^Xm, Mm, Mm^Xm, Mm, Mm, Mm, Mm, Mm^Xm, Mm^Xm, Mm^Xm, Mm, Mm, Mm^Xm, Mm, Mm, Mm^Xm, Mm^Xm, Mm, Mm^Xm, Mm, Mm^Xm, Mm^Xm, Mm^Xm, Mm, Mm^Xm, Mm^Xm, Mm^Xm, Mm, Mm^Xm, Mm, Mm^Xm, Mm, Mm^Xm, Mm, Mm^Xm, Mm, Mm^Xm, Mm, Mm, Mm, Mm^Xm, Mm, Mm, Mm
Mm^Xm, Mm^Xm, Mm, Mm, Mm^Xm, Mm^Xm, Mm, Mm^Xm, Mm, Mm^Xm, Mm^Xm, Mm^Xm, Mm^Xm, Mm^Xm, Mm^Xm, Mm^Xm, Mm, Mm^Xm, Mm, Mm^Xm, Mm, Mm^Xm, Mm^Xm, Mm, Mm, Mm^Xm, Mm, Mm^Xm, Mm^Xm, Mm, Mm, Mm^Xm, Mm^Xm, Mm, Mm, Mm^Xm, Mm^Xm, Mm, Mm^Xm, Mm^Xm, Mm, Mm^Xm, Mm, Mm^Xm, Mm^Xm, Mm, Mm, Mm^Xm, Mm, Mm, Mm, Mm^Xm, Mm, Mm^Xm, Mm^Xm, Mm^Xm, Mm^Xm, Mm^Xm, Mm^Xm, Mm^Xm, Mm^Xm, Mm^Xm, Mm, Mm^Xm, Mm, Mm^Xm, Mm^Xm, Mm
Mm^Xm, Mm, Mm^Xm, Mm^Xm, Mm, Mm, Mm, Mm, Mm, Mm, Mm, Mm, Mm, Mm, Mm, Mm, Mm, Mm, Mm^Xm, Mm^Xm, Mm, Mm^Xm, Mm^Xm, Mm, Mm, Mm, Mm, Mm, Mm^Xm, Mm^Xm, Mm, Mm^Xm, Mm, Mm^Xm, Mm, Mm, Mm, Mm, Mm^Xm, Mm, Mm, Mm, Mm, Mm, Mm, Mm, Mm, Mm, Mm, Mm, Mm, Mm, Wwt, Wwt, Mm, Mm, Mm, Mm^Xm, Mm^Xm, Mm, Mm^Xm, Mm, Mm, Mm, Mm, Mm, Mm^Xm, Mm
Mm^Xm, Mm^Xm, Mm^Xm, Mm, Mm, Mm, Mm, Mm, Mm, Mm, Mm, Mm, Mm, Mm, Hh^Fms, Mm, Mm, Mm, Mm, Mm^Xm, Mm^Xm, Mm, Mm, Mm, Mm, Mm, Mm, Mm, Mm, Mm^Xm, Mm^Xm, Mm, Mm, Mm, Mm, Mm, Mm^Xm, Mm^Xm, Mm, Mm, Mm^Xm, Mm, Mm^Xm, Mm^Xm, Mm, Mm, Mm, Mm, Mm, Mm, Mm, Mm, Wwt, Mm, Mm, Mm, Mm, Mm^Xm, Mm, Mm, Mm^Xm, Mm^Xm, Mm^Xm, Mm, Mm, Mm, Mm, Mm
Mm^Xm, Mm, Mm^Xm, Mm, Mm, Wwt, Wwt, Mm, Hh^Fms, Mm, Hh^Fms, Hh^Fms, Hh^Fms, Hh^Fms, Hh^Fms, Mm, Mm, Mm, Mm^Xm, Mm, Mm, Mm, Mm, Mm, Mm, Mm^Xm, Mm^Xm, Mm, Mm, Mm, Mm, Mm, Mm, Mm, Mm, Mm, Mm, Mm, Mm, Mm^Xm, Mm, Mm, Mm, Mm, Mm, Mm, Hh^Fms, Hh^Fms, Wwt, Wwt, Wwt, Wwt, Mm, Mm, Mm, Mm, Mm, Mm, Mm, Mm^Xm, Mm^Xm, Mm, Mm, Mm^Xm, Mm, Mm^Xm, Mm^Xm, Mm^Xm
Mm, Mm, Mm^Xm, Mm, Mm, Hh^Fms, Wwt, Hh^Fms, Gs^Fms, Hh^Fms, Gs^Fms, Gs^Fms, Gs^Fms, Gs^Fms, Gs^Fms, Hh^Fms, Hh^Fms, Mm, Mm, Mm, Hh^Fms, Mm, Hh^Fms, Mm, Mm, Mm, Mm, Mm^Xm, Mm, Mm, Mm, Mm, Hh^Fms, Mm, Mm, Mm, Mm, Mm, Mm, Mm, Mm, Mm, Mm, Mm, Mm, Mm, Hh^Fms, Wwt, Wwt, Mm, Mm, Mm, Mm, Mm, Mm, Mm, Mm^Xm, Mm, Mm^Xm, Mm, Mm, Mm, Mm^Xm, Mm, Mm, Mm^Xm, Mm^Xm, Mm
Mm^Xm, Mm^Xm, Mm, Mm, Hh^Fms, Hh^Fms, Wwt, Gs^Fms, Gll, Gs^Fms, Gs^Fms, Gs^Fms, Gg^Fet, Gs^Fms, Gg^Fet, Gs^Fms, Gs^Fms, Hh^Fms, Hh^Fms, Hh^Fms, Gs^Fms, Hh^Fms, Gs^Fms, Hh^Fms, Hh^Fms, Mm, Mm, Mm, Mm, Mm, Hh^Fms, Hh^Fms, Hh^Fms, Hh^Fms, Hh^Fms, Mm, Mm, Mm, Mm, Mm, Mm, Mm, Mm, Mm, Mm, Hh^Fms, Hh^Fms, Wwt, Wwt, Hh^Fms, Hh^Fms, Mm, Mm, Mm, Mm, Mm^Xm, Mm, Mm, Mm, Mm, Mm, Mm, Mm^Xm, Mm, Mm, Mm, Mm^Xm, Mm
Mm^Xm, Mm, Mm, Hh^Fms, Hh^Fms, Gs^Fms, Gs^Fms, Wwt, Wwt, Gll, Gll, Gll, Gll, Gg^Fet, Gs^Fms, Gg^Fet, Gg^Fet, Gs^Fms, Gs^Fms, Gg^Fet, Gs^Fms, Gll, Gs^Fms, Gs^Fms, Gs^Fms, Hh^Fms, Hh^Fms, Hh^Fms, Hh^Fms, Hh^Fms, Gs^Fms, Gs^Fms, Gs^Fms, Gs^Fms, Gs^Fms, Hh^Fms, Hh^Fms, Hh^Fms, Hh^Fms, Hh^Fms, Hh^Fms, Hh^Fms, Hh^Fms, Hh^Fms, Hh^Fms, Hh^Fms, Wwt, Wwt, Hh^Fms, Hh^Fms, Mm, Mm, Mm, Mm, Mm, Mm, Mm, Mm, Mm^Xm, Mm^Xm, Mm, Mm^Xm, Mm, Mm^Xm, Mm^Xm, Mm^Xm, Mm^Xm, Mm^Xm
Mm^Xm, Mm, Mm, Mm, Hh^Fms, Gs^Fms, Gs^Fms, Gll, Gll, Wwt, Wwt, Gll, Gll, Gg^Fet, Gs^Fms, Gs^Fms, Hh^Fms, Gg^Fet, Gs^Fms, Gll, Gg^Fet, Gs^Fms, Gs^Fms, Gs^Fms, Gs^Fms, Gs^Fms, Gs^Fms, Gs^Fms, Gs^Fms, Gs^Fms, Gg^Fet, Gg^Fet, Gs^Fms, Gg, Gg^Fet, Gs^Fms, Gs^Fms, Hh^Fms, Gs^Fms, Gs^Fms, Gs^Fms, Gs^Fms, Wwt, Hh^Fms, Wwt, Wwt, Wwt, Wwt, Hh^Fms, Hh^Fms, Mm, Mm, Mm, Mm, Mm, Mm^Xm, Mm^Xm, Mm^Xm, Mm^Xm, Mm, Mm, Mm, Mm, Mm, Mm, Mm, Mm, Mm^Xm
Mm^Xm, Mm, Mm, Hh^Fms, Hh^Fms, Gs^Fms, Gs^Fms, Gg^Fet, Gs^Fms, Gll, Gs^Fms, Wwt, Gll, Gg^Fet, Gs^Fms, Hh^Fms, Hh^Fms, Hh^Fms, Hh^Fms, Gs^Fms, Gll, Gg^Fet, Gs^Fms, Gll, Gg^Fet, Gs^Fms, Gg^Fet, Gs^Fms, Gg^Fet, Gs^Fms, Gs^Fms, Gll, Gll, Gg^Fet, Gll, Gs^Fms, Gg^Fet, Gg^Fet, Gs^Fms, Gs^Fms, Gs^Fms, Wwt, Wwt, Wwt, Wwt, Wwt, Hh^Fms, Hh^Fms, Mm, Mm^Xm, Mm, Mm, Mm^Xm, Mm^Xm, Mm, Mm, Mm^Xm, Mm, Mm, Mm, Mm^Xm, Mm, Mm, Mm, Mm, Mm^Xm, Mm, Mm
Mm^Xm, Mm^Xm, Mm, Mm, Hh^Fms, Hh^Fms, Hh^Fms, Gs^Fms, Gll, Gs^Fms, Gs^Fms, Wwt, Wwt, Gs^Fms, Gs^Fms, Hh^Fms, Hh^Fms, Hh^Fms, Hh^Fms, Gs^Fms, Gs^Fms, Gg^Fet, Gs^Fms, Gll, Gs^Fms, Gs^Fms, Gs^Fms, Gs^Fms, Gll, Gll, Ds, Gll, Ds, Ds, Ds, Gll, Gll, Gs^Fms, Gs^Fms, Gs^Fms, Wwt, Wwt, Wwt, Wwt, Hh^Fms, Hh^Fms, Mm, Mm^Xm, Mm^Xm, Mm, Mm, Mm^Xm, Mm^Xm, Mm, Mm, Mm, Mm, Mm^Xm, Mm^Xm, Mm, Mm, Mm, Mm, Mm, Mm, Mm^Xm, Mm^Xm, Mm
Mm^Xm, Mm, Mm, Mm, Mm, Hh^Fms, Hh^Fms, Gs^Fms, Gll, Gg^Fet, Gs^Fms, Gll, Wwf, Gll, Gs^Fms, Gg^Fet, Gg^Fet, Hh^Fms, Gs^Fms, Gg^Fet, Gs^Fms, Gs^Fms, Gll, Gs^Fms, Gg^Fet, Gg^Fet, Gs^Fms, Gll, Ds, Ds, Ww^Ewf, Ds, Wwt, Wwt, Ww^Ewf, Ds, Ds, Ds, Wwt, Wwt, Wwt, Wwt, Gg^Fet, Gs^Fms, Hh^Fms, Mm, Mm, Mm, Mm, Mm^Xm, Mm, Mm^Xm, Mm, Mm^Xm, Mm, Mm, Mm, Mm, Mm, Mm, Mm, Mm, Mm, Mm, Mm, Mm, Mm^Xm, Mm
Mm^Xm, Mm^Xm, Mm^Xm, Mm, Mm, Hh^Fms, Hh^Fms, Gs^Fms, Gs^Fms, Gll, Gs^Fms, Gll, Wwf, Gll, Gll, Gs^Fms, Gll, Gs^Fms, Gll, Gll, Gg^Fet, Gg^Fet, Gs^Fms, Gg^Fet, Gs^Fms, Gs^Fms, Gs^Fms, Gs^Fms, Ds, Ww^Ewf, Wwt, Ww^Ewf, Ww^Ewf, Ww^Ewf, Wwt, Ww^Ewf, Ww^Ewf, Wwt, Ww^Ewf, Wwt, Wwt, Wwt, Gs^Fms, Gs^Fms, Gs^Fms, Hh^Fms, Mm, Mm, Mm, Mm, Mm, Mm, Mm, Mm, Mm, Mm, Mm, Mm, Mm, Mm, Mm, Mm, Mm, Mm, Mm, Mm, Mm, Mm
Mm^Xm, Mm, Mm^Xm, Mm, Mm, Mm, Hh^Fms, Gs^Fms, Gs^Fms, Gll, Gg^Fet, Gll, Gll, Ww^Ewf, Ww^Ewf, Gll, Wwf, Gll, Wwt, Gll, Gll, Gs^Fms, Gg^Ve, Gs^Fms, Ds, Ds, Ds, Ds, Ww^Ewf, Ww^Ewf, Ww^Ewf, Ww^Ewf, Wot, Ww^Ewf, Ww^Ewf, Wwt, Ww^Ewf, Ww^Ewf, Ww^Ewf, Wwt, Gs^Fms, Gs^Fms, Gg^Fet, Gs^Fms, Gs^Fms, Hh^Fms, Hh^Fms, Mm, Mm, Mm, Mm, Mm, Mm, Mm, Mm, Mm, Mm, Mm, Hh^Fms, Mm, Mm, Mm, Mm, Mm, Mm^Xm, Mm, Mm, Mm
Mm, Mm, Mm^Xm, Mm, Mm, Mm, Hh^Fms, Gs^Fms, Gg^Fet, Gs^Fms, Gs^Fms, Gs^Fms, Gs^Fms, Gll, Gs^Fms, Wwf, Gs^Fms, Wwf, Gll, Ww^Ewf, Wwt, Gs^Fms, Gs^Fms, Ds, Wwt, Ww^Ewf, Ww^Ewf, Wwt, Ww^Ewf, Ww^Ewf, Wwt, Ww^Ewf, Ww^Ewf, Wot, Ww^Ewf, Ww^Ewf, Wwt, Wwt, Wwt, Ds, Gll, Gs^Fms, Gg^Fet, Gs^Fms, Gs^Fms, Gs^Fms, Hh^Fms, Mm, Hh^Fms, Mm, Hh^Fms, Hh^Fms, Hh^Fms, Hh^Fms, Hh^Fms, Hh^Fms, Hh^Fms, Hh^Fms, Hh^Fms, Hh^Fms, Hh^Fms, Mm, Mm, Mm, Mm, Mm, Mm, Mm
Mm^Xm, Mm^Xm, Mm, Mm, Mm, Hh^Fms, Hh^Fms, Gs^Fms, Gs^Fms, Gll, Gll, Gg^Fet, Gll, Gs^Fms, Gll, Gs^Fms, Gg^Fet, Gs^Fms, Gs^Fms, Gs^Fms, Wwt, Gs^Fms, Ds, Ds, Ww^Ewf, Wwt, Ww^Ewf, Ww^Ewf, Wwt, Wwt, Ds, Wwt, Ds, Ww^Ewf, Wwt, Wwt, Wwt, Ww^Ewf, Wwt, Ds, Ds, Gs^Fms, Gg^Fet, Gs^Fms, Gs^Fms, Gs^Fms, Gs^Fms, Hh^Fms, Gs^Fms, Hh^Fms, Gs^Fms, Gs^Fms, Gg^Fet, Gs^Fms, Gs^Fms, Hh^Fms, Gs^Fms, Hh^Fms, Hh^Fms, Hh^Fms, Hh^Fms, Mm, Mm, Mm, Mm^Xm, Mm, Mm^Xm, Mm^Xm
Mm^Xm, Mm, Mm, Mm, Hh^Fms, Hh^Fms, Gs^Fms, Gs^Fms, Gll, Gs^Fms, Gs^Fms, Gs^Fms, Gs^Fms, Gs^Fms, Hh^Fms, Gll, Hh^Fms, Gs^Fms, Gg^Fet, Gs^Fms, Gs^Fms, Wwt, Wwt, Wwt, Wot, Ww^Ewf, Ww^Ewf, Wwt, Ds, Ds, Gs^Fms, Ds, Gs^Fms, Ds, Ds, Ds, Ds, Ww^Ewf, Ww^Ewf, Wwt, Ds, Gll, Gs^Fms, Gs^Fms, Gs^Fms, Gll, Gll, Gs^Fms, Gs^Fms, Gs^Fms, Gg^Fet, Gs^Fms, Gs^Fms, Gs^Fms, Gg^Fet, Gs^Fms, Gs^Fms, Gg^Fet, Gs^Fms, Hh^Fms, Hh^Fms, Hh^Fms, Mm, Mm, Mm, Mm, Mm, Mm^Xm
Mm^Xm, Mm, Mm, Mm, Hh^Fms, Hh^Fms, Hh^Fms, Gg^Fet, Gs^Fms, Gs^Fms, Gg^Fet, Gs^Fms, Gs^Fms, Gll, Hh^Fms, Hh^Fms, Hh^Fms, Gll, Gs^Fms, Gs^Fms, Gs^Fms, Wwt, Wwt, Ww^Ewf, Wot, Ww^Ewf, Ww^Ewf, Wwt, Ds, Gs^Fms, Gs^Fms, Gs^Fms, Gg^Fet, Gs^Fms, Gs^Fms, Gs^Fms, Ds, Wwt, Ww^Ewf, Ww^Ewf, Wwt, Ds, Ds, Gs^Fms, Gs^Fms, Gg^Fet, Gs^Fms, Gs^Fms, Gs^Fms, Gs^Fms, Gs^Fms, Gll, Hh^Fms, Hh^Fms, Gs^Fms, Gs^Fms, Gs^Fms, Gs^Fms, Gs^Fms, Gs^Fms, Hh^Fms, Hh^Fms, Mm, Mm, Mm, Mm^Xm, Mm^Xm, Mm
Mm, Mm^Xm, Mm, Mm, Mm, Hh^Fms, Hh^Fms, Gs^Fms, Gs^Fms, Gll, Gll, Gg^Fet, Gs^Fms, Gs^Fms, Gs^Fms, Hh^Fms, Hh^Fms, Hh^Fms, Gs^Fms, Gg, Gs^Fms, Ds, Ds, Wwt, Ww^Ewf, Ww^Ewf, Wwt, Ds, Gs^Fms, Gs^Fms, Gg^Fet, Gg^Fet, Gll^Cov, Gg^Fet, Gg^Fet, Gs^Fms, Ds, Wwt, Wwt, Ww^Ewf, Ww^Ewf, Wwt, Ds, Gll, Gll, Gs^Fms, Gs^Fms, Gg^Fet, Gs^Fms, Gs^Fms, Hh^Fms, Hh^Fms, Hh^Fms, Hh^Fms, Hh^Fms, Gs^Fms, Gs^Fms, Gg^Fet, Hh^Fms, Hh^Fms, Mm, Mm, Mm, Mm, Mm, Mm, Mm, Mm
Mm, Mm^Xm, Mm, Mm, Mm, Mm, Hh^Fms, Hh^Fms, Gg^Fet, Gs^Fms, Gll, Gs^Fms, Gs^Fms, Gs^Fms, Gs^Fms, Hh^Fms, Hh^Fms, Hh^Fms, Gs^Fms, Gg^Fet, Gs^Fms, Gs^Fms, Ds, Wwt, Ww^Ewf, Wot, Wwt, Ds, Gs^Fms, Gs^Fms, Gg^Fet, Gll^Cov, 3 Gll^Kov, Gll^Cov, Gg^Fet, Gs^Fms, Gs^Fms, Ds, Wwt, Ww^Ewf, Wot, Ww^Ewf, Ww^Ewf, Ds, Ds, Gll, Gs^Fms, Gs^Fms, Gll, Gll, Gs^Fms, Hh^Fms, Hh^Fms, Hh^Fms, Hh^Fms, Gs^Fms, Gg^Fet, Gs^Fms, Hh^Fms, Mm, Mm, Mm, Mm, Mm, Mm^Xm, Mm, Mm, Mm
Mm, Mm^Xm, Mm^Xm, Mm, Mm, Mm, Mm, Hh^Fms, Hh^Fms, Gs^Fms, Gs^Fms, Gll, Gg^Fet, Gs^Fms, Gs^Fms, Gll, Gs^Fms, Gll, Gs^Fms, Gs^Fms, Gs^Fms, Gs^Fms, Ds, Wwt, Ww^Ewf, Ww^Ewf, Wwt, Ds, Ds, Gs^Fms, Gg^Fet, Gll^Cov, 1 Gll^Cov, Gll^Cov, Gg^Fet, Gs^Fms, Gs^Fms, Ds, Wwt, Ww^Ewf, Ww^Ewf, Ww^Ewf, Ww^Ewf, Wwt, Ds, Gs^Fms, Gs^Fms, Gs^Fms, Gll, Gs^Fms, Gs^Fms, Hh^Fms, Hh^Fms, Hh^Fms, Gs^Fms, Gs^Fms, Gg, Gs^Fms, Hh^Fms, Hh^Fms, Mm, Mm, Mm^Xm, Mm^Xm, Mm, Mm, Mm^Xm, Mm^Xm
Mm, Mm, Mm^Xm, Mm^Xm, Mm^Xm, Mm, Mm, Mm, Mm, Hh^Fms, Hh^Fms, Gs^Fms, Gll, Gs^Fms, Gg^Fet, Gll, Gs^Fms, Gs^Fms, Gg^Fet, Gs^Fms, Gs^Fms, Ds, Wwt, Wwt, Ww^Ewf, Ww^Ewf, Ww^Ewf, Wwt, Ds, Gs^Fms, Gs^Fms, Gg^Fet, Gll, Gg^Fet, Gs^Fms, Gs^Fms, Gs^Fms, Ds, Ww^Ewf, Ww^Ewf, Ww^Ewf, Wot, Ww^Ewf, Ww^Ewf, Ds, Gs^Fms, Gs^Fms, Gs^Fms, Gll, Gg^Fet, Gs^Fms, Gs^Fms, Gs^Fms, Gg, Gs^Fms, Gg^Fet, Gs^Fms, Gs^Fms, Gs^Fms, Hh^Fms, Mm, Mm, Mm^Xm, Mm, Mm, Mm, Mm, Mm
Mm^Xm, Mm^Xm, Mm, Mm^Xm, Mm, Mm^Xm, Mm, Mm, Mm, Mm, Hh^Fms, Gs^Fms, Gll, Gs^Fms, Gs^Fms, Gs^Fms, Gg^Fet, Gs^Fms, Gs^Fms, Gs^Fms, Gll, Ds, Wwt, Ww^Ewf, Wot, Ww^Ewf, Ww^Ewf, Ww^Ewf, Wwt, Ds, Ds, Gs^Fms, Gs^Fms, Gll, Gll, Gs^Fms, Gs^Fms, Ds, Ww^Ewf, Wot, Ww^Ewf, Ww^Ewf, Ww^Ewf, Ww^Ewf, Wwt, Ds, Gll, Gll, Gg^Fet, Gs^Fms, Gs^Fms, Gs^Fms, Gg^Fet, Gs^Fms, Gs^Fms, Gg^Fet, Gs^Fms, Gs^Fms, Hh^Fms, Hh^Fms, Mm, Mm, Mm^Xm, Mm, Mm, Mm, Mm, Mm
Mm^Xm, Mm^Xm, Mm, Mm, Mm, Mm, Mm, Mm, Mm, Mm, Hh^Fms, Gg^Fet, Gll, Gll, Gs^Fms, Hh^Fms, Hh^Fms, Hh^Fms, Hh^Fms, Gg^Fet, Gll, Ds, Wwt, Ww^Ewf, Ww^Ewf, Wot, Ww^Ewf, Ww^Ewf, Wot, Wwt, Ds, Gs^Fms, Ds, Gs^Fms, Gll, Gs^Fms, Ds, Ds, Wwt, Ww^Ewf, Ww^Ewf, Ww^Ewf, Ww^Ewf, Wwt, Ww^Ewf, Ds, Gs^Fms, Gll, Gg^Fet, Gs^Fms, Gll, Gs^Fms, Gs^Fms, Gg^Fet, Gg^Fet, Gs^Fms, Gg^Fet, Gs^Fms, Hh^Fms, Mm, Mm, Mm, Mm, Mm^Xm, Mm^Xm, Mm^Xm, Mm, Mm
Mm, Mm^Xm, Mm, Mm, Hh^Fms, Mm, Hh^Fms, Mm, Hh^Fms, Hh^Fms, Gs^Fms, Gg^Ve, Gll, Gll, Gs^Fms, Hh^Fms, Hh^Fms, Hh^Fms, Hh^Fms, Gs^Fms, Gll, Ds, Wwt, Ww^Ewf, Ww^Ewf, Ww^Ewf, Ww^Ewf, Ww^Ewf, Ww^Ewf, Ww^Ewf, Wwt, Ds, Wwt, Ds, Ds, Ds, Wwt, Wwt, Ww^Ewf, Ww^Ewf, Ww^Ewf, Ww^Ewf, Ww^Ewf, Ww^Ewf, Ds, Ds, Gs^Fms, Gll, Gg^Fet, Gs^Fms, Gs^Fms, Gs^Fms, Gll, Gs^Fms, Gs^Fms, Gs^Fms, Gg^Fet, Gs^Fms, Hh^Fms, Hh^Fms, Mm, Mm, Mm, Mm^Xm, Mm^Xm, Mm^Xm, Mm, Mm
Mm^Xm, Mm^Xm, Wwt, Mm, Gs^Fms, Hh^Fms, Hh^Fms, Hh^Fms, Gs^Fms, Gs^Fms, Wwf, Gll, Wwt, Gll, Gll, Gs^Fms, Gs^Fms, Hh^Fms, Hh^Fms, Gs^Fms, Gs^Fms, Ds, Ds, Wwt, Wwt, Ww^Ewf, Wwt, Wwt, Wwt, Ww^Ewf, Ww^Ewf, Ww^Ewf, Wot, Wwt^Bsb|, Wwt, Wwt^Bsb|, Wwt, Ww^Ewf, Ww^Ewf, Ww^Ewf, Wwt, Wwt, Ww^Ewf, Wwt, Ds, Gll, Gll, Gll, Gll, Gs^Fms, Gs^Fms, Gs^Fms, Hh^Fms, Gll, Gs^Fms, Gs^Fms, Gg^Fet, Gs^Fms, Gs^Fms, Hh^Fms, Hh^Fms, Mm, Mm, Mm, Mm^Xm, Mm, Mm^Xm, Mm
Mm^Xm, Mm, Mm, Wwt, Wwt, Gs^Fms, Wwt, Gs^Fms, Wwt, Wwt, Wwf, Wwt, Ww^Ewf, Ww^Ewf, Ww^Ewf, Gll, Gs^Fms, Gs^Fms, Hh^Fms, Hh^Fms, Hh^Fms, Gs^Fms, Gs^Fms, Ds, Ds, Ds, Ds, Ds, Ds, Wwt, Ww^Ewf, Ww^Ewf, Wot, Wot^Bsb|, Ww^Ewf, Wwt^Bsb|, Wwt, Ww^Ewf, Wwt, Ww^Ewf, Wwt, Wwt, Ds, Ds, Gll, Gs^Fms, Gll, Gg^Fet, Gs^Fms, Gs^Fms, Hh^Fms, Hh^Fms, Hh^Fms, Gs^Fms, Gs^Fms, Gs^Fms, Gg^Fet, Gs^Fms, Gg^Fet, Gs^Fms, Gs^Fms, Hh^Fms, Mm, Mm, Mm^Xm, Mm, Mm, Mm^Xm
Mm^Xm, Mm, Mm, Wwt, Ww^Ewf, Ww^Ewf, Ww^Ewf, Ww^Ewf, Ww^Ewf, Ww^Ewf, Gll, Wwt, Gll, Wwt, Ww^Ewf, Gll, Gs^Fms, Gs^Fms, Gs^Fms, Hh^Fms, Hh^Fms, Hh^Fms, Hh^Fms, Gs^Fms, Gg^Fet, Gll, Gll, Gll, Gg^Ve, Ds, Wwt, Ww^Ewf, Ww^Ewf, Wot^Bsb|, Ww^Ewf, Wot^Bsb|, Wwt, Wwt, Ds, Ww^Ewf, Wwt, Wwt, Ds, Gll, Gs^Fms, Gg^Fet, Gll, Gg^Fet, Gs^Fms, Hh^Fms, Hh^Fms, Hh^Fms, Hh^Fms, Hh^Fms, Gs^Fms, Gg^Fet, Gs^Fms, Gs^Fms, Gs^Fms, Gs^Fms, Gs^Fms, Hh^Fms, Hh^Fms, Mm, Mm, Mm^Xm, Mm, Mm
Mm^Xm, Mm, Mm, Hh^Fms, Hh^Fms, Wwt, Hh^Fms, Wwt, Gll, Gs^Fms, Gll, Gs^Fms, Gs^Fms, Ww^Ewf, Ww^Ewf, Gll, Gs^Fms, Gg^Fet, Gg^Fet, Hh^Fms, Hh^Fms, Hh^Fms, Hh^Fms, Gs^Fms, Gs^Fms, Gs^Fms, Gg^Fet, Gll, Gll, Ds, Ds, Wwt, Wwt, Wwt^Bsb|, Wwt, Wwt^Bsb|, Wwt, Ds, Gll, Ds, Wwt, Ww^Ewf, Wwt, Gs^Fms, Gg^Fet, Gg^Ve, Gll, Gg^Fet, Gs^Fms, Hh^Fms, Hh^Fms, Hh^Fms, Hh^Fms, Hh^Fms, Gs^Fms, Gs^Fms, Gs^Fms, Gg^Fet, Gs^Fms, Gs^Fms, Gs^Fms, Hh^Fms, Hh^Fms, Mm, Mm, Mm^Xm, Mm, Mm
Mm, Mm^Xm, Mm, Mm, Hh^Fms, Hh^Fms, Hh^Fms, Hh^Fms, Hh^Fms, Gs^Fms, Gll, Gg^Fet, Gll, Wwt, Ww^Ewf, Wwt, Ww^Ewf, Gs^Fms, Gs^Fms, Gs^Fms, Gs^Fms, Hh^Fms, Hh^Fms, Hh^Fms, Hh^Fms, Hh^Fms, Hh^Fms, Gs^Fms, Gll, Gll, Gll, Ds, Ds, Wwt^Bsb|, Ds, Ds^Bsb|, Ds, Ds, Gll, Gll, Wwt, Ww^Ewf, Wwt, Gs^Fms, Gs^Fms, Gs^Fms, Gs^Fms, Gll, Cv, Gs^Fms, Cv, Hh^Fms, Hh^Fms, Hh^Fms, Gs^Fms, Gs^Fms, Gs^Fms, Gs^Fms, Gs^Fms, Gs^Fms, Gs^Fms, Hh^Fms, Mm, Mm, Mm, Mm, Mm, Mm
Mm, Mm^Xm, Mm^Xm, Mm, Mm, Mm, Mm, Hh^Fms, Hh^Fms, Gll, Gs^Fms, Gg^Ve, Gg^Fet, Gs^Fms, Gs^Fms, Wwt, Ww^Ewf, Ww^Ewf, Wwt, Gg^Fet, Gs^Fms, Gs^Fms, Gs^Fms, Gs^Fms, Gs^Fms, Hh^Fms, Hh^Fms, Gs^Fms, Gs^Fms, Gll, Gg^Fet, Gll, Cv, Gll, Cv, Gll, Cv, Gll, Gs^Fms, Wwt, Wwf, Wwt, Gll, Gll, Gs^Fms, Gg^Fet, Gg^Fet, Gs^Fms, Gg^Fet, Cv, 4 Kv, Cv, Gs^Fms, Gs^Fms, Gg^Fet, Gg^Fet, Gs^Fms, Gs^Fms, Gs^Fms, Gs^Fms, Hh^Fms, Hh^Fms, Mm, Mm, Mm^Xm, Mm^Xm, Mm^Xm, Mm^Xm
Mm, Mm, Mm, Mm^Xm, Mm^Xm, Mm, Mm, Mm, Hh^Fms, Hh^Fms, Gs^Fms, Gll, Gll, Gs^Fms, Gg^Fet, Gs^Fms, Gs^Fms, Ww^Ewf, Wwt, Ww^Ewf, Wwt, Gll, Gs^Fms, Gs^Fms, Gs^Fms, Hh^Fms, Gs^Fms, Gs^Fms, Gs^Fms, Gs^Fms, Gs^Fms, Gg^Fet, Gll, Gll, Gll, Gll, Gll, Gll, Gll, Wwf, Wwf, Gll, Gll, Gs^Fms, Gll, Gll, Gll, Gll, Cv, Cv, Cv, Cv, Cv, Gs^Fms, Gll, Gg^Ve, Gs^Fms, Gs^Fms, Gll, Hh^Fms, Hh^Fms, Mm, Mm, Mm, Mm, Mm, Mm^Xm, Mm
Mm^Xm, Mm^Xm, Mm, Mm, Mm^Xm, Mm, Mm, Mm, Hh^Fms, Hh^Fms, Gs^Fms, Gs^Fms, Gs^Fms, Gll, Cv, Gs^Fms, Gs^Fms, Gll, Gll, Ww^Ewf, Ww^Ewf, Gs^Fms, Wwt, Gll, Gll, Gg^Fet, Gll, Gs^Fms, Gg^Fet, Gg^Fet, Gg^Fet, Gs^Fms, Gll, Gs^Fms, Gll, Gs^Fms, Gs^Fms, Gll, Gll, Wwf, Wwt, Wwt, Wwt, Gll, Wwt, Gg^Fet, Gg^Fet, Gs^Fms, Gs^Fms, Gs^Fms, Cv, Gll, Gll, Gg^Fet, Gll, Gll, Gs^Fms, Gs^Fms, Gll, Gll, Hh^Fms, Mm, Mm, Mm^Xm, Mm, Mm, Mm^Xm, Mm
Mm^Xm, Mm, Mm^Xm, Mm^Xm, Mm, Mm, Mm, Hh^Fms, Hh^Fms, Hh^Fms, Gg^Ve, Gs^Fms, Gs^Fms, Cv, 5 Kv, Cv, Gll, Gs^Fms, Gll, Wwt, Wwt, Ww^Ewf, Ww^Ewf, Wwt, Wwt, Gll, Gll, Gs^Fms, Gs^Fms, Gg^Ve, Gs^Fms, Gs^Fms, Gll, Gg^Fet, Hh^Fms, Gs^Fms, Gs^Fms, Gs^Fms, Gs^Fms, Gg^Fet, Gll, Ww^Ewf, Wwt, Ww^Ewf, Wwt, Wwt, Wwf, Gll, Gll, Gs^Fms, Gll, Gg^Fet, Gll, Gs^Fms, Gg^Fet, Gs^Fms, Gll, Gg^Fet, Gs^Fms, Gll, Hh^Fms, Mm, Mm, Mm^Xm, Mm, Mm^Xm, Mm^Xm, Mm
Mm^Xm, Mm, Mm^Xm, Mm, Mm, Mm, Hh^Fms, Hh^Fms, Hh^Fms, Hh^Fms, Gll, Gs^Fms, Gll, Cv, Cv, Cv, Gll, Gs^Fms, Gg^Ve, Gll, Gll, Wwt, Gll, Wwt, Ww^Ewf, Wwt, Ww^Ewf, Gll, Gs^Fms, Gs^Fms, Gg^Fet, Gg^Fet, Gll, Gs^Fms, Hh^Fms, Hh^Fms, Hh^Fms, Gs^Fms, Gs^Fms, Gg^Fet, Gg^Fet, Gll, Gll, Wwt, Gs^Fms, Wwf, Wwf, Wwf, Gll, Gll, Gg^Ve, Gs^Fms, Gll, Gg^Ve, Gll, Gll, Gs^Fms, Gll, Gs^Fms, Gll, Hh^Fms, Mm, Mm, Mm, Mm^Xm, Mm, Mm, Mm
Mm, Mm, Mm^Xm, Mm, Mm, Mm, Hh^Fms, Hh^Fms, Hh^Fms, Hh^Fms, Hh^Fms, Gs^Fms, Gs^Fms, Gs^Fms, Gll, Gs^Fms, Gs^Fms, Gll, Gll, Gs^Fms, Gs^Fms, Gs^Fms, Gs^Fms, Gs^Fms, Gll, Ww^Ewf, Wwt, Gll, Gll, Gs^Fms, Gs^Fms, Gg^Fet, Gll, Gs^Fms, Hh^Fms, Hh^Fms, Hh^Fms, Hh^Fms, Gs^Fms, Gs^Fms, Gs^Fms, Gll, Gg^Fet, Gll, Gs^Fms, Gll, Wwt, Wwt, Gll, Gs^Fms, Gs^Fms, Gs^Fms, Gs^Fms, Gll, Gs^Fms, Gs^Fms, Gg^Fet, Gg^Fet, Gs^Fms, Gll, Hh^Fms, Mm, Mm, Mm, Mm, Mm^Xm, Mm, Mm
Mm, Mm^Xm, Mm, Mm, Mm, Mm, Mm, Hh^Fms, Mm, Hh^Fms, Hh^Fms, Hh^Fms, Gg^Fet, Gll, Gll, Gll, Gs^Fms, Gs^Fms, Gll, Gll, Gll, Gs^Fms, Gs^Fms, Gs^Fms, Gs^Fms, Wwt, Ww^Ewf, Wwt, Wwt, Gll, Gll, Gg^Fet, Gll, Gs^Fms, Gg^Ve, Hh^Fms, Hh^Fms, Hh^Fms, Gs^Fms, Gs^Fms, Gll, Gll, Gg^Fet, Gs^Fms, Gs^Fms, Gll, Wwt, Ww^Ewf, Gll, Gll, Gs^Fms, Gs^Fms, Gs^Fms, Gll, Gg^Fet, Gs^Fms, Gs^Fms, Gs^Fms, Gs^Fms, Gll, Gll, Hh^Fms, Mm, Mm, Mm, Mm^Xm, Mm, Mm
Mm, Mm, Mm^Xm, Mm^Xm, Mm^Xm, Mm, Mm, Mm, Mm, Mm, Hh^Fms, Hh^Fms, Hh^Fms, Gg^Fet, Gll, Gg^Fet, Gs^Fms, Gs^Fms, Hh^Fms, Hh^Fms, Hh^Fms, Gll, Gll, Gg^Fet, Gs^Fms, Gll, Gll, Ww^Ewf, Ww^Ewf, Wwt, Wwt, Gll, Gll, Gs^Fms, Gs^Fms, Hh^Fms, Hh^Fms, Gg^Ve, Gs^Fms, Gll, Gg^Fet, Gs^Fms, Gs^Fms, Gs^Fms, Gll, Gll, Ww^Ewf, Ww^Ewf, Gs^Fms, Gs^Fms, Gs^Fms, Gg^Fet, Gll, Gll, Gll, Gs^Fms, Gs^Fms, Gs^Fms, Gs^Fms, Gs^Fms, Gll, Hh^Fms, Hh^Fms, Mm, Mm, Mm^Xm, Mm, Mm
Mm^Xm, Mm^Xm, Mm^Xm, Mm, Mm, Mm^Xm, Mm^Xm, Mm, Mm, Mm, Mm, Hh^Fms, Hh^Fms, Gs^Fms, Gll, Gg^Ve, Gs^Fms, Gll, Hh^Fms, Hh^Fms, Hh^Fms, Hh^Fms, Gs^Fms, Gll, Gll, Gs^Fms, Gs^Fms, Gll, Ww^Ewf, Wwt, Wwt, Gll, Gll, Gs^Fms, Gg^Fet, Gs^Fms, Gs^Fms, Gs^Fms, Gs^Fms, Gll, Gll, Gll, Gll, Gll, Wwt, Wwt, Wwt, Wwt, Gll, Gs^Fms, Gg^Fet, Gll, Gs^Fms, Gs^Fms, Gs^Fms, Gll, Gll, Gs^Fms, Gs^Fms, Gll, Hh^Fms, Hh^Fms, Mm, Mm, Mm, Mm^Xm, Mm^Xm, Mm
Mm^Xm, Mm, Mm, Mm^Xm, Mm^Xm, Mm, Mm^Xm, Mm, Mm, Mm, Mm, Mm, Hh^Fms, Gs^Fms, Gll, Gs^Fms, Gll, Hh^Fms, Hh^Fms, Hh^Fms, Hh^Fms, Gs^Fms, Gs^Fms, Gs^Fms, Gg^Fet, Gll, Gg^Ve, Gs^Fms, Wwt, Ww^Ewf, Gs^Fms, Gs^Fms, Gll, Kv, Gs^Fms, Gg^Fet, Gg^Fet, Gg^Ve, Gll, Gll, Wwt, Wwt, Ww^Ewf, Wwt, Ww^Ewf, Ww^Ewf, Wwt, Wwt, Gs^Fms, Gg^Fet, Gs^Fms, Gs^Fms, Hh^Fms, Gll, Gll, Gs^Fms, Gs^Fms, Gll, Hh^Fms, Hh^Fms, Mm, Mm, Mm, Mm, Mm, Mm, Mm^Xm, Mm
Mm, Mm^Xm, Mm^Xm, Mm, Mm^Xm, Mm, Mm^Xm, Mm^Xm, Mm, Mm, Mm, Hh^Fms, Hh^Fms, Gs^Fms, Gll, Gs^Fms, Gs^Fms, Hh^Fms, Hh^Fms, Hh^Fms, Hh^Fms, Hh^Fms, Gll, Gs^Fms, Gll, Gs^Fms, Gll, Gll, Wwf, Wwt, Gll, Kv, Cv, Cv, Cv, Kv, Gll, Gll, Ww^Ewf, Wwt, Ww^Ewf, Ww^Ewf, Wwt, Wwt, Wwt, Wwt, Wwt, Gs^Fms, Gs^Fms, Gs^Fms, Gs^Fms, Hh^Fms, Hh^Fms, Hh^Fms, Gs^Fms, Gs^Fms, Gs^Fms, Gll, Hh^Fms, Mm, Mm, Mm, Mm, Mm, Mm, Mm, Mm^Xm, Mm
Mm, Mm, Mm^Xm, Mm, Mm^Xm, Mm, Mm, Mm, Mm, Mm, Mm, Hh^Fms, Hh^Fms, Gs^Fms, Gs^Fms, Gll, Gs^Fms, Gs^Fms, Gll, Hh^Fms, Hh^Fms, Hh^Fms, Gll, Gs^Fms, Gs^Fms, Gs^Fms, Gll, Wwf, Wwf, Wwf, Gs^Fms, Gs^Fms, Cv, Kv, Cv, Gs^Fms, Gll, Wwt, Wwt, Ww^Ewf, Gs^Fms, Gs^Fms, Gs^Fms, Gll, Wwt, Wwt, Cv, Gll, Gs^Fms, Gs^Fms, Gg^Ve, Hh^Fms, Hh^Fms, Hh^Fms, Hh^Fms, Gg^Fet, Gg^Fet, Gll, Hh^Fms, Mm, Mm, Mm, Mm, Mm^Xm, Mm, Mm^Xm, Mm^Xm, Mm
Mm, Mm, Mm^Xm, Mm, Mm^Xm, Mm, Mm, Mm, Mm, Mm, Hh^Fms, Hh^Fms, Gll, Gs^Fms, Gs^Fms, Gll, Gs^Fms, Gll, Gs^Fms, Gll, Gs^Fms, Gs^Fms, Gs^Fms, Gs^Fms, Gll, Gll, Wwt, Wwt, Wwt, Gll, Gll, Kv, Gs^Fms, Cv, Gs^Fms, Kv, Wwf, Wwt, Wwt, Gll, Gs^Fms, Gs^Fms, Gs^Fms, Gs^Fms, Ww^Ewf, Wwt, Kv, Cv, Gll, Gg^Fet, Gs^Fms, Hh^Fms, Hh^Fms, Hh^Fms, Gs^Fms, Gs^Fms, Gll, Gll, Gll, Hh^Fms, Mm, Mm, Mm, Mm^Xm, Mm, Mm, Mm^Xm, Mm
Mm, Mm, Mm^Xm, Mm, Mm^Xm, Mm, Mm, Mm, Hh^Fms, Mm, Hh^Fms, Gs^Fms, Gs^Fms, Gs^Fms, Gll, Gll, Gll, Gs^Fms, Gg^Fet, Gs^Fms, Gll, Gg^Fet, Gll, Gll, Wwt, Wwt, Ww^Ewf, Wwt, Wwt, Wwt, Gll, Gs^Fms, Gs^Fms, Kv, Gs^Fms, Gs^Fms, Wwt, Wwf, Gll, Gs^Fms, Gs^Fms, Gll, Gs^Fms, Gs^Fms, Wwt, Ww^Ewf, Wwt, Cv, Gs^Fms, Gg^Fet, Gg^Fet, Gs^Fms, Gs^Fms, Gll, Gs^Fms, Gs^Fms, Gll, Gg^Fet, Gll, Hh^Fms, Mm, Mm, Mm, Mm^Xm, Mm^Xm, Mm^Xm, Mm, Mm
Mm, Mm^Xm, Mm^Xm, Mm, Mm^Xm, Mm, Mm, Mm, Mm, Hh^Fms, Hh^Fms, Gs^Fms, Gg^Ve, Gll, Gs^Fms, Gs^Fms, Gll, Gs^Fms, Gs^Fms, Gs^Fms, Gs^Fms, Gs^Fms, Wwt, Ww^Ewf, Ww^Ewf, Ww^Ewf, Wwt, Ww^Ewf, Wwt, Ww^Ewf, Wwt, Gll, Wwt, Gll, Wwt, Ww^Ewf, Ww^Ewf, Wwt, Gll, Gll, Gs^Fms, Gs^Fms, Gs^Fms, Gs^Fms, Wwt, Ww^Ewf, Wwt, Wwt, Wwf, Gs^Fms, Gs^Fms, Gg^Fet, Cv, Gs^Fms, Gg^Fet, Gg^Fet, Gll, Gs^Fms, Gll, Hh^Fms, Hh^Fms, Mm, Mm, Mm, Mm^Xm, Mm, Mm, Mm
Mm^Xm, Mm, Mm, Mm^Xm, Mm^Xm, Mm, Mm, Mm, Mm, Hh^Fms, Hh^Fms, Gs^Fms, Gs^Fms, Gs^Fms, Gs^Fms, Gs^Fms, Gs^Fms, Gll, Gs^Fms, Gs^Fms, Gll, Gll, Wwt, Ww^Ewf, Gs^Fms, Wwt, Gll, Gll, Gg^Fet, Wwt, Wwt, Wwf, Wwt, Wwf, Wwt, Wwt, Gs^Fms, Gs^Fms, Gs^Fms, Gll, Gs^Fms, Gg^Fet, Gs^Fms, Gll, Gll, Wwt, Gs^Fms, Wwf, Wwf, Wwf, Wwt, Cv, Kv, Cv, Gll, Gll, Gs^Fms, Gg^Fet, Gll, Hh^Fms, Hh^Fms, Mm, Mm, Mm, Mm, Mm, Mm^Xm, Mm
Mm^Xm, Mm, Mm, Mm^Xm, Mm^Xm, Mm^Xm, Mm, Mm, Mm, Mm, Hh^Fms, Hh^Fms, Hh^Fms, Gs^Fms, Gg^Fet, Gs^Fms, Gg^Fet, Gll, Gs^Fms, Gs^Fms, Gll, Gg^Ve, Ww^Ewf, Wwt, Gs^Fms, Gs^Fms, Gg^Fet, Gg^Fet, Gs^Fms, Gll, Kv, Wwf, Kv, Wwf, Kv, Gll, Gll, Gll, Gll, Gll, Gs^Fms, Gll, Gs^Fms, Gs^Fms, Gg^Fet, Gg^Fet, Gg^Fet, Gs^Fms, Wwt, Wwt, Ww^Ewf, Wwt, Wwt, Cv, Gs^Fms, Gg^Fet, Gll, Gs^Fms, Gll, Gll, Hh^Fms, Hh^Fms, Mm, Mm, Mm, Mm, Mm^Xm, Mm
Mm^Xm, Mm, Mm, Mm, Mm^Xm, Mm^Xm, Mm^Xm, Mm, Mm, Mm, Mm, Hh^Fms, Hh^Fms, Gs^Fms, Gll, Gs^Fms, Gs^Fms, Gll, Gll, Gll, Ww^Ewf, Ww^Ewf, Ww^Ewf, Wwt, Gs^Fms, Gs^Fms, Gs^Fms, Gs^Fms, Gg^Fet, Gg^Fet, Gll, Gll, Gs^Fms, Gll, Gs^Fms, Gs^Fms, Gs^Fms, Gg^Fet, Gs^Fms, Gg^Fet, Gs^Fms, Gs^Fms, Gs^Fms, Gll, Gs^Fms, Gll, Gg^Fet, Gg^Fet, Gll, Wwt, Wwt, Ww^Ewf, Ww^Ewf, Gll, Gg^Ve, Gs^Fms, Gs^Fms, Gll, Gll, Gs^Fms, Gll, Hh^Fms, Mm, Mm, Mm, Mm, Mm^Xm, Mm
Mm, Mm^Xm, Mm, Mm^Xm, Mm, Mm^Xm, Mm^Xm, Mm, Mm, Mm, Mm, Mm, Hh^Fms, Hh^Fms, Gs^Fms, Gg^Fet, Gs^Fms, Gs^Fms, Gll, Wwt, Wwt, Wwt, Gll, Gll, Gs^Fms, Gg, Gs^Fms, Gll, Gs^Fms, Gll, Gg^Fet, Gs^Fms, Gll, Gll, Gll, Gg^Fet, Gll, Gs^Fms, Gs^Fms, Gs^Fms, Gg^Fet, Gg^Fet, Gll, Gll, Gll, Gs^Fms, Gg^Fet, Gs^Fms, Gg^Fet, Gs^Fms, Gs^Fms, Wwt, Wwt, Wwt, Wwt, Gs^Fms, Gs^Fms, Gg^Fet, Gll, Gs^Fms, Hh^Fms, Hh^Fms, Mm, Mm, Mm, Mm, Mm^Xm, Mm
Mm, Mm^Xm, Mm^Xm, Mm, Mm^Xm, Mm^Xm, Mm, Mm^Xm, Mm, Mm, Mm, Mm, Mm, Hh^Fms, Gs^Fms, Gs^Fms, Gs^Fms, Gs^Fms, Wwt, Wwf, Wwf, Gll, Gs^Fms, Gs^Fms, Gs^Fms, Gg^Fet, Gs^Fms, Gs^Fms, Gs^Fms, Gll, Gg^Fet, Gs^Fms, Gs^Fms, Gll, Gs^Fms, Gll, Gll, Gs^Fms, Gs^Fms, Gg^Ve, Gs^Fms, Gs^Fms, Gll, Gs^Fms, Gs^Fms, Gs^Fms, Gg^Fet, Gs^Fms, Gs^Fms, Gg^Fet, Gs^Fms, Wwt, Wwt, Ww^Ewf, Wwt, Gll, Gs^Fms, Gs^Fms, Gs^Fms, Gll, Hh^Fms, Mm, Mm, Mm, Mm, Mm, Mm^Xm, Mm
Mm^Xm, Mm, Mm, Mm, Mm^Xm, Mm, Mm, Mm^Xm, Mm, Mm, Mm, Mm, Mm, Hh^Fms, Gs^Fms, Gg^Fet, Gs^Fms, Gs^Fms, Wwt, Wwt, Cv, Gll, Gll, Gg^Ve, Gs^Fms, Gll, Gg^Fet, Gs^Fms, Gg^Fet, Gll, Gs^Fms, Gll, Gs^Fms, Gll, Gs^Fms, Gll, Gll, Gs^Fms, Gll, Gs^Fms, Gll, Gg^Fet, Gg^Fet, Gg^Fet, Gs^Fms, Gll, Gs^Fms, Gs^Fms, Hh^Fms, Gs^Fms, Gg^Fet, Gs^Fms, Gs^Fms, Wwt, Wwt, Wwt, Gll, Gs^Fms, Gll, Gll, Hh^Fms, Hh^Fms, Mm, Mm, Mm^Xm, Mm^Xm, Mm^Xm, Mm^Xm
Mm^Xm, Mm^Xm, Mm, Mm, Mm, Mm, Mm, Mm, Mm, Mm, Mm, Mm, Hh^Fms, Hh^Fms, Gs^Fms, Gg^Fet, Gs^Fms, Gll, Ww^Ewf, Ww^Ewf, Kv, Cv, Gll, Gll, Gll, Gs^Fms, Gs^Fms, Gs^Fms, Gll, Gll, Gs^Fms, Gll, Gs^Fms, Gs^Fms, Gs^Fms, Gs^Fms, Gll, Gll, Gs^Fms, Gs^Fms, Gg^Fet, Gll, Gg^Fet, Gs^Fms, Gll, Gs^Fms, Hh^Fms, Hh^Fms, Hh^Fms, Hh^Fms, Gs^Fms, Gg^Fet, Gs^Fms, Gs^Fms, Ww^Ewf, Ww^Ewf, Gll, Gg^Fet, Gll, Hh^Fms, Mm, Mm, Mm^Xm, Mm^Xm, Mm, Mm, Mm^Xm, Mm
Mm^Xm, Mm, Mm, Mm, Mm, Mm, Mm, Mm, Mm, Mm, Mm, Mm, Hh^Fms, Gs^Fms, Gll, Gs^Fms, Ww^Ewf, Ww^Ewf, Ww^Ewf, Wwt, Gll, Cv, Gll, Gs^Fms, Hh^Fms, Gll, Gll, Gs^Fms, Gs^Fms, Gs^Fms, Gll, Gs^Fms, Gll, Gll, Gll, Gll, Gg, Gll, Gg^Ve, Gs^Fms, Gg, Gs^Fms, Gg^Fet, Gs^Fms, Gll, Gs^Fms, Hh^Fms, Hh^Fms, Hh^Fms, Hh^Fms, Gs^Fms, Gg^Fet, Gg^Fet, Gs^Fms, Ww^Ewf, Wwt, Gs^Fms, Gll, Gg^Fet, Hh^Fms, Hh^Fms, Mm, Mm, Mm^Xm, Mm, Mm, Mm^Xm, Mm
Mm^Xm, Mm^Xm, Mm, Mm, Mm, Mm, Mm, Mm, Mm, Mm, Mm, Hh^Fms, Hh^Fms, Gg^Fet, Wwt, Ww^Ewf, Wwt, Ww^Ewf, Gll, Gll, Gs^Fms, Gll, Hh^Fms, Hh^Fms, Hh^Fms, Hh^Fms, Hh^Fms, Gg^Ve, Gs^Fms, Gll, Gll, Gll, Gg, Gg, Gg, Gg, Gg, Gll, Gs^Fms, Gs^Fms, Gs^Fms, Gg^Fet, Gll, Gg^Fet, Gs^Fms, Hh^Fms, Hh^Fms, Hh^Fms, Hh^Fms, Hh^Fms, Hh^Fms, Cv, Kv, Gs^Fms, Ww^Ewf, Wwt, Gs^Fms, Gll, Gs^Fms, Hh^Fms, Hh^Fms, Mm, Mm, Mm, Mm, Mm^Xm, Mm, Mm
Mm, Mm^Xm, Mm, Mm, Hh^Fms, Hh^Fms, Hh^Fms, Hh^Fms, Hh^Fms, Mm, Hh^Fms, Hh^Fms, Hh^Fms, Gs^Fms, Wwt, Ww^Ewf, Gs^Fms, Gs^Fms, Gs^Fms, Gs^Fms, Gg^Fet, Gll, Hh^Fms, Hh^Fms, Hh^Fms, Hh^Fms, Hh^Fms, Gs^Fms, Gll, Gll, Cv, Cv, Cv, Gll, Gg, Gll, Gg, Gll, Gll, Gll, Gg^Fet, Gg^Fet, Gll, Gs^Fms, Gll, Gll, Gll, Hh^Fms, Hh^Fms, Hh^Fms, Gll, Cv, Cv, Gs^Fms, Ww^Ewf, Wwt, Gs^Fms, Gll, Gs^Fms, Hh^Fms, Hh^Fms, Hh^Fms, Mm, Mm, Mm^Xm, Mm^Xm, Mm, Mm
Mm^Xm, Mm, Mm, Mm, Wwt, Wwt, Wwt, Wwt, Hh^Fms, Hh^Fms, Hh^Fms, Hh^Fms, Gs^Fms, Wwt, Ww^Ewf, Wwt, Gs^Fms, Gs^Fms, Gg^Fet, Gs^Fms, Gs^Fms, Gll, Gll, Hh^Fms, Hh^Fms, Hh^Fms, Gll, Gs^Fms, Gll, Gll, Gg, Gg, Gll, Gg, Gll, Gg, Gg, Gll, Gs^Fms, Gll, Gll, Gll, Gg^Fet, Gll, Gll, Gs^Fms, Gs^Fms, Gll, Gll, Gs^Fms, Gg^Fet, Gg^Fet, Gll, Wwt, Wwt, Ww^Ewf, Gll, Gll, Gg^Fet, Hh^Fms, Hh^Fms, Hh^Fms, Mm, Mm, Mm^Xm, Mm^Xm, Mm^Xm, Mm
Mm^Xm, Mm, Mm, Mm, Wwt, Ww^Ewf, Wwt, Ww^Ewf, Ww^Ewf, Hh^Fms, Wwt, Gs^Fms, Wwt, Wwt, Wwt, Gs^Fms, Gll, Gs^Fms, Gll, Gs^Fms, Gg^Fet, Gg^Ve, Gll, Gs^Fms, Gll, Hh^Fms, Cv, Cv, Gg, Gll, Gll, Gg, Gll, Gg, Gll, Cv, Cv, Gll, Gs^Fms, Gg^Fet, Gll, Gs^Fms, Gg^Fet, Gll, Gs^Fms, Gg^Fet, Gg^Fet, Gs^Fms, Gll, Gs^Fms, Gg^Fet, Gs^Fms, Wwf, Wwf, Wwf, Wwt, Gg^Ve, Gs^Fms, Gg^Fet, Gs^Fms, Hh^Fms, Mm, Mm, Mm, Mm, Mm^Xm, Mm^Xm, Mm
Mm^Xm, Mm, Wwt, Wwt, Hh^Fms, Hh^Fms, Hh^Fms, Wwt, Wwt, Ww^Ewf, Ww^Ewf, Wwt, Ww^Ewf, Ww^Ewf, Hh^Fms, Gs^Fms, Gs^Fms, Gs^Fms, Gs^Fms, Gs^Fms, Gs^Fms, Gll, Gs^Fms, Gll, Gll, Gs^Fms, Cv, Gg, Gll, Gg, Gll, Gg, Gll, Gll, Gg, Gg, Cv, Gs^Fms, Gs^Fms, Gg^Fet, Gg^Ve, Gs^Fms, Gs^Fms, Gs^Fms, Gs^Fms, Gs^Fms, Gg^Fet, Gs^Fms, Gll, Gll, Gll, Gll, Wwt, Wwf, Wwf, Gs^Fms, Gs^Fms, Gs^Fms, Gg^Fet, Hh^Fms, Hh^Fms, Mm, Mm, Mm, Mm, Mm^Xm, Mm, Mm
Mm, Mm^Xm, Mm, Mm, Mm, Mm, Mm, Hh^Fms, Hh^Fms, Wwt, Hh^Fms, Wwt, Hh^Fms, Hh^Fms, Hh^Fms, Hh^Fms, Gs^Fms, Gs^Fms, Hh^Fms, Gs^Fms, Hh^Fms, Gs^Fms, Hh^Fms, Gs^Fms, Gs^Fms, Gll, Gs^Fms, Gg, Gll, Gg, Gll, Gg, Gg, Gll, Gll, Gll, Gll, Gll, Gs^Fms, Gs^Fms, Gs^Fms, Gs^Fms, Gs^Fms, Gs^Fms, Hh^Fms, Gs^Fms, Gs^Fms, Gg^Fet, Gg^Fet, Gs^Fms, Gg^Fet, Gll, Ww^Ewf, Wwt, Wwt, Gs^Fms, Gll, Gg^Fet, Hh^Fms, Hh^Fms, Mm, Mm, Mm, Mm, Mm, Mm, Mm, Mm
Mm, Mm^Xm, Mm, Mm, Mm, Mm, Mm, Mm, Mm, Hh^Fms, Hh^Fms, Hh^Fms, Hh^Fms, Hh^Fms, Hh^Fms, Hh^Fms, Hh^Fms, Hh^Fms, Hh^Fms, Hh^Fms, Hh^Fms, Hh^Fms, Hh^Fms, Hh^Fms, Hh^Fms, Gs^Fms, Hh^Fms, Gs^Fms, Gs^Fms, Gll, Gll, Gs, Gs, Gll, Gg, Gll, Gs^Fms, Gs^Fms, Hh^Fms, Hh^Fms, Hh^Fms, Hh^Fms, Hh^Fms, Hh^Fms, Hh^Fms, Hh^Fms, Hh^Fms, Gll, Hh^Fms, Gg^Fet, Gs^Fms, Gs^Fms, Gll, Wwt, Ww^Ewf, Wwt, Ww^Ewf, Gll, Hh^Fms, Mm, Mm, Mm^Xm, Mm^Xm, Mm^Xm, Mm, Mm^Xm, Mm, Mm
Mm, Mm^Xm, Mm^Xm, Mm, Mm, Mm, Mm, Mm, Mm, Hh^Fms, Mm, Mm, Mm, Mm, Mm, Hh^Fms, Hh^Fms, Hh^Fms, Mm, Hh^Fms, Mm, Mm, Mm, Mm, Mm, Hh^Fms, Hh^Fms, Cv, Cv, Gd^Fetd, Gd, Gs, Gd, Gs, Cv, Cv, Gs^Fms, Hh^Fms, Hh^Fms, Hh^Fms, Hh^Fms, Hh^Fms, Hh^Fms, Hh^Fms, Mm, Hh^Fms, Mm, Hh^Fms, Hh^Fms, Hh^Fms, Hh^Fms, Gs^Fms, Gs^Fms, Gs^Fms, Gg^Fet, Ww^Ewf, Wwt, Wwt, Wwt, Mm, Mm, Mm^Xm, Mm, Mm, Mm^Xm, Mm^Xm, Mm^Xm, Mm
Mm^Xm, Mm^Xm, Mm^Xm, Mm^Xm, Mm, Mm, Mm, Mm, Mm, Mm, Mm, Mm, Mm, Mm, Mm, Mm, Mm, Mm, Mm, Mm, Mm, Mm, Mm, Mm, Mm, Mm, Mm, Hh^Fms, Cv, Gd, Rb^Cov, Gd, Rb^Cov, Gd, Cv, Gs^Fms, Hh^Fms, Hh^Fms, Mm, Mm, Hh^Fms, Hh^Fms, Hh^Fms, Mm, Mm, Mm, Mm, Mm, Mm, Hh^Fms, Hh^Fms, Hh^Fms, Hh^Fms, Gs^Fms, Hh^Fms, Gs^Fms, Gs^Fms, Wwt, Ww^Ewf, Hh^Fms, Hh^Fms, Hh^Fms, Mm, Mm, Mm, Mm^Xm, Mm, Mm
Mm, Mm, Mm, Mm^Xm, Mm^Xm, Mm^Xm, Mm^Xm, Mm, Mm, Mm, Mm, Mm, Mm, Mm^Xm, Mm^Xm, Mm, Mm, Mm, Mm, Mm, Mm^Xm, Mm^Xm, Mm^Xm, Mm, Mm^Xm, Mm^Xm, Mm, Hh^Fms, Gd^Fetd, Rb^Cov, Wwb^Cov, Rb^Cov, Wwb^Cov, Gd^Cov, Gd^Fetd, Gs^Fms, Hh^Fms, Mm, Mm^Xm, Mm, Mm, Mm, Mm, Mm, Mm^Xm, Mm, Mm^Xm, Mm, Mm, Mm, Mm, Hh^Fms, Hh^Fms, Hh^Fms, Hh^Fms, Gs^Fms, Gs^Fms, Wwt, Ww^Ewf, Wwt, Wwt, Hh^Fms, Hh^Fms, Mm, Mm, Mm, Mm^Xm, Mm
Mm, Mm^Xm, Mm, Mm^Xm, Mm, Mm^Xm, Mm, Mm^Xm, Mm, Mm^Xm, Mm^Xm, Mm, Mm, Mm, Mm, Mm^Xm, Mm^Xm, Mm^Xm, Mm^Xm, Mm, Mm^Xm, Mm, Mm, Mm, Mm^Xm, Mm, Hh^Fms, Hh^Fms, Gd^Fetd, Rb^Cov, Uu^Cov, Uu^Cov, Uu^Cov, Wwb^Cov, Gd, Gd^Fetd, Hh^Fms, Mm, Mm, Mm^Xm, Mm^Xm, Mm, Mm, Mm^Xm, Mm, Mm^Xm, Mm, Mm^Xm, Mm, Mm, Mm, Mm, Mm, Hh^Fms, Hh^Fms, Hh^Fms, Hh^Fms, Gs^Fms, Hh^Fms, Ww^Ewf, Ww^Ewf, Ww^Ewf, Wwt, Hh^Fms, Hh^Fms, Mm, Mm^Xm, Mm
Mm, Mm^Xm, Mm, Mm^Xm, Mm, Mm, Mm, Mm^Xm, Mm^Xm, Mm, Mm, Mm^Xm, Mm, Mm, Mm^Xm, Mm, Mm^Xm, Mm, Mm, Mm^Xm, Mm, Mm^Xm, Mm^Xm, Mm, Mm, Mm, Hh^Fms, Hh^Fms, Gd^Fetd, Wwb^Cov, Uu^Cov, 2 Uu^Kov, Uu^Cov, Wwb^Cov, Gd, Gd^Fetd, Hh^Fms, Hh^Fms, Mm, Mm, Mm, Mm^Xm, Mm^Xm, Mm, Mm, Mm, Mm, Mm^Xm, Mm^Xm, Mm^Xm, Mm, Mm, Mm, Hh^Fms, Mm, Hh^Fms, Hh^Fms, Hh^Fms, Hh^Fms, Hh^Fms, Hh^Fms, Wwt, Ww^Ewf, Hh^Fms, Hh^Fms, Mm, Mm^Xm, Mm
Mm, Mm^Xm, Mm, Mm, Mm, Mm^Xm, Mm, Mm, Mm^Xm, Mm^Xm, Mm, Mm, Mm^Xm, Mm^Xm, Mm, Mm, Mm^Xm, Mm, Mm^Xm, Mm^Xm, Mm, Mm, Mm, Mm, Hh^Fms, Hh^Fms, Hh^Fms, Gd^Fetd, Gd, Wwb^Cov, Wwb^Cov, Uu^Cov, Wwb^Cov, Rb^Cov, Gd, Gd^Fetd, Hh^Fms, Hh^Fms, Hh^Fms, Mm, Mm, Mm, Mm, Mm^Xm, Mm, Mm^Xm, Mm^Xm, Mm, Mm^Xm, Mm^Xm, Mm^Xm, Mm^Xm, Mm^Xm, Mm, Mm, Hh^Fms, Mm, Mm, Mm, Hh^Fms, Mm, Wwt, Wwt, Ww^Ewf, Wwt, Mm, Mm^Xm, Mm^Xm
Mm, Mm, Mm, Mm, Mm^Xm, Mm^Xm, Mm, Mm, Mm^Xm, Mm, Mm^Xm, Mm, Mm^Xm, Mm, Mm, Mm, Mm^Xm, Mm, Mm, Mm, Mm^Xm, Mm, Mm, Mm, Hh^Fms, Hh^Fms, Hh^Fms, Gs^Fms, Gs, Gd, Gd, Rb^Cov, Gd, Gd, Gd^Fetd, Gd^Fetd, Hh^Fms, Hh^Fms, Hh^Fms, Mm, Mm, Mm, Mm, Mm, Mm^Xm, Mm, Mm, Mm, Mm, Mm, Mm, Mm, Mm, Mm, Mm, Mm, Mm^Xm, Mm, Mm^Xm, Mm, Mm, Mm, Mm, Ww^Ewf, Wwt, Mm, Mm^Xm, Mm
Mm, Mm^Xm, Mm^Xm, Mm, Mm, Mm, Mm, Mm, Mm^Xm, Mm, Mm, Mm, Mm, Mm^Xm, Mm, Mm, Mm^Xm, Mm, Mm, Mm, Mm, Mm, Mm, Mm^Xm, Mm, Hh^Fms, Hh^Fms, Hh^Fms, Gs^Fms, Gs, Gs, Gd, Gs, Gs, Gs^Fms, Gs^Fms, Hh^Fms, Hh^Fms, Hh^Fms, Hh^Fms, Mm, Mm, Mm, Mm, Mm^Xm, Mm, Mm, Mm, Mm, Mm, Mm, Mm^Xm, Mm^Xm, Mm^Xm, Mm^Xm, Mm^Xm, Mm, Mm^Xm, Mm, Mm^Xm, Mm, Mm^Xm, Mm, Mm, Wwt, Mm, Mm^Xm, Mm
Mm, Mm, Mm^Xm, Mm^Xm, Mm, Mm^Xm, Mm, Mm, Mm, Mm^Xm, Mm^Xm, Mm^Xm, Mm^Xm, Mm^Xm, Mm, Mm, Mm, Mm^Xm, Mm^Xm, Mm^Xm, Mm^Xm, Mm, Mm, Mm, Mm, Mm, Hh^Fms, Hh^Fms, Gs^Fms, Gll, Gg, Gs, Gg, Gll, Gs^Fms, Gs^Fms, Gg, Hh^Fms, Mm, Mm, Mm, Mm, Mm^Xm, Mm^Xm, Mm, Mm, Mm^Xm, Mm^Xm, Mm^Xm, Mm^Xm, Mm, Mm, Mm, Mm^Xm, Mm, Mm^Xm, Mm, Mm, Mm, Mm, Mm^Xm, Mm^Xm, Mm, Mm^Xm, Mm, Mm^Xm, Mm^Xm, Mm
