Xu, Xu, Xu, Xu, Xu, Xu, Xu, Xu, Xu, Xu, Xu, Xu, Xu, Xu, Xu, Xu, Xu, Xu, Xu, Xu, Xu, Xu, Xu, Xu, Xu, Xu, Xu, Xu, Xu, Xu, Xu, Xu, Xu, Xu, Xu, Xu, Xu, Xu, Xu, Xu, Xu, Xu, Xu, Xu, Xu, Xu, Xu, Xu, Xu, Xu, Xu, Xu, Xu, Xu
Xu, Xu, Xu, Xu, Xu, Xu, Xu, Xu, Xu, Xu, Xu, Xu, Xu, Xu, Xu, Xu, Xu, Xu, Xu, Xu, Xu, Xu, Xu, Xu, Xu, Xu, Xu, Xu, Xu, Xu, Xu, Xu, Xu, Xu, Xu, Xu, Uu, Uu, Uu, Xu, Xu, Xu, Xu, Xu, Xu, Xu, Xu, Xu, Xu, Xu, Xu, Xu, Xu, Xu
Xu, Xu, Xu, Xu, Xu, Xu, Xu, Xu, Xu, Xu, Xu, Xu, Xu, Xu, Xu, Xu, Xu, Xu, Xu, Xu, Xu, Xu, Xu, Xu, Xu, Xu, Xu, Xu, Xu, Xu, Xu, Xu, Xu, Xu, Xu, Xu, Uu, Uu, Uu, Xu, Xu, Xu, Xu, Xu, Xu, Xu, Xu, Xu, Xu, Xu, Xu, Xu, Xu, Xu
Xu, Xu, Xu, Xu, Xu, Xu, Xu, Xu, Xu, Xu, Xu, Xu, Xu, Xu, Xu, Xu, Xu, Xu, Xu, Xu, Xu, Xu, Xu, Xu, Xu, Xu, Xu, Xu, Xu, Xu, Xu, Xu, Xu, Xu, Xu, Xu, Uu, Uu, Uu, Xu, Xu, Xu, Xu, Xu, Xu, Xu, Xu, Xu, Xu, Xu, Xu, Xu, Xu, Xu
Xu, Xu, Xu, Xu, Xu, Xu, Xu, Xu, Xu, Xu, Xu, Xu, Xu, Xu, Xu, Xu, Xu, Xu, Xu, Xu, Xu, Xu, Xu, Xu, Xu, Xu, Xu, Xu, Xu, Xu, Xu, Xu, Xu, Xu, Xu, Xu, Uu, Uu, Uu, Xu, Xu, Xu, Xu, Xu, Xu, Xu, Xu, Xu, Xu, Xu, Xu, Xu, Xu, Xu
Xu, Xu, Xu, Xu, Xu, Xu, Xu, Xu, Xu, Xu, Xu, Xu, Xu, Xu, Xu, Xu, Xu, Xu, Xu, Xu, Xu, Xu, Xu, Xu, Xu, Xu, Xu, Xu, Xu, Xu, Xu, Xu, Xu, Xu, Xu, Xu, Uu^Xo, Uu^Xo, Uu^Xo, Xu, Xu, Xu, Xu, Xu, Xu, Xu, Xu, Xu, Xu, Xu, Xu, Xu, Xu, Xu
Xu, Xu, Xu, Xu, Xu, Xu, Xu, Xu, Xu, Xu, Xu, Xu, Xu, Xu, Xu, Xu, Xu, Xu, Xu, Xu, Xu, Xu, Xu, Xu, Xu, Xu, Xu, Xu, Xu, Xu, Xu, Xu, Xu, Xu, Xu, Xu, Uu, Ur, Uu, Xu, Xu, Xu, Xu, Xu, Xu, Xu, Xu, Xu, Xu, Xu, Xu, Xu, Xu, Xu
Xu, Xu, Xu, Xu, Xu, Xu, Xu, Xu, Xu, Xu, Xu, Xu, Xu, Xu, Xu, Xu, Xu, Xu, Xu, Xu, Xu, Xu, Xu, Xu, Xu, Xu, Xu, Xu, Xu, Xu, Xu, Xu, Xu, Xu, Xu, Xu, Uu, Ur, Uu, Xu, Xu, Xu, Xu, Xu, Xu, Xu, Xu, Xu, Xu, Xu, Xu, Xu, Xu, Xu
Xu, Xu, Xu, Xu, Xu, Xu, Xu, Xu, Xu, Xu, Xu, Xu, Xu, Xu, Xu, Xu, Xu, Xu, Xu, Xu, Xu, Xu, Xu, Xu, Xu, Xu, Xu, Xu, Xu, Xu, Xu, Xu, Xu, Xu, Xu, Xu, Uu, Ur, Uu, Xu, Xu, Xu, Xu, Xu, Uh, Xu, Xu, Xu, Xu, Xu, Xu, Xu, Xu, Xu
Xu, Xu, Xu, Xu, Xu, Xu, Xu, Xu, Xu, Xu, Xu, Xu, Xu, Xu, Xu, Xu, Xu, Xu, Xu, Xu, Xu, Xu, Xu, Xu, Xu, Xu, Xu, Xu, Xu, Xu, Xu, Xu, Uh, Xu, Uu^Uf, Xu, Uu, Ur, Uu, Xu, Uh, Uh, Uh, Uh, Uh, Uh, Uh, Xu, Xu, Xu, Xu, Xu, Xu, Xu
Xu, Xu, Xu, Xu, Xu, Xu, Xu, Xu, Xu, Xu, Xu, Xu, Xu, Xu, Xu, Xu, Uu, Uu, Uu, Xu, Xu, Xu, Xu, Xu, Xu, Xu, Xu, Xu, Xu, Xu, Xu, Xu, Uh, Uu^Uf, Uu, Uu^Vud, Uu, Ur, Uu, Uu, Uu, Uu, Uu^Vud, Uu^Uf, Uu^Uf, Uu^Uf, Uh, Xu, Xu, Xu, Xu, Xu, Xu, Xu
Xu, Xu, Xu, Xu, Xu, Xu, Xu, Xu, Xu, Xu, Xu, Xu, Xu, Xu, Xu, Xu, Uu, Uu, Uu, Uu, Xu, Xu, Xu, Xu, Xu, Xu, Xu, Xu, Xu, Xu, Xu, Uh, Uu^Uf, Uh, Uu, Uu, Ur, Ur, Ce, Ce, Ce, Uu, Uu, Uu, Uu, Uu^Uf, Uh, Xu, Xu, Xu, Xu, Xu, Xu, Xu
Xu, Xu, Xu, Xu, Xu, Xu, Xu, Xu, Xu, Xu, Xu, Xu, Xu, Xu, Xu, Xu, Xu, Uu, Uu, Uu, Uu, Xu, Xu, Xu, Xu, Xu, Xu, Xu, Xu, Xu, Xu, Uu^Uf, Uu, Uu, Ur, Ur, Uu, Uu, Ce, 2 Ke, Ce, Uu, Uu, Uh, Uh, Uu, Uu, Uu, Uu^Uf, Xu, Xu, Xu, Xu, Xu
Xu, Xu, Xu, Xu, Xu, Xu, Xu, Xu, Xu, Xu, Xu, Xu, Xu, Xu, Xu, Xu, Xu, Uu, Uu, Uu, Uu, Xu, Xu, Xu, Xu, Xu, Xu, Xu, Xu, Xu, Uu, Uu, Uu, Uu, Ur, Uu^Vud, Uu, Uu, Uu, Ce, Uu, Uu, Uu^Uf, Uh, Uu^Uf, Uu, Uu, Uu, Uu^Uf, Uh, Uh, Xu, Xu, Xu
Xu, Xu, Xu, Xu, Xu, Xu, Xu, Xu, Xu, Xu, Xu, Xu, Xu, Xu, Xu, Xu, Xu, Uu, Uu, Uu, Uu, Xu, Xu, Xu, Xu, Xu, Xu, Xu, Uh, Uh, Uu^Vud, Uu, Uu, Uu, Ur, Uu, Uu^Ii, Uu^Ii, Uu^Ii, Uu, Uu^Vud, Uu, Uu, Uu^Uf, Uu, Uu, Uu^Vud, Uu, Uu^Uf, Uu^Uf, Uh, Xu, Xu, Xu
Xu, Xu, Xu, Xu, Xu, Xu, Xu, Xu, Xu, Xu, Xu, Xu, Xu, Xu, Xu, Xu, Xu, Uu, Uu, Uu, Uu, Uu, Uu, Xu, Xu, Xu, Uu^Uf, Uu^Uf, Uu, Uu, Uu^Ii, Uu^Ii, Uu^Ii, Uu, Ur, Uu, Uu^Ii, Ql^Ii, Ql^Ii, Uu^Ii, Uu, Uu, Uu^Ii, Uu^Ii, Uu^Ii, Uu, Uu, Uu, Uu, Uu^Uf, Uu^Uf, Xu, Xu, Xu
Xu, Xu, Xu, Xu, Xu, Xu, Xu, Xu, Xu, Xu, Xu, Xu, Xu, Xu, Xu, Xu, Xu, Xu, Xu, Uu, Uu, Uu, Uu^Xo, Uu^Xo, Uh, Xu, Uh, Uu, Ce, Uu^Ii, Ql^Ii, Ql^Ii, Ql^Ii, Uu^Ii, Ur^Ii, Uu^Ii, Ql^Ii, Ql^Ii, Ql^Ii, Uu^Ii, Uu^Ii, Uu^Ii, Ql^Ii, Ql^Ii, Uu^Ii, Uu, Uu^Ii, Uu^Ii, Uu^Ii, Uu^Uf, Uu, Xu, Xu, Xu
Xu, Xu, Xu, Xu, Xu, Xu, Xu, Xu, Xu, Xu, Xu, Xu, Xu, Xu, Xu, Xu, Xu, Xu, Xu, Xu, Xu, Uu^Xo, Uh, Ur, Ur, Uh, Uu, Ce, 3 Ke, Ce^Ii, Ql^Ii, Xu, Ql^Ii, Uu^Vud, Ur, Uu^Ii, Ql^Ii, Ql^Ii, Uu^Ii, Uu^Ii, Ql^Ii, Uu^Ii, Ql^Ii, Ql^Ii, Uu^Ii, Uu^Ii, Ql^Ii, Ql^Ii, Uu^Ii, Uu, Uu, Xu, Xu, Xu
Xu, Xu, Xu, Xu, Xu, Xu, Xu, Xu, Xu, Xu, Xu, Xu, Xu, Xu, Xu, Xu, Xu, Xu, Xu, Xu, Xu, Xu, Xu, Uh, Xu, Ur, Ur, Ce, Ce, Ce^Ii, Uu^Ii, Ql^Ii, Ql^Ii, Uu^Ii, Ur^Ii, Uu^Ii, Uu^Ii, Ql^Ii, Ql^Ii, Uu^Ii, Uu^Ii, Uu^Ii, Uu^Ii, Ql^Ii, Ql^Ii, Ql^Ii, Ql^Ii, Ql^Ii, Uu^Ii, Uu, Xu, Xu, Uu^Xo, Uu^Xo
Xu, Xu, Xu, Xu, Xu, Xu, Xu, Xu, Xu, Xu, Xu, Xu, Xu, Xu, Xu, Xu, Xu, Xu, Xu, Xu, Xu, Xu, Xu, Xu, Xu, Uh, Uh, Ur, Ur, Uu, Uu^Ii, Uu^Ii, Uu^Ii, Uu^Ii, Ur, Uu^Ii, Uu^Ii, Ql^Ii, Ql^Ii, Ql^Ii, Uu^Ii, Uu^Ii, Uu^Ii, Ql^Ii, Uu^Ii, Ql^Ii, Uu^Ii, Uu^Ii, Uu, Uu, Uu, Uu, Uu^Xo, Uu^Xo
Xu, Xu, Xu, Xu, Xu, Xu, Xu, Xu, Xu, Xu, Xu, Xu, Xu, Xu, Xu, Xu, Xu, Xu, Xu, Xu, Xu, Xu, Xu, Xu, Xu, Xu, Uh, Uu^Uf, Uu^Uf, Ur, Ur, Ur^Ii, Ur^Ii, Ur, Uu^Ii, Ur^Ii, Ur^Ii, Uu^Ii, Uu^Ii, Uu^Ii, Uh, Uh, Uu^Uf, Uu^Ii, Uu, Uu^Ii, Uu, Uu, Uu, Uu, Ur, Ur, Uu, Uu^Xo
Xu, Xu, Xu, Xu, Xu, Xu, Xu, Xu, Xu, Xu, Xu, Xu, Xu, Xu, Xu, Xu, Xu, Xu, Xu, Xu, Xu, Xu, Xu, Xu, Xu, Xu, Xu, Uu^Uf, Uu^Uf, Uu, Uu, Uu, Uu^Ii, Ql^Ii, Ql^Ii, Uu^Ii, Ur, Uu^Vud, Uu^Ii, Uu^Uf, Uu^Uf, Uh, Uu^Uf, Uu, Ur, Uu, Ur, Ur, Ur, Ur, Uu, Uu, Uh, Xu
Xu, Xu, Xu, Xu, Xu, Xu, Xu, Xu, Xu, Xu, Xu, Xu, Xu, Xu, Xu, Xu, Xu, Xu, Xu, Xu, Xu, Xu, Xu, Xu, Xu, Xu, Xu, Xu, Xu, Uu^Vud, Uu^Ii, Uu^Ii, Ql^Ii, Ql^Ii, Uu^Ii, Uu^Ii, Uu^Ii, Ur, Cud^Ii, Uu, Uu, Uu, Ur, Ur, Uu, Ur, Uu, Uu^Vud, Uu, Uu, Uu, Uh, Xu, Xu
Xu, Xu, Xu, Xu, Xu, Xu, Xu, Xu, Xu, Xu, Xu, Xu, Xu, Xu, Xu, Xu, Xu, Xu, Xu, Xu, Xu, Xu, Xu, Xu, Xu, Xu, Xu, Xu, Xu, Uu, Uu^Ii, Ql^Ii, Ql^Ii, Ql^Ii, Cud^Ii, Uu, Cud, Cud^Ii, Qlf^Ii, Cud^Ii, Cud, Ur, Cud, Uu, Uu, Uu, Uu^Ii, Uu, Uu, Uu, Uu, Xu, Xu, Xu
Xu, Xu, Xu, Xu, Xu, Xu, Xu, Xu, Xu, Xu, Xu, Xu, Xu, Xu, Xu, Xu, Xu, Xu, Xu, Xu, Xu, Xu, Xu, Xu, Xu, Xu, Xu, Xu, Xu, Uu, Uu^Ii, Ql^Ii, Ql^Ii, Cud^Ii, Urb, Urb, Uu^Vud, Cud^Ii, Cud^Ii, Cud^Ii, Uu^Vud, Urb, Urb, Cud, Uu, Uu^Ii, Ql^Ii, Uu^Ii, Uu^Ii, Uu, Uu, Xu, Xu, Xu
Xu, Xu, Xu, Xu, Xu, Xu, Xu, Xu, Uu, Xu, Xu, Xu, Xu, Xu, Xu, Xu, Xu, Xu, Xu, Xu, Xu, Xu, Xu, Xu, Xu, Xu, Xu, Xu, Uu, Uu, Uu, Uu^Ii, Uu^Ii, Cud^Ii, Urb, Uu^Vud, Urb^Ii, Urb^Ii, Kud^Ii, Urb^Ii, Urb^Ii, Uu^Vud, Urb, Cud, Uu, Uu^Ii, Ql^Ii, Ql^Ii, Ql^Ii, Uu^Ii, Uu, Xu, Xu, Xu
Xu, Xu, Xu, Xu, Xu, Xu, Xu, Uu, Uu, Uu, Xu, Xu, Xu, Xu, Xu, Xu, Xu, Xu, Xu, Xu, Xu, Xu, Xu, Xu, Xu, Xu, Xu, Xu, Uu, Uu, Uu, Uu, Uu, Uu, Cud, Uu^Vud, Urb^Ii, Qlf^Ii, Qlf^Ii, Qlf^Ii, Urb^Ii, Uu^Vud, Cud, Uu, Uu, Uu^Ii, Uu^Ii, Ql^Ii, Ql^Ii, Uu^Ii, Uu, Xu, Xu, Xu
Xu, Xu, Xu, Xu, Xu, Xu, Xu, Uu, Uu, Uu, Uu, Xu, Xu, Xu, Xu, Xu, Xu, Xu, Xu, Xu, Xu, Xu, Uu^Uf, Xu, Uu^Uf, Xu, Xu, Xu, Uu, Uu, Uu, Uu, Ur, Ur, Cud^Ii, Cud^Ii, Cud^Ii, Kud^Ii, Qlf^Ii, Kud^Ii, Cud^Ii, Cud^Ii, Cud^Ii, Uu, Uu^Ii, Uu, Ql^Ii, Ql^Ii, Uu^Ii, Uu^Ii, Uu, Xu, Xu, Xu
Xu, Xu, Xu, Xu, Xu, Xu, Xu, Uu, Uu, Uu, Uu, Xu, Xu, Xu, Xu, Xu, Xu, Xu, Xu, Xu, Xu, Xu, Uh, Uu^Uf, Uu, Xu, Xu, Xu, Uu, Uu, Ur, Ur, Uu, Uu, Cud^Ii, Qlf^Ii, Cud^Ii, Urb^Ii, Urb^Ii, Urb^Ii, Cud^Ii, Qlf^Ii, Cud^Ii, Uu^Ii, Uu, Uu^Ii, Ql^Ii, Ql^Ii, Uu, Uu, Uu, Xu, Xu, Xu
Xu, Xu, Xu, Xu, Xu, Xu, Xu, Xu, Uu, Uu, Uu, Xu, Xu, Xu, Xu, Xu, Xu, Xu, Xu, Xu, Uu^Uf, Uh, Uu, Uu, Xu, Uu, Uu, Uu, Uu, Uu, Ur, Uu, Uu^Ii, Uu^Ii, Uu, Cud^Ii, Cud, Uu^Vud, Uu^Vud, Uu^Vud, Cud^Ii, Cud^Ii, Uu, Uu^Ii, Uu^Ii, Uu^Ii, Uu^Ii, Uu^Ii, Uu, Uu, Xu, Xu, Xu, Xu
Xu, Xu, Xu, Xu, Xu, Xu, Xu, Xu, Uu^Xo, Uu^Xo, Uu^Xo, Xu, Xu, Xu, Xu, Xu, Xu, Xu, Uh, Uu^Uf, Xu, Xu, Uu, Uu, Ur, Ur, Ur, Uu, Ur, Ur, Uu, Uu^Ii, Ql^Ii, Uu^Ii, Uu^Ii, Uu^Ii, Uu, Urb, Urb, Urb, Uu, Uu^Ii, Uu^Ii, Uu^Ii, Ql^Ii, Uu^Ii, Uu^Ii, Uu, Uu, Uh, Xu, Xu, Xu, Xu
Xu, Xu, Xu, Xu, Xu, Xu, Xu, Xu, Xu, Ur, Uu, Xu, Xu, Xu, Xu, Xu, Xu, Xu, Uh, Xu, Uu^Vud, Uu, Ur, Ur, Uu, Uu, Uu, Ur, Uu, Uu, Uu, Uu^Ii, Ql^Ii, Ql^Ii, Ql^Ii, Uu^Ii, Uu, Cud, Cud, Cud, Uu, Uu^Ii, Ql^Ii, Ql^Ii, Ql^Ii, Ql^Ii, Uu^Ii, Uu, Uu, Uh, Xu, Xu, Xu, Xu
Uu^Uf, Xu, Xu, Xu, Xu, Xu, Xu, Xu, Xu, Ur, Ur, Xu, Xu, Xu, Xu, Xu, Xu, Xu, Uu^Uf, Xu, Ur, Ur, Uu, Uu, Xu, Xu, Uu, Uu^Vud, Uu, Uu, Uu, Uu^Ii, Ql^Ii, Xu, Ql^Ii, Uu^Ii, Uu, Uu, Ur, Uu, Uu^Ii, Uu^Ii, Ql^Ii, Xu, Xu, Ql^Ii, Uu^Ii, Uu, Uu, Xu, Xu, Xu, Xu, Xu
Uu, Uu^Uf, Xu, Xu, Xu, Xu, Xu, Xu, Xu, Uu, Ur, Uu, Uh, Xu, Xu, Xu, Xu, Uh, Uu, Ur, Uu, Uu, Xu, Uu, Uu, Uu, Xu, Xu, Uu, Uu, Uu, Uu^Ii, Ql^Ii, Xu, Ql^Ii, Uu^Ii, Uu^Ii, Uu, Ur, Uu, Uu^Ii, Ql^Ii, Ql^Ii, Xu, Ql^Ii, Ql^Ii, Uu^Ii, Uu, Uh, Uh, Xu, Xu, Xu, Xu
Ur, Uu^Uf, Uu, Xu, Xu, Xu, Xu, Uu^Uf, Uu^Uf, Ur, Uu^Uf, Uu, Uu, Uh, Xu, Xu, Xu, Uh, Uu, Ur, Uu, Xu, Uu, Uu, Xu, Xu, Xu, Xu, Uu, Uu, Uu, Uu^Ii, Uu^Ii, Ql^Ii, Ql^Ii, Ql^Ii, Ql^Ii, Uu^Ii, Uu, Ur, Uu^Ii, Ql^Ii, Ql^Ii, Ql^Ii, Uu^Ii, Uu^Ii, Uu, Uu, Uh, Uh, Xu, Xu, Xu, Xu
Uh, Ur, Ur, Uu, Uh, Xu, Uh, Uu^Uf, Uu, Ur, Uu^Uf, Uu^Uf, Ur, Uu^Uf, Uu^Uf, Uh, Uu, Uu, Ur, Ur, Uu, Uu, Xu, Xu, Xu, Xu, Xu, Xu, Uu^Ii, Uu, Uu, Uu, Uu, Uu^Ii, Uu^Ii, Ql^Ii, Uu^Ii, Uu^Ii, Uu, Ur, Uu, Uu^Ii, Uu^Ii, Uu^Ii, Uu, Uu^Uf, Uu^Uf, Uu, Uh, Uh, Xu, Xu, Xu, Xu
Uh, Uh, Uu^Vu, Ur, Ur, Uh, Uu, Uu, Ur, Ur, Ur, Ur, Uu, Ur, Ur, Ur, Ur, Ur, Uu, Uu, Xu, Xu, Xu, Xu, Xu, Xu, Xu, Xu, Ql^Ii, Uu^Ii, Uu^Ii, Uu^Vud, Uu, Uu, Uu, Uu^Ii, Uu, Uu, Uu, Ur, Ur, Uu, Uu, Uu, Uu, Uu^Uf, Uu, Uu, Uu, Uh, Xu, Xu, Xu, Xu
Xu, Xu, Xu, Uu, Ur, Uu, Ur, Ur, Uh, Uu^Vu, Xu, Xu, Xu, Uu, Uu^Uf, Uu^Vud, Uu^Uf, Uu^Uf, Xu, Xu, Xu, Xu, Xu, Xu, Xu, Xu, Xu, Ql^Ii, Ql^Ii, Uu^Ii, Uu^Ii, Uu, Uu^Ii, Uu, Uu, Uu, Uu, Uu, Uu^Uf, Uu, Uu, Ur, Ur, Uu, Ur, Uu, Ur, Ur, Ur, Uu, Uu, Xu, Xu, Xu
Xu, Xu, Xu, Uu, Uu, Ur, Uu, Uh, Xu, Xu, Xu, Xu, Xu, Xu, Xu, Xu, Xu, Xu, Xu, Xu, Xu, Xu, Xu, Xu, Xu, Xu, Xu, Ql^Ii, Ql^Ii, Uu^Ii, Ql^Ii, Uu^Ii, Uu^Ii, Uu^Ii, Uu^Ii, Uu, Uu, Uu^Uf, Uu^Uf, Uh, Uu^Vud, Uu, Uu, Ur, Ce, Ur, Uu, Uu^Vud, Uu, Ur, Ur, Uu, Uu, Xu
Xu, Xu, Xu, Ce, Ce, Ce, Ce, Ce, Xu, Xu, Xu, Xu, Xu, Xu, Xu, Xu, Xu, Xu, Xu, Xu, Xu, Xu, Xu, Xu, Xu, Xu, Xu, Xu, Xu, Ql^Ii, Ql^Ii, Ql^Ii, Uu^Ii, Uu^Ii, Uu^Ii, Uu, Uu, Uu, Uu, Uu, Uu, Uu, Uu, Ce, 4 Ke, Ce, Uu, Uu, Xu, Uu, Uu, Ur, Uu, Xu
Xu, Xu, Xu, Uu, Ce, 1 Ke, Ce, Uu, Xu, Xu, Xu, Xu, Xu, Xu, Xu, Xu, Xu, Xu, Xu, Xu, Xu, Xu, Xu, Xu, Xu, Xu, Xu, Xu, Xu, Xu, Ql^Ii, Ql^Ii, Ql^Ii, Ql^Ii, Ql^Ii, Uu^Ii, Uu^Ii, Uu, Uu, Uu, Uu, Uu, Uu, Ce, Ce, Ce, Uu, Uh, Uh, Xu, Uu, Ur, Uu^Xo, Uu^Xo
Xu, Xu, Xu, Uh, Uh, Ce, Uu, Uu, Xu, Xu, Xu, Xu, Xu, Xu, Xu, Xu, Xu, Xu, Xu, Xu, Xu, Xu, Xu, Xu, Xu, Xu, Xu, Xu, Xu, Xu, Ql^Ii, Ql^Ii, Ql^Ii, Ql^Ii, Xu, Uu^Ii, Uu^Ii, Uu, Uh, Uu, Uh, Uu^Vud, Uh, Uu, Uu, Uu, Uh, Uh, Uh, Xu, Xu, Uu, Uu^Xo, Uu
Xu, Xu, Xu, Uu^Uf, Uh, Ur, Uu, Uu^Vu, Xu, Xu, Xu, Xu, Xu, Xu, Xu, Xu, Xu, Xu, Xu, Xu, Xu, Xu, Xu, Xu, Xu, Xu, Xu, Xu, Xu, Xu, Xu, Ql^Ii, Xu, Xu, Xu, Xu, Uh, Uh, Uh, Uh, Uh, Uh, Uh, Uh, Uh, Uh, Uh, Uh, Xu, Xu, Xu, Xu, Xu, Uu
Xu, Xu, Xu, Uh, Uu, Uu, Uu, Uh, Qxu, Xu, Xu, Xu, Xu, Xu, Xu, Xu, Xu, Xu, Xu, Xu, Xu, Xu, Xu, Xu, Xu, Xu, Xu, Xu, Xu, Xu, Xu, Xu, Xu, Xu, Xu, Xu, Xu, Xu, Xu, Xu, Xu, Xu, Xu, Uh, Xu, Uh, Xu, Xu, Xu, Xu, Xu, Xu, Xu, Xu
Xu, Xu, Qxu, Wwg, Uh, Ur, Uh, Uh, Qxu, Qxu, Xu, Xu, Xu, Xu, Xu, Xu, Xu, Xu, Xu, Xu, Xu, Xu, Xu, Xu, Xu, Xu, Xu, Xu, Xu, Xu, Xu, Xu, Xu, Xu, Xu, Xu, Xu, Xu, Xu, Xu, Xu, Xu, Xu, Xu, Xu, Xu, Xu, Xu, Xu, Xu, Xu, Xu, Xu, Xu
Xu, Qxu, Qxu, Wwg, Uh, Wwg, Uh, Wwg, Qxu, Qxu, Xu, Xu, Xu, Xu, Xu, Xu, Xu, Xu, Xu, Xu, Xu, Xu, Xu, Xu, Xu, Xu, Xu, Xu, Xu, Xu, Xu, Xu, Xu, Xu, Xu, Xu, Xu, Xu, Xu, Xu, Xu, Xu, Xu, Xu, Xu, Xu, Xu, Xu, Xu, Xu, Xu, Xu, Xu, Xu
