Gg, Gg, Gg, Hh, Hh, Hh, Hh, Gg, Gs, Hh, Mm, Mm, Mm, Mm, Mm, Mm, Mm, Mm, Mm, Mm, Mm, Mm, Mm, Mm, Mm, Mm, Mm, Mm, Mm, Mm, Mm, Mm, Mm, Mm, Mm, Mm, Mm, Mm, Mm, Mm, Mm, Mm, Mm, Mm, Mm, Mm, Mm, Mm, Mm, Mm, Mm
Gg, Gs, Gs^Es, Gg, Hh, Hh, Gg, Gs, Gg, Hh, Hh, Mm, Mm, Mm, Mm, Mm, Mm, Mm, Mm, Mm, Mm, Mm, Mm, Mm, Mm, Mm, Mm, Mm, Mm, Mm, Mm, Mm, Mm, Mm, Mm, Mm, Mm, Mm, Mm, Mm, Mm, Mm, Mm, Mm, Mm, Mm, Mm, Mm, Mm, Mm, Mm
Hh, Gg, Gg^Es, Gg, Gg, Hh, Gs, Gs^Es, Gg, Hh, Uu^Vud, Mm, Hh, Mm, Mm, Mm, Mm, Mm, Mm, Mm, Mm, Mm, Mm, Mm, Mm, Mm, Mm, Mm, Mm, Mm, Mm, Mm, Mm, Mm, Mm, Mm, Mm, Mm, Mm, Mm, Mm, Mm, Mm, Mm, Mm, Mm, Mm, Mm, Mm, Mm, Mm
Mm, Hh, Gg, Gs, Gs, Gg, Gg^Es, Gs, Gg, Gs, Gg, Hh, Hh, Mm, Mm, Mm, Mm, Mm, Mm, Mm, Mm, Mm, Mm, Mm, Mm, Mm, Mm, Mm, Mm, Mm, Hh, Hh, Hh, Hh, Mm, Mm, Mm, Mm, Mm, Mm, Mm, Mm, Mm, Mm, Mm, Mm, Mm, Mm, Mm, Mm, Mm
Mm, Hh, Hh, Gg, Gg, Gg, Gs^Es, Gg, Hh, Gg, Hh, Gg, Gs, Hh, Hh, Hh, Hh, Hh, Hh, Mm, Hh, Hh, Hh, Mm, Hh, Mm, Hh, Hh, Hh, Hh, Gg, Hh, Gg, Hh, Mm, Mm, Mm, Mm, Mm, Mm, Hh, Uu^Vud, Hh, Mm, Hh, Mm, Mm, Mm, Mm, Mm, Mm
Mm, Mm, Hh, Hh, Hh, Gg, Gg, Gg, Gg, Hh, Hh, Gg, Gs, Gg^Es, Gs, Gs, Gs, Hh, Gg, Hh, Gg, Gs, Gg, Hh, Hh, Hh, Gs, Gs, Gg, Gg^Es, Gs, Gg^Es, Gg, Hh, Hh, Mm, Hh, Mm, Hh, Hh, Gg^Es, Gs^Es, Gs, Hh, Hh, Mm, Mm, Mm, Mm, Mm, Mm
Mm, Mm, Mm, Mm, Mm, Hh, Hh, Gs, Gs, Hh, Hh, Hh, Gg, Gg^Es, Gg, Gg, Hh, Gg, Gs, Gs^Es, Gs, Gg^Es, Gg^Es, Gs, Gg, Gg, Hh, Gg, Hh, Gg, Gg, Gs^Es, Gs, Gg, Gs, Hh, Gg, Hh, Gs, Gg, Rb, Gg^Es, Gs^Es, Gg, Hh, Mm, Mm, Mm, Mm, Mm, Mm
Mm, Mm, Mm, Mm, Mm, Mm, Mm, Hh, Gg, Gg, Gg, Gg, Gs, Gg, Hh, Hh, Hh, Hh, Hh, Gg^Es, Gg, Gs, Gg, Gs, Hh, Hh, Mm, Hh, Mm, Hh, Hh, Uu^Vud, Hh, Gg, Gg^Es, Gs, Gg, Gg, Rb, Rb, Rb, Rb, Rb, Gs, Hh, Mm, Mm, Mm, Mm, Mm, Mm
Mm, Mm, Mm, Mm, Mm, Mm, Mm, Hh, Gg, Gg, Gs, Gs^Es, Gg, Hh, Mm, Mm, Mm, Hh, Mm, Hh, Gs^Es, Gs, Hh, Hh, Mm, Mm, Mm, Mm, Mm, Mm, Mm, Mm, Mm, Hh, Hh, Hh, Hh, Gs^Es, Rb, Rb, Rb, Rb, Rb, Rb, Gs, Hh, Mm, Mm, Mm, Mm, Mm
Mm, Mm, Mm, Mm, Mm, Mm, Mm, Hh, Gs, Gs^Es, Gg^Es, Gs, Gg, Hh, Mm, Mm, Mm, Mm, Hh, Hh, Gs, Gg, Hh, Mm, Mm, Mm, Mm, Mm, Mm, Mm, Mm, Mm, Mm, Mm, Mm, Mm, Hh, Gs^Es, Rb, Rb, Rb, Rb, Rb, Rb, Gs^Es, Hh, Mm, Mm, Mm, Mm, Mm
Mm, Mm, Mm, Mm, Mm, Mm, Hh, Hh, Gg, Gg, Gs^Es, Gg, Gg, Hh, Mm, Mm, Hh, Hh, Gs, Gg, Gg^Es, Gs, Gg, Hh, Mm, Mm, Hh, Hh, Hh, Hh, Hh, Mm, Mm, Mm, Mm, Mm, Hh, Gg, Gg, Rb, Rb, Rb, Rb, Gs, Hh, Hh, Mm, Mm, Mm, Mm, Mm
Mm, Mm, Mm, Mm, Mm, Mm, Mm, Hh, Hh, Gg, Gg, Gs, Gg, Uu^Vud, Hh, Hh, Hh, Gs, Gs^Es, Gs, Gs, Gg^Es, Gg, Hh, Uu^Vud, Hh, Gg, Gg, Gg, Gg, Gs, Hh, Hh, Mm, Mm, Mm, Hh, Gs^Es, Gs, Rb, Rb, Rb, Gg, Hh, Mm, Mm, Mm, Mm, Mm, Mm, Mm
Mm, Mm, Mm, Mm, Mm, Mm, Mm, Mm, Hh, Gg, Gg^Es, Gs, Gs^Es, Gs, Gg, Gg, Gg, Gs^Es, Gg, Gg, Gg, Gs, Gs^Es, Gg, Gs, Gs, Gs, Gs^Es, Gs, Gg, Rb, Gg, Rb, Hh, Hh, Mm, Hh, Gg^Es, Gs, Rb, Rb, Gs, Gg^Es, Hh, Mm, Mm, Mm, Mm, Mm, Mm, Mm
Mm, Mm, Mm, Mm, Mm, Mm, Mm, Mm, Hh, Gs, Gs, Gs, Gg^Es, Gs, Gs, Gg, Hh, Hh, Hh, Hh, Hh, Gg, Gs, Gs, Rb, Rb, Rb, Rb, Rb, Rb, Gs^Es, Rb, Gs, Rb, Rb, Uu^Vud, Gg, Gg^Es, Rb, Rb, Gg, Gs, Gg, Hh, Mm, Mm, Mm, Mm, Mm, Mm, Mm
Mm, Mm, Mm, Mm, Mm, Mm, Mm, Mm, Hh, Gg, Gg^Es, Gs, Gg, Gg, Hh, Hh, Mm, Mm, Mm, Mm, Hh, Gg, Gs^Es, Rb, Gg, Gs^Es, Gs^Es, Gg, Gg, Gs, Gs^Es, Gg, Hh, Gs^Es, Rb, Rb, Rb, Rb, Rb, Rb, Gs, Gg^Es, Gg^Es, Hh, Hh, Mm, Mm, Mm, Mm, Mm, Mm
Mm, Mm, Mm, Mm, Mm, Mm, Mm, Uu^Vud, Gg, Gg, Gs^Es, Gs^Es, Gg, Gs, Hh, Mm, Mm, Mm, Mm, Mm, Hh, Gg, Rb, Rb, Uu^Vud, Gg, Hh, Gg, Hh, Hh, Uu^Vud, Hh, Mm, Hh, Rb, Rb, Rb, Rb, Gg, Gg, Gg^Es, Gg, Gs, Gg, Gg, Hh, Mm, Mm, Mm, Mm, Mm
Mm, Mm, Mm, Mm, Mm, Mm, Hh, Hh, Gg^Es, Gs^Es, Gg, Gg, Gg, Hh, Mm, Mm, Mm, Mm, Hh, Hh, Rb, Rb, Hh, Hh, Mm, Hh, Cud, Cud, Cud, Mm, Mm, Mm, Hh, Hh, Rb, Rb, Gg, Gs^Es, Gg^Es, Gs, Gs, Gg^Es, Gg, Gg, Gg, Hh, Hh, Mm, Mm, Mm, Mm
Mm, Mm, Mm, Mm, Mm, Mm, Hh, Gs, Gs^Es, Gg, Hh, Hh, Hh, Hh, Mm, Mm, Hh, Hh, Gs^Es, Gg, Rb, Hh, Mm, Mm, Mm, Mm, Mm, 7 Kud, Mm, Mm, Mm, Hh, Rb, Rb, Hh, Hh, Hh, Gs, Hh, Gg, Gg, Gs, Gs, Gg, Gg^Es, Gg, Gs, Hh, Hh, Mm, Mm
Mm, Mm, Mm, Mm, Mm, Hh, Gs, Gs, Hh, Hh, Hh, Hh, Hh, Mm, Mm, Mm, Hh, Gs^Es, Rb, Rb, Gs, Hh, Mm, Mm, Hh, Mm, Mm, Cud, Mm, Mm, Hh, Hh, Rb, Hh, Mm, Mm, Mm, Hh, Mm, Hh, Hh, Gg, Gg, Gs^Es, Gs, Gg, Gg, Gg, Hh, Mm, Hh
Mm, Mm, Mm, Mm, Mm, Hh, Gg, Hh, Mm, Mm, Hh, Uu^Vud, Hh, Mm, Hh, Hh, Rb, Rb, Hh, Rb, Rb, Hh, Hh, Hh, Gs, Hh, Hh, Hh, Hh, Hh, Rb, Rb, Rb, Hh, Hh, Mm, Mm, Mm, Mm, Mm, Hh, Gg, Gs^Es, Gs, Gs, Gg^Es, Gg, Gs^Es, Hh, Hh, Hh
Mm, Mm, Mm, Mm, Mm, Hh, Gs^Es, Hh, Mm, Mm, Mm, Hh, Hh, Hh, Rb, Rb, Uu^Vud, Hh, Mm, Hh, Hh, Rb, Rb, Gs^Es, Rb, Rb, Rb, Rb, Rb, Rb, Rb, Rb, Rb, Rb, Rb, Hh, Uu^Vud, Mm, Mm, Mm, Hh, Gg, Gs^Es, Gg, Gs, Gs^Es, Gs^Es, Gs, Hh, Hh, Hh
Mm, Mm, Mm, Mm, Mm, Hh, Gs^Es, Hh, Hh, Mm, Mm, Hh, Hh, Rb, Hh, Hh, Mm, Mm, Mm, Mm, Hh, Rb, Rb, Rb, Hh, Hh, Hh, Hh, Hh, Hh, Hh, Hh, Hh, Rb, Rb, Gs^Es, Hh, Mm, Mm, Mm, Hh, Gg, Gs, Gg^Es, Gg, Gg^Es, Gs, Gg, Gg, Hh, Mm
Mm, Mm, Mm, Mm, Mm, Hh, Hh, Gs, Hh, Mm, Hh, Hh, Rb, Rb, Cud, Cud, Mm, Mm, Mm, Hh, Rb, Rb, Hh, Hh, Mm, Mm, Mm, Mm, Mm, Mm, Mm, Mm, Mm, Hh, Gs^Es, Rb, Rb, Hh, Mm, Mm, Uu^Vud, Gg, Gg, Gs, Gg, Gg^Es, Gg, Gg, Hh, Hh, Mm
Mm, Mm, Mm, Mm, Mm, Mm, Hh, Gg, Gg^Es, Hh, Rb, Rb, Hh, Hh, Cud, 5 Kud, Cud, Mm, Hh, Hh, Rb, Hh, Mm, Mm, Mm, Uu^Vud, Mm, Mm, Mm, Mm, Uu^Vud, Mm, Mm, Hh, Hh, Rb, Rb, Hh, Mm, Mm, Mm, Hh, Gs, Gs^Es, Gs, Gg, Gs, Uu^Vud, Mm, Mm, Mm
Mm, Mm, Mm, Mm, Mm, Mm, Hh, Hh, Gg^Es, Gs, Rb, Hh, Mm, Mm, Mm, Mm, Hh, Hh, Rb, Rb, Hh, Hh, Mm, Mm, Mm, Mm, Mm^Xm, Mm, Mm^Xm, Mm, Mm, Mm, Mm, Mm, Hh, Rb, Hh, Hh, Mm, Cud, Cud, Hh, Gg^Es, Gs, Gg, Gs^Es, Gs, Hh, Mm, Mm, Mm
Mm, Mm, Mm, Mm, Mm, Mm, Hh, Gg, Rb, Rb, Gg^Es, Hh, Mm, Mm, Mm, Mm, Hh, Rb, Hh, Hh, Mm, Mm, Mm, Mm, Mm, Mm^Xm, Mm^Xm, Mm^Xm, Mm^Xm, Mm^Xm, Mm, Mm, Mm, Hh, Rb, Rb, Hh, Mm, Cud, 6 Kud, Cud, Hh, Gg, Gs, Gs, Gg, Hh, Hh, Mm, Mm, Mm
Mm, Mm, Mm, Mm, Mm, Hh, Hh, Rb, Rb, Rb, Rb, Hh, Mm, Mm, Mm, Uu^Vud, Rb, Rb, Hh, Mm, Mm, Mm, Mm, Mm, Mm, Mm^Xm, Mm^Xm, Mm^Xm, Mm^Xm, Mm^Xm, Mm, Mm, Mm, Hh, Rb, Rb, Hh, Mm, Mm, Mm, Mm, Hh, Gs, Gs^Es, Gg, Gg^Es, Hh, Mm, Mm, Mm, Mm
Mm, Mm, Mm, Mm, Mm, Hh, Rb, Rb, Hh, Rb, Rb, Hh, Hh, Mm, Mm, Hh, Rb, Hh, Mm, Mm, Mm, Mm, Mm, Mm, Mm, Mm^Xm, Mm^Xm, Mm^Xm, Mm^Xm, Mm^Xm, Mm, Mm, Mm, Hh, Hh, Rb, Rb, Hh, Hh, Mm, Hh, Hh, Gs, Gg, Gg, Hh, Mm, Mm, Mm, Mm, Mm
Mm, Mm, Mm, Mm, Hh, Uu^Vud, Rb, Hh, Mm, Hh, Hh, Rb, Rb, Hh, Hh, Hh, Rb, Hh, Hh, Mm, Hh, Mm, Mm, Uu^Vud, Mm, Cud, Mm, Kud, Mm, Cud, Mm, Mm, Mm, Mm, Hh, Rb, Rb, Rb, Rb, Hh, Uu^Vud, Hh, Gg, Gs^Es, Rb, Hh, Cud, Cud, Wo, Mm, Mm
Mm, Mm, Mm, Hh, Gs, Rb, Rb, Hh, Mm, Mm, Mm, Hh, Hh, Rb, Rb, Rb, Rb, Gg, Gs, Hh, Gg, Hh, Mm, Mm, Mm, Cud, Cud, Cud, Cud, Cud, Mm, Uu^Vud, Mm, Hh, Rb, Rb, Hh, Hh, Hh, Rb, Rb, Rb, Rb, Rb, Rb, Rb, Cud, Wo, Wo, Mm, Mm
Mm, Mm, Mm, Hh, Gs^Es, Rb, Rb, Hh, Hh, Mm, Mm, Mm, Mm, Hh, Gg, Gs, Gs, Rb, Gs, Gg, Rb, Hh, Hh, Mm, Hh, Mm, Mm, Mm, Mm, Mm, Mm, Mm, Hh, Hh, Rb, Rb, Hh, Mm, Mm, Hh, Hh, Rb, Rb, Rb, Rb, Hh, Cud, Wo, Wo, Mm, Mm
Mm, Mm, Mm, Hh, Gs^Es, Rb, Rb, Rb, Hh, Hh, Mm, Mm, Mm, Uu^Vud, Hh, Gg, Gg, Rb, Rb, Rb, Hh, Rb, Rb, Hh, Rb, Hh, Hh, Mm, Hh, Mm, Hh, Hh, Rb, Rb, Rb, Hh, Mm, Mm, Mm, Mm, Hh, Gg, Rb, Rb, Gs, Hh, Mm, Cud, Mm, Mm, Mm
Mm, Mm, Mm, Hh, Hh, Gg, Gs, Rb, Gg, Hh, Mm, Mm, Mm, Mm, Mm, Hh, Hh, Gg, Rb, Hh, Mm, Hh, Hh, Rb, Hh, Rb, Rb, Hh, Rb, Hh, Rb, Rb, Rb, Rb, Rb, Hh, Mm, Mm, Mm, Hh, Gg, Gg^Es, Rb, Rb, Gs, Hh, Mm, Mm, Mm, Mm, Mm
Mm, Mm, Mm, Hh, Hh, Hh, Gs, Gs, Gs, Hh, Hh, Hh, Hh, Mm, Mm, Mm, Mm, Hh, Rb, Hh, Hh, Mm, Mm, Uu^Vud, Mm, Hh, Hh, Rb, Gs, Rb, Uu^Vud, Gs, Gg^Es, Rb, Rb, Hh, Uu^Vud, Mm, Mm, Hh, Gs, Gg, Rb, Rb, Uu^Vud, Hh, Mm, Mm, Mm, Mm, Mm
Mm, Mm, Mm, Mm, Mm, Hh, Hh, Gs, Rb, Gg, Gg^Es, Gg, Gg, Hh, Hh, Mm, Mm, Hh, Hh, Rb, Rb, Hh, Mm, Mm, Mm, Mm, Mm, Hh, Hh, Hh, Mm, Hh, Hh, Rb, Rb, Hh, Mm, Mm, Mm, Hh, Gs, Gg^Es, Rb, Rb, Hh, Mm, Mm, Mm, Mm, Mm, Mm
Mm, Mm, Mm, Mm, Mm, Hh, Hh, Rb, Gg, Gs, Gs, Gs^Es, Gg, Gs^Es, Gs, Hh, Hh, Mm, Mm, Hh, Rb, Hh, Hh, Mm, Mm, Mm, Mm, Cud, Mm, Mm, Mm, Mm, Hh, Rb, Hh, Hh, Mm, Mm, Mm, Hh, Gg, Gs, Rb, Rb, Gg, Hh, Hh, Mm, Mm, Mm, Mm
Mm, Mm, Mm, Mm, Mm, Mm, Hh, Gs, Hh, Gg, Gg, Gg, Rb, Gs^Es, Gs^Es, Gg, Hh, Mm, Mm, Hh, Hh, Rb, Rb, Hh, Mm, Mm, Cud, 4 Kud, Cud, Mm, Mm, Mm, Hh, Rb, Hh, Mm, Mm, Mm, Hh, Hh, Gg, Gg^Es, Rb, Rb, Gs, Gs, Hh, Hh, Mm, Mm, Mm
Mm, Mm, Mm, Mm, Mm, Mm, Hh, Hh, Hh, Hh, Gs, Rb, Gg, Gs, Rb, Gg, Hh, Mm, Mm, Mm, Hh, Rb, Rb, Uu^Vud, Hh, Mm, Hh, Cud, Hh, Mm, Hh, Hh, Rb, Rb, Rb, Hh, Hh, Hh, Gs, Gg, Rb, Rb, Rb, Rb, Gs^Es, Gs, Gs, Hh, Mm, Mm, Mm
Mm, Mm, Mm, Mm, Mm, Mm, Mm, Hh, Hh, Hh, Gg, Rb, Gs, Rb, Gg, Rb, Hh, Hh, Hh, Hh, Rb, Rb, Rb, Rb, Rb, Hh, Rb, Hh, Rb, Hh, Rb, Rb, Hh, Hh, Hh, Rb, Rb, Gs, Rb, Rb, Rb, Rb, Hh, Gs, Gg, Gs, Gs, Hh, Mm, Mm, Mm
Mm, Mm, Mm, Mm, Mm, Mm, Mm, Mm, Hh, Hh, Gs, Rb, Hh, Hh, Gs, Rb, Rb, Rb, Rb, Rb, Rb, Rb, Hh, Rb, Rb, Rb, Rb, Rb, Rb, Rb, Uu^Vud, Hh, Mm, Mm, Hh, Rb, Rb, Rb, Rb, Rb, Hh, Hh, Hh, Gs, Gs, Gg^Es, Gs, Hh, Hh, Mm, Mm
Mm, Mm, Mm, Mm, Mm, Mm, Mm, Mm, Hh, Hh, Gs, Rb, Hh, Hh, Hh, Rb, Rb, Rb, Rb, Rb, Hh, Hh, Mm, Hh, Hh, Rb, Hh, Rb, Hh, Hh, Hh, Hh, Mm, Mm, Hh, Gg, Gs^Es, Rb, Gg, Hh, Uu^Vud, Hh, Hh, Hh, Gs, Gg^Es, Gs, Hh, Mm, Mm, Mm
Mm, Mm, Mm, Mm, Mm, Mm, Mm, Hh, Hh, Gg, Gs, Rb, Gg, Hh, Uu^Vud, Hh, Hh, Gs, Gg, Hh, Mm, Mm, Mm, Mm, Mm, Hh, Mm, Uu^Vud, Mm, Mm, Mm, Mm, Mm, Mm, Hh, Gg, Gs, Gg, Hh, Hh, Hh, Hh, Hh, Gg, Gs^Es, Gs^Es, Gg, Hh, Hh, Mm, Mm
Mm, Mm, Mm, Mm, Mm, Mm, Mm, Hh, Hh, Hh, Hh, Rb, Gs, Hh, Hh, Hh, Hh, Gg, Gs^Es, Hh, Hh, Mm, Hh, Mm, Mm, Mm, Mm, Mm, Mm, Mm, Mm, Mm, Hh, Hh, Gg, Gs, Gs, Hh, Hh, Hh, Hh, Hh, Gs, Gs, Gs, Gg, Hh, Hh, Mm, Mm, Mm
Mm, Mm, Mm, Mm, Mm, Mm, Mm, Mm, Mm, Hh, Hh, Gs, Gg^Es, Gs, Gs, Hh, Hh, Gg, Gg^Es, Gg, Gs^Es, Hh, Hh, Hh, Hh, Mm, Hh, Mm, Hh, Hh, Hh, Hh, Gs, Gs, Gs, Gs^Es, Gs, Gg, Hh, Hh, Gs, Gg, Gs^Es, Gs, Uu^Vud, Hh, Mm, Mm, Mm, Mm, Mm
Mm, Mm, Mm, Mm, Mm, Mm, Mm, Mm, Mm, Mm, Mm, Hh, Gg^Es, Gs, Hh, Hh, Hh, Gs, Hh, Gs, Gs^Es, Gs, Gs, Uu^Vud, Gs, Hh, Gg, Hh, Gs, Gs, Gg, Gg, Gs, Gg^Es, Gg, Gg, Gs, Gg^Es, Gs, Gs, Gs^Es, Gs^Es, Gs, Gg, Hh, Mm, Mm, Mm, Mm, Mm, Mm
Mm, Mm, Mm, Mm, Mm, Mm, Mm, Mm, Mm, Mm, Mm, Hh, Hh, Gs, Hh, Hh, Hh, Hh, Hh, Hh, Hh, Gg^Es, Gg^Es, Gs, Gg, Gs, Gg, Gg, Gg, Gs^Es, Gs, Gg^Es, Gs^Es, Gs, Gg, Gs, Gs, Gg^Es, Gg, Gs, Gg, Gs, Gs, Cud, Hh, Mm, Mm, Mm, Mm, Mm, Mm
Mm, Mm, Mm, Mm, Mm, Mm, Mm, Mm, Mm, Mm, Mm, Hh, Mm, Hh, Hh, Hh, Mm, Hh, Mm, Mm, Mm, Hh, Gs, Gs, Gg^Es, Gs^Es, Gs, Gs^Es, Hh, Gg, Gg, Gs^Es, Gg, Gg^Es, Gg, Gg, Hh, Gg, Hh, Uu^Vud, Hh, Cud, Cud, Cud, Kud, Mm, Mm, Mm, Mm, Mm, Mm
Mm, Mm, Mm, Mm, Mm, Mm, Mm, Mm, Mm, Mm, Mm, Mm, Mm, Mm, Mm, Mm, Mm, Mm, Mm, Mm, Mm, Hh, Hh, Gs, Gs, Gg, Hh, Hh, Hh, Hh, Hh, Gs, Gs, Gg^Es, Gg, Hh, Mm, Hh, Mm, Mm, Mm, Hh, Cud, Cud, 1 Kud, Mm, Mm, Mm, Mm, Mm, Mm
Mm, Mm, Mm, Mm, Mm, Mm, Mm, Mm, Mm, Mm, Mm, Mm, Mm, Mm, Mm, Mm, Mm, Mm, Mm, Mm, Mm, Mm, Mm, Hh, Hh, Hh, Hh, Hh, Mm, Mm, Hh, Gg, Hh, Gg, Hh, Hh, Mm, Mm, Mm, Mm, Mm, Cud, Mm, Kud, Mm, Mm, Mm, Mm, Mm, Mm, Mm
Mm, Mm, Mm, Mm, Mm, Mm, Mm, Mm, Mm, Mm, Mm, Mm, Mm, Mm, Mm, Mm, Mm, Mm, Mm, Mm, Mm, Mm, Mm, Mm, Mm, Mm, Mm, Mm, Mm, Mm, Mm, Hh, Mm, Hh, Mm, Mm, Mm, Mm, Mm, Mm, Mm, Mm, Mm, Mm, Mm, Mm, Mm, Mm, Mm, Mm, Mm
Mm, Mm, Mm, Mm, Mm, Mm, Mm, Mm, Mm, Mm, Mm, Mm, Mm, Mm, Mm, Mm, Mm, Mm, Mm, Mm, Mm, Mm, Mm, Mm, Mm, Mm, Mm, Mm, Mm, Mm, Mm, Mm, Mm, Mm, Mm, Mm, Mm, Mm, Mm, Mm, Mm, Mm, Mm, Mm, Mm, Mm, Mm, Mm, Mm, Mm, Mm
Mm, Mm, Mm, Mm, Mm, Mm, Mm, Mm, Mm, Mm, Mm, Mm, Mm, Mm, Mm, Mm, Mm, Mm, Mm, Mm, Mm, Mm, Mm, Mm, Mm, Mm, Mm, Mm, Mm, Mm, Mm, Mm, Mm, Mm, Mm, Mm, Mm, Mm, Mm, Mm, Mm, Mm, Mm, Mm, Mm, Mm, Mm, Mm, Mm, Mm, Mm
Mm, Mm, Mm, Mm, Mm, Mm, Mm, Mm, Mm, Mm, Mm, Mm, Mm, Mm, Mm, Mm, Mm, Mm, Mm, Mm, Mm, Mm, Mm, Mm, Mm, Mm, Mm, Mm, Mm, Mm, Mm, Mm, Mm, Mm, Mm, Mm, Mm, Mm, Mm, Mm, Mm, Mm, Mm, Mm, Mm, Mm, Mm, Mm, Mm, Mm, Mm
