border_size=1
usage=map

Gll, Gll, Gs^Fds, Gs^Fds, Hh^Fds, Gs^Fds, Gs^Fds, Gs^Fds, Gs^Fds, Gs^Fds, Gs^Fds, Gll, Gll, Gg, Gs^Fds, Gg, Gll, Gs, Gs, Gs^Fds, Gs^Fds, Gs^Fds, Gs^Fds, Gll, Ww, Ww, Ww, Gg, Gs^Fds, Gs^Fds, Gll, Gs^Fds, Gs^Fds, Gll, Gll, Gll, Gll, Gg, Gll, Gg, Gs, Gs^Fds, Hh, Gg, Hh, Gg, Gs, Gg, Gs, Gg, Gs, Gg, Gs^Fds, Gs^Fds, Gs^Fds, Gs^Fds, Gs^Fds, Gs^Fds, Gg
Gll, Gs^Fds, Gs^Fds, Hh^Fds, Hh^Fds, Hh^Fds, Hh^Fds, Gs^Fds, Gs^Fds, Gs^Fds, Gll, Gs^Fds, Gs^Fds, Gs^Fds, Gs^Vl, Gs^Fds, Gs^Fds, Gs, Gs^Fds, Gs^Fds, Gs^Fds, Gll, Gs^Fds, Gs^Fds, Ww, Ww, Ww, Gll, Gs^Fds, Gll, Gll, Gll, Gll, Gs^Fds, Gs^Fds, Gs^Fds, Gll, Gs^Fds, Gs, Gs, Gs, Hh, Hh, Hh, Hh^Fds, Hh, Hh, Gs, Gs, Gs, Gg, Gs^Fds, Gs^Fds, Gs^Fds, Gll, Gll, Gll, Gs^Fds, Gs^Fds
Gs^Fds, Gs^Fds, Gs^Fds, Hh^Fds, Hh, Hh^Fds, Hh, Hh^Fds, Hh^Fds, Gs^Fds, Gs^Fds, Gll, Gll, Gs^Fds, Gs^Fds, Gll, Gs^Fds, Gs^Fds, Gll, Gs^Fds, Gs^Fds, Gll, Gs, Ww, Wo, Wo, Ww, Gll, Gs^Fds, Gll, Gs^Fds, Gll, Gs^Fds, Gs^Fds, Gll, Gs^Fds, Gll, Gs, Gs, Gs^Fds, Gll, Gs^Fds, Gll, Hh^Fds, Hh^Fds, Hh^Fds, Hh, Gll, Gll, Gs, Gll, Gs^Fds, Gs^Fds, Gll, Gll, Gs^Fds, Gs^Fds, Gs^Fds, Gs^Fds
Gll, Gs^Fds, Gs^Fds, Gs^Fds, Hh, Hh, Hh^Fds, Hh, Hh^Fds, Gll, Gs^Fds, Gs, Gs, Gs^Fds, Gs^Fds, Gll, Gs^Fds, Gs^Fds, Gs, Gg, Ww, Ww, Ww, Ww, Wo, Ww, Gs, Gll, Gs^Fds, Gs^Fds, Gs^Fds, Gs^Fds, Gs, Gs^Fds, Gs^Fds, Gs^Fds, Gs^Fds, Gll, Gll, Gll, Gs^Fds, Gll, Gs^Fds, Gs^Fds, Gs, Hh, Hh^Fds, Hh, Gs^Fds, Gs^Fds, Gs^Fds, Gs^Fds, Gs^Fds, Gs^Fds, Gs^Fds, Gll, Gs^Fds, Gs^Fds, Gs^Fds
Gs^Fds, Gs^Fds, Gs^Fds, Hh^Fds, Hh^Fds, Hh, Hh, Hh, Hh^Fds, Gll, Gs^Fds, Gll, Gs^Fds, Gll, Gs^Fds, Gs^Fds, Gs^Fds, Gs^Fds, Gs, Ww, Wo, Wo, Wo, Wo, Ww, Ww, Gs, Gs^Fds, Gs^Fds, Gs^Fds, Gll, Gs, Gs, Gs, Gs^Fds, Gll, Gll, Gs^Fds, Gs^Fds, Gs^Fds, Gs^Fds, Gll, Gs^Fds, Gs^Fds, Gs, Hh, Hh^Fds, Hh, Gs^Fds, Gll, Gll, Gll, Gll, Gs^Fds, Gs^Fds, Gs^Fds, Gs^Fds, Gs^Fds, Gs
Gs^Fds, Gll, Gs^Fds, Hh^Fds, Hh^Fds, Hh^Fds, Hh^Fds, Hh^Fds, Gs^Fds, Gs^Fds, Gs^Fds, Gll, Gs^Fds, Gll, Gll, Gs^Vl, Gll, Gs, Ww, Ww, Wo, Wo, Ww, Ww, Gg, Gs, Gs^Fds, Gs^Fds, Gs^Fds, Gs^Fds, Gs^Fds, Gll, Gs^Fds, Gs^Vl, Gs^Fds, Gs^Fds, Gs^Fds, Gs^Fds, Gll, Gll, Gs^Fds, Gll, Gll, Gg, Hh, Hh, Hh^Fds, Hh^Fds, Gs^Fds, Gll, Gs^Fds, Gll, Gs^Fds, Gs^Fds, Gs^Fds, Gs^Fds, Gs^Fds, Gs^Fds, Gs
Gll, Gs^Fds, Gll, Gs^Fds, Gs^Fds, Hh^Fds, Hh^Fds, Hh^Fds, Gs^Fds, Gs^Fds, Gs^Fds, Gs^Fds, Gll, Gs^Fds, Gll, Gs^Fds, Gs^Fds, Gg, Ww, Ww, Ww, Ww, Gs^Vl, Gg, Gg^Efm, Gs, Gs, Gll, Gll, Gs^Fds, Gs^Fds, Gs^Fds, Gs^Fds, Gs^Fds, Gll, Gll, Gs^Fds, Gll, Gs^Fds, Gs^Fds, Gs^Fds, Gs^Fds, Gs^Fds, Gs, Hh^Fds, Hh^Fds, Hh, Hh^Fds, Gs^Fds, Gs^Fds, Gll, Gs^Fds, Gs^Fds, Gs^Fds, Gs^Fds, Gs^Fds, Gs^Fds, Gs^Fds, Gs
Gs, Gll, Gs, Gll, Gll, Gs^Fds, Gs^Fds, Gs^Fds, Gll, Gs^Vl, Gs^Fds, Gs^Fds, Gs^Fds, Gll, Gs^Fds, Gs^Fds, Gs^Fds, Gs, Gg^Efm, Ww, Wo, Ww, Ww, Gs, Gs^Efm, Gg^Efm, Gg, Gs, Gs^Fds, Gs^Fds, Gs^Fds, Gll, Gll, Gs^Fds, Gs^Fds, Gll, Gs^Fds, Gs^Fds, Gll, Gs^Fds, Gs^Fds, Gll, Gs^Fds, Gll, Gs^Fds, Hh^Fds, Gs^Fds, Hh, Gs^Fds, Gll, Gs, Gs^Fds, Gll, Gs^Fds, Gs^Fds, Gs^Fds, Gs^Fds, Gs^Fds, Gs
Gs, Gs^Fds, Gs^Fds, Gs^Fds, Gs^Fds, Gll, Gs^Fds, Gll, Gs^Fds, Gs^Fds, Gs^Fds, Gs^Fds, Gg, Gs^Fds, Gs^Fds, Gs^Fds, Gs^Fds, Gs, Gg^Efm, Ww, Ww, Wo, Wo, Ww, Gg^Efm, Gs^Efm, Gg, Gs^Es, Gs^Fds, Gll, Gll, Gs^Fds, Gs^Fds, Gll, Gs^Fds, Gs^Fds, Gll, Gll, Gs^Fds, Gs^Fds, Gs^Fds, Gll, Gs^Fds, Gll, Gs^Fds, Gs^Fds, Gs^Fds, Gll, Gll, Gll, Gs^Fds, Gs, Gll, Gll, Gll, Gs^Fds, Gs^Fds, Gs^Fds, Gs
Gs^Fds, Gs^Fds, Gll, Gll, Gll, Gs^Fds, Gs^Fds, Gll, Hh^Fds, Gs^Fds, Gs^Fds, Gg, Gg, Gg, Gs^Fds, Gs^Fds, Gs^Fds, Gs^Fds, Gs, Ww, Ww, Ww, Ww, Ww, Wwf, Gs, Gg, Gs, Gs, Gs^Fds, Gs^Fds, Gs^Fds, Gll, Gs, Gll, Gs, Gs, Gg, Gs^Fds, Gll, Gll, Gs^Fds, Gs^Fds, Gs^Fds, Gll, Gs^Fds, Gg, Gs^Fds, Gs^Fds, Gs^Fds, Gll, Gs^Fds, Gs^Fds, Gs^Fds, Gll, Gs, Gs, Gs, Gs
Gs, Gs^Fds, Gs^Fds, Gs, Gs, Gs^Fds, Gs^Fds, Hh^Fds, Hh^Fds, Hh^Fds, Hh, Gg, Gs^Fds, Gs^Fds, Hh, Hh, Gs, Gs, Gg^Es, Gg, Gg, Ww, Wwf, Wwf, Ww, Gg, Gs, Gg^Es, Gs, Gs, Gs, Gs, Gg, Gll, Gg, Gs, Gs^Fds, Gs^Fds, Gs^Fds, Gll, Gll, Gll, Gs^Fds, Gll, Gs^Fds, Gs^Fds, Gs, Gg, Gs, Gs^Fds, Gs^Fds, Gs^Fds, Gg, Gll, Gs^Fds, Gg, Gs, Gg, Gg
Gs, Gs^Fds, Gs^Fds, Gs^Fds, Gs^Fds, Gs^Fds, Gs, Hh^Fds, Hh^Fds, Hh^Fds, Hh, Gg, Hh, Hh, Hh^Fds, Hh, Gg, Gs, Gs, Gs, Gg^Efm, Gg^Efm, Ww, Ww, Wo, Ww, Gg, Gg, Gg, Gg, Gg, Gs, Gs, Gs^Fds, Gs^Fds, Gs^Vl, Gs^Fds, Gg, Gg, Gs^Fds, Gs^Fds, Gs^Fds, Gs^Fds, Gs^Fds, Rmo^Vdm, Gs, Gg, Gs, Gg, Gs, Rmo^Vdm, Gg, Gs, Gs^Fds, Gs, Gs, Gs^Es, Gg, Gg
Gg, Gs, Gs^Fds, Gs^Fds, Gs, Gs, Gg, Hh, Hh, Hh, Hh, Hh, Hh, Hh^Fds, Hh, Hh, Gg, Gs^Es, Gs, Gs, Gs^Efm, Gg, Gg, Ww, Wo, Ww, Gg, Gs, Gs, Gg^Es, Gg, Gs, Gs^Fds, Gll, Gs^Fds, Gll, Gs^Fds, Gg, Gs^Es, Gg, Gs^Fds, Gs^Fds, Gll, Gs^Fds, Gs^Fds, Gs, Gg, Gs^Efm, Gg^Es, Gs^Efm, Gg, Gg, Gg, Gs, Gg, Gs, Gg, Gg, Gg
Gg, Gs, Gs, Gs, Gg, Gs^Vc, Gg, Gg, Gs, Hh, Hh, Hh, Hh, Hh, Gs, Gg, Gg, Gs, Gs, Gs^Fds, Gs, Gg^Efm, Gg, Ww, Wo, Ww, Ww, Gg, Gg, Gs^Es, Gs, Gs, Gs, Gs^Fds, Gs^Fds, Gs^Fds, Gs^Fds, Gs, Gg, Gs, Gs, Gs^Fds, Gs^Fds, Gs^Fds, Gs^Fds, Gs, Gg, Gs^Efm, Gs^Efm, Gg^Efm, Gg, Gg, Gs, Gs, Gs, Gs, Rmo^Vdm, Gs^Es, Gg
Gg, Gg, Gg, Gg, Gs, Gg, Gs, Gg, Gs^Es, Gg, Gg, Gg, Gg, Gs, Gg, Gg, Gs, Gg, Gs^Fds, Gs^Fds, Gs^Fds, Gs, Gg, Ww, Ww, Wo, Wo, Ww, Ww, Gg, Gg, Gg, Gg, Gs, Gs, Gs^Fds, Gs^Fds, Gs, Gg, Gg, Gs, Gs^Fds, Hh^Fds, Hh^Fds, Hh, Gs, Gg, Gg, Gs, Gg^Efm, Gs, Gs^Fds, Gs^Fds, Gs^Fds, Gs^Fds, Gs, Gg, Gs, Gs
Gs, Gs, Gg^Es, Gs, Gs^Fds, Gs^Fds, Rp, Rp, Rp, Gg, Gs, Gg^Efm, Gs^Efm, Gg, Gg, Gs, Gs^Fds, Gg, Gll, Gs^Fds, Gs^Fds, Gs, Gs, Gs, Gg, Ww, Wo, Wo, Ww, Ww, Ww, Gg, Gg, Gg, Gs, Gs^Fds, Gs^Fds, Gs, Gg, Gs, Gs, Hh, Hh^Fds, Hh^Fds, Hh, Hh, Gg, Gs^Es, Gs, Gg, Re^Vct, Gs, Gs, Gs, Gs, Gs^Fds, Gs, Gs, Gg
Gs, Gs, Gg, Gs, Rp, Rp, Rp, Rp, Rp, Rp, Rp, Gg, Gs^Efm, Gs, Gs^Fds, Gll, Gg, Gg, Gg^Es, Gll, Gs^Fds, Gs^Fds, Gs, Gs^Es, Gg, Ww, Ww, Ww, Ww, Wo, Wo, Ww, Ww, Gg, Gs, Gll, Gs^Fds, Gs, Rmo, Gs, Hh, Hh, Hh, Hh, Hh, Gg, Gs, Gs, Rmo, Gs, Gs, Gg, Rmo, Gg, Gg, Gs, Gg, Gg, Gg
Gs, Gs, Rp, Rp, Rp, Rp, Gs, Gs, Gg, Rp, Rp, Rp, Rp, Gs, Gg, Gs^Vc, Gs^Fds, Gs, Gs, Gs^Es, Gg, Gs, Gs, Gs, Gs^Es, Gg, Hh, Ww, Hh, Ww, Ww, Wo, Ww, Kd, Cd, Gs^Fds, Rmo, Rmo, Rmo, Rmo, Rmo, Hh, Rmo, Gg, Gs, Gg, Rmo, Rmo, Rmo, Rmo, Rmo, Rmo, Rmo, Rmo, Rmo, Gg, Gg, Gg, Rmo
Rp, Rp, Rp, Rp, Gg, Gg, Hh, Hh, Hh^Fds, Hh, Gg, Rp, Rp, Rp, Rp, Gs, Gs, Gs^Fds, Gg, Gg, Gs, Gs, Gs, Gg, Gs, Gg, Hh, Hh, Hh^Fds, Hh, Ww, Wo, Ww, Cd, Rmo, Rmo, Rmo, Rmo, Gs^Efm, Rmo, Rmo, Rmo, Rmo, Rmo, Rmo, Rmo, Rmo, Rmo, Gs, Rmo, Rmo, Rmo, Gg, Rmo, Rmo, Rmo, Rmo, Rmo, Rmo
Rp, Rp, Gs, Gg, Gg, Gg, Hh, Hh^Fds, Hh, Hh, Gg, Re^Vct, Gs, Rp, Rp, Gg, Gg, Gg, Gg, Gs^Fds, Rp, Gs, Gg, Gg, Gs, Gg, Hh, Hh^Fds, Cd, Hh, Ww, Wo, Ww^Bsb/, Ww^Bsb/, Gg^Bsb/, Rmo, Gs, Gs^Efm, Gs^Efm, Gs, Gs, Rmo, Gs, Rmo, Rmo, Rmo, Gg, Gg, Gg, Gs, Gs, Gs, Ce, Gs, Ce, Rmo, Rmo, Rmo, Gg
Gg, Gg, Gs, Gs, Gg, Hh, Hh^Fds, Hh, Gg, Gs, Ce, Ce, Re^Vct, Rp, Rp, Rp, Rp, Gg, Rp, Rp, Rp, Rp, Rp, Gg^Es, Gg, Gg, Gg, Hh, Cd, Kd, Ww^Bsb/, Ww^Bsb/, Ww^Bsb/, Ww^Bsb/, Cd, Cd, Gg, Gg^Efm, Gs, Gg, Gs, Gg, Gs^Fds, Gs, Gs, Gs, Gs, Gs^Fds, Gs^Fds, Gg, Gg, Ce, Re^Vct, Ce, 2 Ke, Ce, Gg, Gs, Gs
Gg, Gs, Gg, Gs^Es, Gg, Hh, Hh^Fds, Hh, Gg, 1 Ke, Ce, Ce, Ce, Gs, Re^Vct, Rp, Rp, Rp, Rp, Rp, Gs, Rp, Rp, Rp, Rp, Gs, Gs, Gg, Rp, Rp, Rp, Ww^Bsb/, Wo, Ww, Hh, Kd, Hh, Gg, Gs, Gs^Fds, Gs, Gs, Gll, Gll, Gs, Gg, Gs, Gs^Fds, Gs^Fds, Gll, Gg, Ce, Ce, Ce, Ce, Ce, Gg, Gs^Fds, Gs^Fds
Gg, Gg, Gg, Gs, Gg, Hh, Hh, Hh, Gg, Ke, Ce, Ce, Gg, Gs, Gs, Gs, Gg, Rp, Gs, Gs, Gs^Fds, Gs, Gg, Rp, Rp, Rp, Rp, Rp, Rp, Rp, Kd, Ww, Wo, Ww, Hh, Hh^Fds, Hh, Gg, Gs, Gs^Fds, Gs^Fds, Gg, Gg, Gs^Fds, Gg, Gg, Rmo^Vdm, Gs, Gs, Gs^Fds, Gs^Fds, Gs^Fds, Ce, Re^Vct, Ce, Gs, Gg, Gs, Gs^Fds
Gg, Gs, Gg, Gs, Gg, Gg, Hh, Hh, Hh, Gg, Gg, Ce, Gs, Gg, Gg, Gs, Gg, Gs^Es, Gs^Fds, Gs^Fds, Gs^Fds, Gs, Gs, Gg, Gs, Rp, Rp, Rp, Gg, Cd, Cd, Ww, Wo, Ww, Hh, Hh^Fds, Hh, Hh, Gg, Gs, Gg, Gll, Gs, Gg, Gg, Gs, Gg^Es, Gg, Gg, Gs, Gs, Gs, Gs^Fds, Ce, Gs^Fds, Gg, Re^Vct, Gs, Gs^Fds
Gg, Gs, Gg, Gg, Gs, Gs, Gs^Fds, Hh^Fds, Hh, Hh, Hh, Hh^Fds, Hh^Fds, Re^Vct, Gg, Gs, Gs, Gs, Gs, Gs^Fds, Gs^Fds, Gs^Fds, Gll, Gs, Gs, Gs, Gs, Gg, Gg, Gs, Gg, Ww, Wo, Ww, Ww, Hh, Gg, Gg, Gs, Gg, Gg, Gs^Fds, Gs, Gs, Gg^Efm, Gs^Es, Gg, Gg, Gs, Gg, Gg^Es, Gs^Fds, Gs, Gs^Fds, Gs^Fds, Gs, Gg, Gs^Fds, Gs
Gg, Gs, Gs^Es, Gg, Gs, Gs^Fds, Gs^Fds, Gll, Gll, Hh^Fds, Hh^Fds, Hh^Fds, Gll, Gs, Gs, Gs, Gs, Gg, Gs, Gs^Fds, Gs^Fds, Gll, Gll, Gs^Fds, Gs^Fds, Gs^Fds, Gs^Fds, Gs, Gs, Gg, Gs, Ww, Ww, Wo, Wo, Ww, Gg, Gs, Gg, Gs, Gg, Gg, Gg^Efm, Gs^Efm, Gs, Gs, Gs, Gs, Gs^Fds, Gs, Gs, Gg, Gs, Gg, Gs, Gs, Gg^Es, Gs, Gg
Gg, Gg, Gs, Gs, Gs, Gs, Gs^Fds, Gs^Fds, Gs^Fds, Gs^Fds, Gll, Gll, Gll, Gs^Fds, Gs, Gg, Gs, Gg, Gs, Gs^Fds, Gs, Gs, Gs, Gs^Fds, Gs^Fds, Gs^Fds, Gll, Gs^Fds, Gs^Fds, Gs, Gs, Gg, Gg, Ww, Ww, Ww, Ww, Gs, Gg, Gg^Es, Gs, Gg, Gs, Gs^Efm, Gs^Fds, Gs^Fds, Gs^Fds, Gs^Fds, Hh^Fds, Gs^Fds, Gs, Gg, Gg, Re^Vct, Gg, Gg, Gs, Gg, Gg
Gg, Gg, Gs, Gg^Es, Gs, Gs, Gs^Fds, Gll, Gs^Fds, Gll, Gs^Fds, Gs^Fds, Gs^Fds, Gs^Fds, Gs, Gg, Gg^Efm, Gs, Gs, Gs, Gg, Gg, Gs, Gs^Fds, Hh^Fds, Hh^Fds, Hh^Fds, Gs^Fds, Gs^Fds, Gs, Gg, Gg, Gg, Ww, Ww, Ww, Ww, Gs, Gs, Gs, Gg, Gg, Gs, Gs^Fds, Gs^Fds, Gll, Gs^Fds, Gs^Fds, Hh^Fds, Hh^Fds, Hh, Hh, Hh, Gg, Gg, Gs, Gg, Gs, Gg
Gs, Gg, Gs, Gg, Gs, Gs^Fds, Gll, Gs^Fds, Gs^Fds, Gll, Gs^Fds, Gll, Gs^Fds, Gs^Fds, Gs, Gg, Gs, Gg^Efm, Gg^Efm, Gs^Es, Gg^Es, Gs^Vc, Gs, Hh^Fds, Hh, Hh, Hh, Hh^Fds, Gs, Gs, Gs, Gs, Gg, Gg, Ww, Wo, Wo, Ww, Gg, Gg, Gg, Gs^Es, Gg, Gs, Gs^Fds, Gs^Fds, Gs^Fds, Gs^Fds, Hh^Fds, Hh^Fds, Hh, Hh, Hh, Hh, Gg, Gs, Rmo^Vdm, Gg, Gg
Gs, Gg, Gs, Gs, Gs^Fds, Gs^Fds, Gs^Fds, Gs^Fds, Gll, Gs^Fds, Gs^Fds, Gll, Hh, Gs, Gg, Gg, Gs, Gg^Efm, Gs, Gs^Efm, Gg, Gg, Gg, Gg, Gs, Hh, Hh, Hh, Gg, Gg, Gs, Gg, Gs, Gg, Gg, Ww, Wo, Ww, Ww, Gs, Gg, Gg, Gg, Gs, Gs, Gs, Gs, Gs^Fds, Gs, Hh, Hh, Hh, Hh^Fds, Hh, Gs, Gs, Gs, Gg, Gg
Gs, Gs^Es, Gs, Gs, Gs, Gs^Fds, Hh^Fds, Gs^Fds, Gs^Fds, Gll, Gs^Fds, Gs^Fds, Hh^Fds, Hh, Gg, Gs, Gs, Gg^Efm, Gg^Efm, Gg^Efm, Gg, Gg, Gg, Gg, Gs, Gs, Hh, Gg, Gg, Gs, Gs^Efm, Gg^Es, Gg, Gg, Gg, Ww, Ww, Wo, Ww, Gg, Ww, Gg, Gg, Gg, Gg, Gg, Gg^Efm, Gs, Gg, Hh, Gs^Fds, Hh^Fds, Hh^Fds, Hh^Fds, Gs^Fds, Gs, Gg, Gs^Es, Gg
Gg, Gs, Gs, Gg, Gg, Hh, Hh, Hh^Fds, Hh^Fds, Gs^Fds, Hh^Fds, Hh^Fds, Hh, Hh, Gg, Gs, Gs^Es, Gs, Gs, Gs, Gg, Gs^Es, Gg, Gg, Gg, Gg, Gg, Gg, Gs, Gg, Gg, Gs^Efm, Gg, Gs, Gg, Gg, Ww, Wo, Wo, Ww, Wo, Ww, Ww, Ww, Ww, Gs, Gg, Gg^Efm, Gg^Efm, Gs, Gs, Gs^Fds, Gs^Fds, Gs^Fds, Gs^Fds, Gs, Gg, Gs, Gg
Gs, Gs, Gs, Gs, Gs, Gg, Hh, Hh, Hh, Hh^Fds, Hh, Hh, Hh, Hh, Gg, Gs, Gg, Gg^Es, Gs, Gg, Gg, Gg^Es, Gs, Gs^Efm, Gs, Gg, Gg, Gs, Gg, Gg, Gs^Efm, Gg^Efm, Gg, Gs, Gg, Gg^Es, Gg, Ww, Ww, Wo, Ww, Wo, Wo, Wo, Wo, Ww, Gg, Gs^Es, Gs, Gg, Gs, Gs^Fds, Gs^Fds, Gll, Gs^Fds, Gs, Gg, Gg, Gg
Gs, Gg, Gs, Gs, Gs, Gg, Gg, Hh, Gg, Hh, Hh, Hh, Gs, Gg, Gg, Gs, Gg, Gs^Vc, Gs, Gg^Es, Gs, Gg, Gg^Efm, Gg, Gg, Gg, Gs^Es, Gs, Gs^Vc, Gs, Gg^Efm, Gg, Gs, Gs, Gs, Gg, Gs, Gg, Gg, Ww, Gs, Ww, Ww, Wo, Wo, Ww, Ww, Gg, Gg, Gs, Gg, Gs, Gs^Fds, Gs^Fds, Gs, Gs, Gg, Gs, Gg
Gg, Gs, Gs, Gg, Gg^Es, Gs, Gs, Gg, Gs, Gg, Gg, Gg, Gs, Gs, Gg, Gs, Gg, Gs, Gg^Es, Gg, Gs, Gg, Gg, Gg, Gg, Gs, Gg, Gg, Gs, Gg, Gs, Gs, Gs^Fds, Gs^Fds, Gs^Fds, Gs, Gs^Fds, Gg, Gs, Gs, Hh^Fds, Hh^Fds, Hh^Fds, Ww, Ww, Ww, Wwf, Wwf, Ww, Gs, Gg, Gs, Gs, Gs, Gg, Gg, Gs, Gg, Gg
Gs, Gs, Gg, Gs^Es, Gs, Gg, Gs^Vc, Gs, Gs, Gs, Gs, Gg, Gs, Gg, Gs, Gs^Es, Gg, Gs, Gg, Gs, Gs, Gs, Gs, Gs, Gs, Gg, Gg, Gg, Gs, Gg, Gs, Gs^Fds, Gs^Fds, Gs^Fds, Gll, Gs^Fds, Gll, Gll, Gs^Fds, Hh^Fds, Hh^Fds, Hh^Fds, Hh^Fds, Gg, Gg, Wwf, Ww, Ww, Wo, Ww, Ww, Gs, Gg, Gg, Gg^Es, Gs, Gg, Gg^Es, Gg
Gg, Gg, Gs, Gs, Gg, Gs, Gs, Gg, Gs, Gg^Es, Gs, Gs, Gg, Gs, Gg, Gg, Gg, Gs, Gg, Gg, Gs, Gs^Fds, Gs^Fds, Gs^Fds, Gs^Fds, Gs, Gg, Gs, Gg, Gg, Gs, Gs^Fds, Gs^Fds, Gs^Fds, Gs^Fds, Gll, Gs^Fds, Gs^Fds, Gs^Fds, Hh^Fds, Hh^Fds, Hh^Fds, Hh^Fds, Gs, Gs^Es, Gs^Vc, Gg, Ww, Ww, Wo, Ww, Gg, Gg, Gs, Gg, Gg, Gg, Gs, Gg
Gs, Gs, Gs^Fds, Gs, Gs, Gs, Gs^Fds, Gs, Gs^Fds, Gs, Gs^Fds, Gs, Gs, Gg, Gg, Gs, Gg, Gs, Gg, Gs, Gs^Fds, Gs^Fds, Gll, Gs^Fds, Gs^Fds, Gs, Gg, Gg, Gs, Gs, Gg, Gs, Gs, Gll, Gll, Gs^Fds, Gs^Fds, Gll, Gs^Fds, Gll, Gll, Hh^Fds, Gs^Fds, Gs^Fds, Gs^Fds, Gs, Gs^Es, Gg, Ww, Wo, Wo, Ww, Gg, Gs, Gg, Gs^Es, Gg^Es, Gg, Gg
Gs, Gll, Gll, Gs^Fds, Gs^Fds, Gs^Fds, Gll, Gs^Fds, Gll, Gs^Fds, Gs^Fds, Gs^Fds, Gs^Fds, Gs, Gg, Gs^Es, Gg, Gg, Gs, Gs, Gll, Gll, Gs^Fds, Gll, Gs^Fds, Gs, Gs, Gg, Gg, Gg, Gs, Gg, Gs, Gs^Fds, Gs^Fds, Gs^Fds, Gs^Fds, Gll, Gll, Gs^Fds, Gg, Gll, Gs^Fds, Gll, Gs^Fds, Gs^Fds, Gs, Gg, Ww, Wo, Wo, Ww, Ww, Gg, Gs, Gg, Gg, Gs, Gg
Gs^Fds, Gs^Fds, Gs^Fds, Gs^Fds, Gll, Gs^Fds, Gs^Fds, Gs^Fds, Gll, Gll, Gs^Fds, Gll, Gs^Fds, Gs, Gg, Gs, Gg, Gs, Gs, Gs^Fds, Gs^Fds, Gs^Fds, Gs^Fds, Gs^Fds, Gs^Fds, Gs^Fds, Gs, Gg, Gg, Gs^Es, Gg, Gg, Gg, Gs, Gs^Fds, Gll, Gs^Fds, Gs^Fds, Gs^Fds, Gs^Fds, Gs^Es, Gg, Gll, Gs^Fds, Gs^Fds, Gll, Gs^Fds, Gs, Gg, Ww, Wo, Ww, Ww, Gg, Gg, Gg, Gs, Gg, Gg
Gs^Fds, Gs^Fds, Gs^Fds, Gs^Fds, Gs^Fds, Gll, Gll, Gs^Fds, Gs^Fds, Gll, Gs, Gs^Fds, Gs, Gs, Gs, Gs, Gs, Gs, Gs^Fds, Gll, Gs^Fds, Gll, Gll, Gs^Fds, Gll, Gs^Fds, Gs, Gg, Gs, Gs, Gs, Gg, Gg^Es, Gs, Gs^Fds, Gll, Gs^Fds, Gs^Fds, Gll, Gs^Fds, Gs, Gs, Gs^Fds, Gs^Fds, Gs^Fds, Gll, Gs, Gs, Gg, Ww, Ww, Wo, Wo, Ww, Gg, Gg, Gg, Gs, Gg
Gs^Fds, Gs^Fds, Gs^Fds, Gll, Gs^Fds, Gs^Fds, Gs^Fds, Gs^Fds, Gs^Fds, Gs, Gg, Gs, Gg, Gg, Gs, Gs, Gg, Gs, Gg, Gs^Fds, Gs^Fds, Gs^Fds, Gg, Gs^Fds, Gs^Fds, Gs^Fds, Gs^Fds, Gs, Gs, Gg, Gs, Gg, Gg^Es, Gs, Gs^Fds, Gs^Fds, Gs^Fds, Gll, Gg, Gg, Gs, Gs, Gs^Fds, Gs^Fds, Gs^Fds, Gs^Fds, Gs, Gg, Gg, Gg, Gg, Ww, Wo, Ww, Gg, Gg, Gs, Gs, Gg
