border_size=1
usage=map

Gs^Fms, Gll, Gs^Fms, Gs^Fms, Gll, Gs^Fms, Gs^Fms, Gs^Fms, Gs^Fms, Gs^Fms, Hh^Fms, Hh, Hh, Hh, Gg, Gg, Gs, Gg, Hh, Hh, Mm, Mm, Mm, Mm, Mm, Mm, Mm, Mm, Mm, Mm, Mm, Mm, Mm, Mm, Mm, Mm, Mm, Mm, Mm, Mm, Hh, Hh, Hh, Hh, Hh^Fms, Gs^Fms, Gs, Gg, Ds, Wwt, Wwt, Wwt, Wot, Wot, Wot, Wot, Wot, Wot, Wot, Wot, Wot, Wot, Wot, Wot, Wot, Wot, Wot, Wot, Wot, Wot, Wot, Wot, Wot, Wot, Wot, Wot
Gs^Fms, Gs^Fms, Gll, Gs^Fms, Gs^Fms, Gs^Fms, Gs^Fms, Gll, Gs^Fms, Hh^Fms, Hh^Fms, Hh, Hh, Hh, Gg, Gg, Gs, Gs^Fms, Hh^Fms, Hh, Hh, Mm, Mm, Mm, Mm, Mm, Mm, Mm, Mm, Mm, Ww, Mm, Mm, Mm, Mm, Mm, Mm, Mm, Mm, Hh, Hh, Hh, Hh, Hh^Fms, Gs^Fms, Gs^Fms, Gs, Gs, Ds, Wwt, Wwt, Wwt, Wot, Wot, Wot, Wot, Wot, Wot, Wot, Wot, Wot, Wot, Wot, Wot, Wot, Wot, Wot, Wot, Wot, Wot, Wot, Wot, Wot, Wot, Wot, Wot
Gll, Gs^Fms, Gs^Fms, Gll, Gll, Gs^Fms, Gs^Fms, Gs^Fms, Gs^Fms, Hh^Fms, Hh^Fms, Hh, Hh, Gg, Gg^Es, Gg^Es, Gs^Fms, Gll, Gll, Hh, Hh^Fms, Hh, Mm, Mm, Mm, Mm, Mm, Mm, Hh, Hh, Ww, Hh, Mm, Mm, Mm, Mm, Mm, Mm, Hh, Hh, Hh^Fms, Hh^Fms, Gll, Gll, Gs^Fms, Gs, Ds, Ds, Wwt, Wwt, Wwt, Wwt, Wot, Wot, Wot, Wot, Wot, Wot, Wot, Wot, Wot, Wot, Wot, Wot, Wot, Wot, Wot, Wot, Wot, Wot, Wot, Wot, Wot, Wot, Wot, Wot
Gs^Fms, Gs^Fms, Gs^Fms, Gs^Fms, Gs^Fms, Gll, Gs, Gs, Hh, Hh^Fms, Hh, Hh^Fms, Hh, Gg, Gs, Gs, Gs^Fms, Gs^Fms, Gs, Gs^Fms, Hh^Fms, Hh, Hh, Mm, Mm, Mm, Mm, Mm, Hh, Hh, Ww, Hh, Hh, Mm, Hh, Mm, Hh, Hh, Hh, Hh, Gll, Gs^Fms, Gs^Fms, Gs^Fms, Gs, Gs, Ds, Wwt, Wwt, Wwt, Wwt, Wot, Wot, Wot, Wot, Wot, Wot, Wot, Wot, Wot, Wot, Wot, Wot, Wot, Wot, Wot, Wot, Wot, Wot, Wot, Wot, Wot, Wot, Wot, Wot, Wot
Gll, Gs^Fms, Gs^Fms, Gll, Gs, Gs, Gg, Gg, Hh, Hh, Hh^Fms, Hh, Hh, Gg, Gs, Gs^Fms, Gs^Fms, Gll, Gg, Gs, Gs, Hh^Fms, Hh, Hh, Hh, Hh, Hh, Hh, Hh^Fms, Hh, Ww, Hh, Hh, Hh, Hh, Hh, Hh^Fms, Hh, Hh, Hh^Fms, Gs^Fms, Gs^Fms, Gll, Gs, Gs, Gs, Ds, Wwt, Wwt, Wwt, Wot, Wot, Wot, Wot, Wot, Wot, Wot, Wot, Wot, Wot, Wot, Wot, Wot, Wot, Wot, Wot, Wot, Wot, Wot, Wot, Wot, Wot, Wot, Wot, Wot, Wot
Gs^Fms, Gll, Re, Gg, Gg^Es, Gg, Gg, Hh, Hh, Hh^Fms, 1 Ke, Hh, Ce, Gg, Gs, Gs^Fms, Re, Gg, Gs^Fms, Gg^Es, Gg, Gs, Gg, Hh^Fms, Hh^Fms, Hh^Fms, Gs^Fms, Gs, Gs^Fms, Ww, Ww, Gs, Gs, Hh^Fms, Gs^Fms, Hh^Fms, Gg, Hh^Fms, Gs, Gll, Gll, Gs^Fms, Gs, Gs, Ds, Gs, Ds, Wwt, Wwt, Wwt, Wot, Wot, Wot, Wot, Wot, Wot, Wot, Wot, Wot, Wot, Wot, Wot, Wot, Wot, Wot, Wot, Wot, Wot, Wot, Wot, Wot, Wot, Wot, Wot, Wot, Wot
Gs^Fms, Gs^Fms, Gs, Re, Gg, Gg, Gg, Hh, Hh, Ke, Ce, Ce, Ce, Gs, Gs^Fms, Re, Gs^Fms, Gll, Gs^Fms, Gs^Fms, Gg^Es, Gs, Gs, Gs, Gs^Fms, Gs, Gs, Gg^Es, Gs, Ww, Ww, Gs^Fms, Gll, Gll, Gs^Fms, Gs^Fms, Gg^Es, Gs, Gs^Fms, Gs^Fms, Gs^Fms, Gs, Gs, Ds, Wwt, Ds, Wwt, Wwt, Wwt, Wot, Wot, Wot, Wot, Wot, Wot, Wot, Wot, Wot, Wot, Wot, Wot, Wot, Wot, Wot, Wot, Wot, Wot, Wot, Wot, Wot, Wot, Wot, Wot, Wot, Wot, Wot
Gs^Fms, Gs, Gs, Re, Re, Gg, Rb^Gvs, Gg, Ce, Ce, Ce, Ce, Ce, Gg, Re, Re, Gll, Gs^Fms, Gs^Fms, Gll, Gs^Fms, Gs^Fms, Gs^Fms, Gs, Gs^Fms, Gs^Fms, Gs^Fms, Gs^Fms, Gs, Ww, Ww, Gs^Fms, Gs^Fms, Gs^Fms, Gll, Gs^Fms, Gs^Fms, Gs^Fms, Gs^Fms, Gs^Fms, Gs, Gs, Gs, Ds, Wwt, Wwt, Wwt, Wwt, Wot, Wot, Wot, Wot, Wot, Wot, Wot, Wot, Wot, Wot, Wot, Wot, Wot, Wot, Wot, Wot, Wot, Wot, Wot, Wot, Wot, Wot, Wot, Wot, Wot, Wot, Wot, Wot
Gs^Fms, Gs^Fms, Gs^Fms, Gg, Rb^Gvs, Rb^Gvs, Rb^Gvs, Rb^Gvs, Rb^Gvs, Ce, Ce, Ce, Rb^Gvs, Rb^Gvs, Rb^Gvs, Gs^Fms, Gs^Fms, Gll, Gs^Fms, Gs^Fms, Gs^Fms, Gll, Gs^Fms, Gs^Fms, Gs^Fms, Gll, Gs^Fms, Gll, Ww, Ww, Ww, Gs^Fms, Gll, Gs^Fms, Gll, Gs^Fms, Gll, Gs^Fms, Gs^Fms, Gs, Gg, Gg^Es, Gs, Ds, Wwt, Wwt, Wwt^Bw/, Wwt, Wot, Wot, Wot, Wot, Wot, Wot, Wot, Wot, Wot, Wot, Wot, Wot, Wot, Wot, Wot, Wot, Wot, Wot, Wot, Wot, Wot, Wot, Wot, Wot, Wot, Wot, Wot, Wot
Hh^Fms, Gs^Fms, Hh^Fms, Hh, Gg, Rb^Gvs, Rb^Gvs, Rb^Gvs, Re, Re, Re, Rb^Gvs, Rb^Gvs, Rb^Gvs, Rb^Gvs, Rb^Gvs, Gs, Gs^Fms, Gs, Gs^Fms, Gs, Gs^Fms, Gs^Fms, Gs^Fms, Gs^Fms, Gs^Fms, Ww, Ww, Ww, Ww, Gs^Fms, Gs^Fms, Gs^Fms, Gs^Fms, Gll, Gs^Fms, Gs^Fms, Gs^Fms, Gs, Gs, Gg^Es, Gg, Gs, Ds, Cd, Wwt^Bw/, Wwt^Bw/, Wwt^Bw/, Wwt, Wwt, Wwt, Wot, Wot, Wot, Wot, Wot, Wot, Wot, Wot, Wot, Wot, Wot, Wot, Wot, Wot, Wot, Wot, Wot, Wot, Wot, Wot, Wot, Wot, Wot, Wot, Wot
Hh, Hh^Fms, Hh, Hh, Hh, Gg, Re, Re, Rb^Gvs, Rb^Gvs, Rb^Gvs, Re, Re, Rb^Gvs, Gg^Es, Gg, Gs, Gs, Gg, Gs, Gg, Gg^Es, Gg^Es, Gs, Ww, Ww, Ww, Ww, Gs^Fms, Gs^Fms, Hh^Fms, Gs^Fms, Hh^Fms, Gs^Fms, Gs^Fms, Gs^Fms, Hh^Fms, Gs^Fms, Gs, Gg, Rmo^Vdm, Gg, Gg, Gs, Kd, Cd, Wwt^Bw/, Wwt^Bw/, Wwt, Wwt, Wwt, Wwt, Wwt, Wwt, Wwt, Wot, Wot, Wot, Wot, Wot, Wot, Wot, Wot, Wot, Wot, Wot, Wot, Wot, Wot, Wot, Wot, Wot, Wot, Wot, Wot, Wot
Hh, Hh, Hh^Fms, Hh^Fms, Hh, Gg, Gg, Rb^Gvs, Rb^Gvs, Rb^Gvs, Rb^Gvs, Rb^Gvs, Gg, Re, Gg, Gs, Gs^Fms, Gs^Fms, Hh^Fms, Hh, Hh, Gg, Gg, Ww, Ww, Ww, Hh^Fms, Gs^Fms, Hh^Fms, Hh^Fms, Hh^Fms, Hh^Fms, Hh^Fms, Hh^Fms, Hh^Fms, Hh^Fms, Hh^Fms, Gs^Fms, Gs, Gg^Es, Gg, Gg, Rmo, Rmo, Gs, Cd, Wwt, Wwt, Wwt, Wwt, Wwt, Wwt, Wwt, Wwt, Wwt, Wot, Wwt, Wot, Wot, Wot, Wot, Wot, Wot, Wot, Wot, Wot, Wot, Wot, Wot, Wot, Wot, Wot, Wot, Wot, Wot, Wot
Hh, Hh^Fms, Hh, Hh^Fms, Hh, Gg, Gg, Gg, Gs, Rb^Gvs, Gg, Gg^Es, Gg, Re, Gg, Gs^Fms, Gll, Gs^Fms, Hh^Fms, Hh^Fms, Hh^Fms, Hh, Gg, Ww, Ww, Gs^Fms, Hh^Fms, Hh^Fms, Hh^Fms, Hh^Fms, Hh^Fms, Hh^Fms, Hh, Hh^Fms, Hh, Hh, Hh, Hh, Gg, Gg, Rmo, Rmo, Gg, Gg, Gs, Ds, Ds, Wwt, Ds, Wwt, Ds, Wwt, Ds, Wwt, Wwt, Wwt, Wwt, Wwt, Wwt, Wot, Wot, Wot, Wot, Wot, Wot, Wot, Wot, Wot, Wot, Wot, Wot, Wot, Wot, Wot, Wot, Wot
Gs^Fms, Gs^Fms, Gll, Hh, Gg^Es, Gg^Es, Gs, Gs, Gs^Fms, Gs, Gg, Gg, Gg, Re, Gs, Gs^Fms, Gs^Fms, Gs^Fms, Gs^Fms, Hh^Fms, Hh^Fms, Hh, Gs, Ww, Ww, Gg, Hh, Hh, Hh, Hh, Hh, Hh^Fms, Hh, Hh, Hh, Hh, Hh, Gg, Gg, Gg, Rmo, Gg, Gg, Gg^Es, Gs, Gs^Es, Gs, Ds, Hd, Ds, Hd, Ds, Hd, Ds, Wwt, Wwt, Wwt, Wwt, Wwt, Wwt, Wot, Wot, Wot, Wot, Wot, Wot, Wot, Wot, Wot, Wot, Wot, Wot, Wot, Wot, Wot, Wot
Gs^Fms, Gs^Fms, Gs^Fms, Gs, Gs, Gs, Gs^Fms, Gs^Fms, Hh^Fms, Hh, Hh, Gg, Gg, Re, Gs, Gs^Fms, Gs^Fms, Gll, Gs^Fms, Gs^Fms, Hh, Hh, Gs, Ww, Ww, Gg, Gg, Gs, Gg^Es, Gg^Es, Gs, Hh, Gg, Hh, Gg^Es, Gg, Gg, Gg, Gg, Rmo, Gg, Gg, Hh, Gs, Gs^Fms, Gs, Gs, Gs, Hh, Hd, Hh, Hd, Hh, Ds, Ds, Ds, Ds, Wwt, Wwt, Wwt, Wot, Wot, Wot, Wot, Wot, Wot, Wot, Wot, Wot, Wot, Wot, Wot, Wot, Wot, Wot, Wot
Gll, Gll, Gs^Fms, Gll, Gs^Fms, Gs^Fms, Gs^Fms, Hh^Fms, Hh^Fms, Hh^Fms, Hh^Fms, Hh, Gg, Re, Re, Gs, Gs, Gs^Fms, Gs, Gs, Hh, Hh, Gg, Ww, Ww, Gs, Cd, Gs, Cd, Gg, Cd, Gs, Cd, Gg^Es, Cd, Gg^Es, Cd, Cd, Rmo, Rmo, Gg, Hh, Hh, Hh, Hh, Gs^Fms, Gs^Fms, Gs^Fms, Gs^Fms, Hh^Fms, Hh^Fms, Hh, Hh^Fms, Hd, Hd, Hd, Ds, Wwt, Wwt, Wwt, Wwt, Wot, Wot, Wot, Wot, Wot, Wot, Wot, Wot, Wot, Wot, Wot, Wot, Wot, Wot, Wot
Gll, Gll, Gll, Gs^Fms, Gll, Gll, Gs^Fms, Hh^Fms, Hh, Hh^Fms, Hh^Fms, Hh, Hh, Gg, Re, Gg^Es, Gg, Gs, Gg, Gg, Cd, Gg, Cd, Ww, Ww, Ww, Ww, Cd, Rmo, Cd, Gg, Cd, Gg, Cd, Gg, Cd, Gg, Gg, Rmo, Gg, Cd, Hh, Hh, Hh, Hh^Fms, Hh, Gs^Fms, Gs^Fms, Hh^Fms, Hh^Fms, Hh^Fms, Hh^Fms, Hh^Fms, Hh, Hd, Hd, Ds, Wwt, Wwt, Wwt, Wwt, Wot, Wot, Wot, Wot, Wot, Wot, Wot, Wot, Wot, Wot, Wot, Wot, Wot, Wot, Wot
Gs^Fms, Gs^Fms, Gs^Fms, Gs^Fms, Gs^Fms, Gs^Fms, Gs, Gs, Gg, Hh, Hh^Fms, Hh^Fms, Hh, Gs, Gg, Re, Re, Gg, Cd, Cd, Gg, Cd, Rmo, Gg, Gg, Ww, Ww, Gg, Rmo, Gg, Gg, Gg, Gg, Rmo, Gg, Gg^Es, Rmo, Rmo, Cd, Cd, Gs, Gs, Hh, Hh^Fms, Hh^Fms, Hh^Fms, Hh^Fms, Gs^Fms, Gs^Fms, Hh^Fms, Hh^Fms, Hh^Fms, Hh^Fms, Hh, Hd, Hd, Ds, Wwt, Wwt, Wwt, Wot, Wot, Wot, Wot, Wot, Wot, Wot, Wot, Wot, Wot, Wot, Wot, Wot, Wot, Wot, Wot
Gs^Fms, Gs^Fms, Gs^Fms, Gs^Fms, Gs^Fms, Gs, Gg^Es, Gg, Gg, Hh, Hh^Fms, Hh^Fms, Hh, Gs, Gg, Gg, Re, Gg, Gg, Gg, Gg, Gg, Rmo, Rmo^Vdm, Gg, Ww, Ww, Gg, Rmo, Gg, Rmo^Vdm, Gg^Es, Gg, Rmo, Rmo, Rmo, Gg^Es, Gg, Cd, Gg, Gg, Gg, Hh, Hh^Fms, Hh^Fms, Hh^Fms, Hh^Fms, Gs^Fms, Gs^Fms, Gs^Fms, Gs^Fms, Hh^Fms, Hh, Hh, Hd, Ds, Wwt, Wwt, Wwt, Wwt, Wot, Wot, Wot, Wot, Wot, Wot, Wot, Wot, Wot, Wot, Wot, Wot, Wot, Wot, Wot, Wot
Gs^Fms, Gs^Fms, Gs^Fms, Gs^Fms, Gll, Gs, Gg, Gg, Gg, Hh, Hh^Fms, Hh^Fms, Hh, Gg, Gs, Cd, Gg, Re, Re, Gg^Es, Rmo, Rmo, Rmo, Rmo, Ww^Bsb\, Ww, Ww, Gg, Re, Rmo, Rmo, Rmo, Rmo, Rmo, Rmo^Vdm, Gg, Rmo, Gg, Rmo, Cd, Gs, Hh, Hh, Hh^Fms, Hh^Fms, Hh^Fms, Gs^Fms, Gs^Fms, Gs^Fms, Gs^Fms, Hh, Hh, Hd, Hd, Ds, Ds, Wwt, Wwt, Wwt, Wwt, Wot, Wot, Wot, Wot, Wot, Wot, Wot, Wot, Wot, Wot, Wot, Wot, Wot, Wot, Wot, Wot
Gs^Fms, Gs^Fms, Gs^Fms, Gll, Gs^Fms, Gs, Gg^Es, Gg, Hh, Hh, Hh, Hh^Fms, Hh, Gs, Cd, Cd, Gg, Gg, Rmo^Vdm, Rmo, Gg, Gg, Ww, Ww^Bsb\, Ww^Bsb\, Ww^Bsb\, Rmo, Re, Gg, Gg, Gg, Gg^Es, Gg, Rmo, Rmo, Rmo, Gg, Rmo, Cd, Cd, Gs, Hh, Hh, Hh^Fms, Hh, Hh, Gs, Gs^Fms, Gs, Hh^Fms, Hh, Hh, Hd, Ds, Wwt, Wwt, Wwt, Wwt, Wot, Wot, Wot, Wot, Wot, Wot, Wot, Wot, Wot, Wot, Wot, Wot, Wot, Wot, Wot, Wot, Wot, Wot
Gs^Fms, Gll, Gs^Fms, Gs, Gg, Gg, Gg^Efm, Gg, Gg, Hh, Hh, Hh, Gg, Gg, Cd, Gg, Gg^Es, Gg, Rmo, Rmo, Gg, Ww, Ww, Ww, Gg, Rmo, Rmo, Rmo, Rmo, Rmo^Vdm, Rmo, Gg^Es, Gg, Rmo, Re, Gg, Gg^Es, Gg, Cd, Gg, Gs, Hh, Hh, Hh, Gs, Gs, Gs, Gs^Fms, Gs, Gs, Hd, Hd, Hd, Ds, Wwt, Wwt, Wwt, Wwt, Wot, Wot, Wot, Wot, Wot, Wot, Wot, Wot, Wot, Wot, Wot, Wot, Wot, Wot, Wot, Wot, Wot, Wot
Gs, Gs^Fms, Gs, Gs, Gg^Efm, Gg^Efm, Gg, Gg, Gg, Gs, Gs, Gs, Cd, Cd, Gg, Rmo, Rmo, Gg, Rmo, Gg, Gg^Es, Ww, Ww, Kd, Gg, Gg, Rmo, Gg, Gg, Rmo, Gg, Rmo, Rmo, Rmo, Gg, Rmo^Vdm, Gg, Gg, Rmo, Cd, Gg, Gg^Es, Gg, Hh, Gg, Gg, Gg^Es, Gs, Gs, Gs, Ds, Hd, Ds, Ds, Wwt, Wwt, Wwt, Wwt, Wot, Wot, Wot, Wot, Wot, Wot, Wot, Wot, Wot, Wot, Wot, Wot, Wot, Wot, Wot, Wot, Wot, Wot
Gg, Gs, Gg, Gg, Gg, Gg, Gg, Gs, Cd, Cd, Cd, Cd, Rmo, Gg, Rmo^Vdm, Gg^Es, Rmo^Vdm, Rmo, Rmo, Gg^Es, Gg, Ww, Ww, Cd, Re, Gg^Es, Rmo, Rmo^Vdm, Gg^Es, Re, Re, Gg, Rmo, Rmo, Rmo, Re, Rmo, Rmo, Gg, Cd, Cd, Gg, Gg, Gg, Gg^Es, Gg, Gg, Gg, Gs, Ds, Wwt, Ds, Wwt, Wwt, Wwt, Wwt, Wot, Wot, Wot, Wot, Wot, Wot, Wot, Wot, Wot, Wot, Wot, Wot, Wot, Wot, Wot, Wot, Wot, Wot, Wot, Wot
Gg, Gg^Efm, Gg^Es, Gg^Efm, Rmo^Vdm, Gg^Es, Gg, Cd, Cd, Kd, Cd, Gg, Gg^Es, Rmo, Rmo, Gg, Rmo, Rmo, Gg, Gg, Ww, Ww, Ww, Cd, Gg, Rmo, Gg, Gg, Rmo^Vdm, Gg, Rmo, Rmo, Rmo^Vdm, Gg, Gg, Rmo, Rmo, Gg, Gg^Es, Gg, Gg, Cd, Gg, Gg^Es, Gg, Gg, Gg, Rmo^Vdm, Gs, Ds, Ds, Wwt, Wwt, Wwt, Wot, Wot, Wot, Wot, Wot, Wot, Wot, Wot, Wot, Wot, Wot, Wot, Wot, Wot, Wot, Wot, Wot, Wot, Wot, Wot, Wot, Wot
Gg, Gg, Gg^Efm, Gg^Efm, Gg, Gs, Gg, Cd, Gg, Cd, Rmo, Gg, Rmo^Vdm, Gg, Rmo, Rmo, Gg, Gg, Ww, Ww, Ww, Ww, Cd, Cd, Gg, Rmo, Gg, Gg, Gg, Rmo, Gg, Gg, Gg, Gg, Gg, Rmo^Vdm, Rmo, Rmo, Rmo, Gg^Es, Gg, Cd, Cd, Cd, Cd, Gg, Gg, Gg, Gg, Gs, Ds, Wwt, Wwt, Wwt, Wot, Wot, Wot, Wot, Wot, Wot, Wot, Wot, Wot, Wot, Wot, Wot, Wot, Wot, Wot, Wot, Wot, Wot, Wot, Wot, Wot, Wot
Gg, Gg, Gg, Gg, Gg, Gs, Cd, Cd, Gg, Gg, Gg, Rmo, Rmo, Rmo, Rmo, Gg, Ww, Ww, Ww, Ww, Cd, Cd, Gg, Gg^Efm, Gg^Efm, Rmo, Cd, Kd, Cd, Rmo, Gg, Gg^Es, Gg, Gg^Es, Rmo, Rmo, Gg^Es, Gg, Rmo, Rmo, Rmo, Gg, Gg, Gg, Re, Cd, Gg, Gg^Es, Gg, Gg^Es, Gs, Ds, Wwt, Wwt, Wwt, Wot, Wot, Wot, Wot, Wot, Wot, Wot, Wot, Wot, Wot, Wot, Wot, Wot, Wot, Wot, Wot, Wot, Wot, Wot, Wot, Wot
Rmo, Rmo, Rmo, Gg, Rmo, Rmo, Rmo, Gg, Rmo, Rmo^Vdm, Rmo, Rmo, Gg, Rmo, Ww^Bsb\, Ww^Bsb\, Ww^Bsb\, Ww, Kd, Cd, Gg^Es, Rmo, Rmo, Gg^Efm, Cd, Rmo, Rmo, Rmo, Rmo, Rmo, Cd, Gg, Rmo, Rmo, Gg, Re, Gg, Gg, Rmo, Gg, Gg, Rmo, Rmo, Re, Gg, Cd, Gg, Gg, Gg^Es, Gg, Gs, Ds, Ds, Wwt, Wwt, Wot, Wot, Wot, Wot, Wot, Wot, Wot, Wot, Wot, Wot, Wot, Wot, Wot, Wot, Wot, Wot, Wot, Wot, Wot, Wot, Wot
Rmo, Rmo, Rmo, Rmo, Rmo, Rmo, Rmo, Rmo, Gg, Rmo, Rmo^Vdm, Gg, Gg, Ww, Ww, Ww^Bsb\, Rmo, Rmo, Rmo, Gg, Gg^Es, Gg, Cd, Rmo, Rmo, Rmo, Rmo, Rmo, Rmo, Rmo, Rmo, Rmo, Cd, Gg, Gg, Rmo^Vdm, Gg, Gg, Rmo, Gg^Es, Rmo^Vdm, Re, Gg, Rmo, Rmo, Cd, Cd, Gg, Gg^Es, Gg, Gg, Gs, Ds, Wwt, Wwt, Wwt, Wot^Bw/, Wot, Wot, Wot, Wot, Wot, Wot, Wot, Wot, Wot, Wot, Wot, Wot, Wot, Wot, Wot, Wot, Wot, Wot, Wot
Gs, Gg, Gg, Rmo, Gg, Gg, Cd, Gg, Gg, Rmo, Gg, Gg, Rmo^Vdm, Ww, Ww, Gg, Gg, Rmo, Rmo, Rmo^Vdm, Gg, Kd, Rmo, Rmo, Rmo, Rmo, Cd, Kd, Cd, Rmo, Rmo, Rmo, Rmo, Kd, Gg, Gg, Gg^Es, Rmo^Vdm, Rmo, Re, Gg, Gg, Rmo, Rmo, Rmo, Rmo, Rmo, Gg, Gg, Gg, Gg, Gs, Gs, Ds, Cd, Wwt^Bw/, Wwt, Wot, Wot, Wot, Wot, Wot, Wot, Wot, Wot, Wot, Wot, Wot, Wot, Wot, Wot, Wot, Wot, Wot, Wot, Wot
Gs^Fms, Gs, Gs, Re, Gg, Gg, Gg, Cd, Re, Rmo, Rmo, Re, Gg, Ww, Ww, Cd, Cd, Gg, Gg, Rmo, Rmo, Cd, Rmo, Rmo, Kd, Cd, Rmo^Vdm, Cd, Rmo^Vdm, Cd, Kd, Rmo, Rmo, Cd, Gg, Gg^Es, Gg, Gg, Rmo, Gg, Rmo, Rmo, Gg, Gg, Gg, Rmo, Rmo, Rmo, Rmo, Rmo, Rmo, Gg, Rmo, Ds, Cd, Cd, Wwt^Bw/, Wot^Bw/, Wot, Wot, Wot, Wot, Wot, Wot, Wot, Wot, Wot, Wot, Wot, Wot, Wot, Wot, Wot, Wot, Wot, Wot
Gs^Fms, Gs^Fms, Gs^Fms, Rmo^Vdm, Gs, Gg, Gg, Cd, Gg, Gg, Rmo, Rmo^Vdm, Gg, Ww, Ww, Ww, Cd, Gg, Gg, Rmo, Gg^Efm, Rmo, Rmo, Rmo, Cd, Cd, Cd, Cd, Cd, Cd, Cd, Rmo, Rmo, Rmo, Rmo, Rmo, Rmo, Rmo, Rmo, Rmo, Re, Gg, Gg, Gg, Cd, Gg, Cd, Gg, Gg, Gg, Gg, Rmo, Rmo, Kd, Cd, Cd, Wwt^Bw\, Wwt, Wot, Wot, Wot, Wot, Wot, Wot, Wot, Wot, Wot, Wot, Wot, Wot, Wot, Wot, Wot, Wot, Wot, Wot
Gs^Fms, Gll, Gs^Fms, Gs, Gg, Gs, Gs, Cd, Cd, Gg, Rmo, Gg, Cd, Gg, Ww, Ww, Ww, Cd, Gg, Rmo, Gg^Efm, Cd, Rmo, Rmo, Cd, Rmo^Vdm, Cd, 3 Kd, Cd, Rmo^Vdm, Cd, Rmo, Rmo, Cd, Rmo, Gg, Gg, Gg^Es, Rmo, Gg, Rmo^Vdm, Re, Re, Cd, Gg, Cd, Gg, Gg, Gg, Gg^Efm, Gg, Gg, Gs, Ds, Cd, Cd, Wwt, Wwt^Bw\, Wot, Wot, Wot, Wot, Wot, Wot, Wot, Wot, Wot, Wot, Wot, Wot, Wot, Wot, Wot, Wot, Wot, Wot
Gs^Fms, Gll, Gll, Gs, Gs, Hh, Hh, Gs^Fms, Gs^Fms, Cd, Cd, Cd, Gs, Cd, Ds, Ww, Ww, Cd, Gg, Rmo, Rmo, Rmo, Rmo, Rmo, Kd, Cd, Rmo^Vdm, Cd, Rmo^Vdm, Cd, Kd, Rmo, Rmo, Rmo, Gg, Gg, Rmo^Vdm, Gg, Rmo, Re, Gg, Gg, Cd, Cd, Gg, Gg, Gg^Efm, Gg^Efm, Gg^Efm, Gg^Es, Gg, Gg^Efm, Gs, Ds, Wwt, Wwt^Bw\, Wwt^Bw\, Wwt, Wot, Wot, Wot, Wot, Wot, Wot, Wot, Wot, Wot, Wot, Wot, Wot, Wot, Wot, Wot, Wot, Wot, Wot
Gll, Gs^Fms, Gs^Fms, Gs^Fms, Hh^Fms, Hh, Hh^Fms, Hh^Fms, Gll, Gs, Gs, Gg, Gg, Ds, Ww, Ww, Ww, Cd, Gg, Rmo, Gg^Efm, Cd, Rmo, Rmo, Rmo, Cd, Cd, Cd, Cd, Cd, Rmo, Rmo, Rmo, Cd, Gg, Gg, Gg, Re, Rmo, Gg, Gg^Es, Gg^Es, Cd, Gg, Gg, Gg^Efm, Gg, Gg^Efm, Gg^Efm, Gg, Gs, Gs, Ds, Ds, Wwt, Wwt, Wot, Wot, Wot, Wot, Wot, Wot, Wot, Wot, Wot, Wot, Wot, Wot, Wot, Wot, Wot, Wot, Wot, Wot, Wot, Wot
Gll, Gs^Fms, Gs^Fms, Hh^Fms, Hh, Hh^Fms, Mm, Hh^Fms, Hh, Gll, Gs^Fms, Gs, Ww, Ww, Ww, Ww, Ds, Cd, Gg, Rmo, Gg^Efm, Kd, Cd, Rmo, Rmo, Rmo, Rmo, Kd, Rmo, Rmo, Rmo, Rmo, Cd, Kd, Gg, Gg^Es, Gg, Gg, Rmo, Gg, Gg, Gg^Es, Cd, Gg, Gg^Efm, Gg^Es, Gg, Gg, Gg^Efm, Gs, Ds, Ds, Wwt, Wwt, Wwt, Wwt, Wot, Wot, Wot, Wot, Wot, Wot, Wot, Wot, Wot, Wot, Wot, Wot, Wot, Wot, Wot, Wot, Wot, Wot, Wot, Wot
Gs^Fms, Gs^Fms, Gs^Fms, Hh^Fms, Hh, Mm, Mm, Hh^Fms, Hh^Fms, Gs^Fms, Gll, Gs^Fms, Ww, Ww, Ds, Ds, Gs, Cd, Re, Rmo, Rmo, Gg^Efm, Gg^Efm, Rmo, Cd, Rmo, Rmo, Rmo, Rmo, Rmo, Cd, Rmo, Gg, Gg, Gg, Gg, Rmo, Rmo, Gg, Gg, Cd, Cd, Gg, Gg, Gs, Gs, Gs, Gg^Efm, Gs, Gs, Ds, Wwt, Wwt, Wwt, Wwt, Wwt, Wot, Wot, Wot, Wot, Wot, Wot, Wot, Wot, Wot, Wot, Wot, Wot, Wot, Wot, Wot, Wot, Wot, Wot, Wot, Wot
Gll, Gs^Fms, Gs^Fms, Hh^Fms, Hh, Mm, Mm, Mm, Hh^Fms, Gs^Fms, Gs^Fms, Ds, Ww, Ww, Ww, Ds, Gs, Cd, Cd, Gg, Gg, Rmo, Rmo, Rmo, Rmo, Rmo, Cd, Rmo, Cd, Rmo, Rmo, Rmo, Rmo, Rmo^Vdm, Rmo, Rmo, Gg, Re, Gg, Gg, Cd, Gg, Ww, Ww, Ww, Ds, Ds, Gs, Ds, Ds, Wwt, Wwt, Wwt, Wwt, Wwt, Wot, Wot, Wot, Wot, Wot, Wot, Wot, Wot, Wot, Wot, Wot, Wot, Wot, Wot, Wot, Wot, Wot, Wot, Wot, Wot, Wot
Gll, Gs^Fms, Gll, Gll, Gs^Fms, Hh^Fms, Mm, Hh^Fms, Gs^Fms, Gs^Fms, Gs^Fms, Ds, Ds, Ww, Ww, Ds, Ds, Gs, Gg, Cd, Cd, Gg, Gg, Rmo, Rmo, Gg^Efm, Gg^Efm, Kd, Gg^Efm, Gg^Efm, Rmo, Rmo, Re, Rmo, Gg, Gg, Gg, Re, Re, Cd, Gg, Ww, Ww, Ww, Ww, Ww, Ww, Ds, Ww, Ww, Ww, Wwt, Ds, Wwt, Wwt, Wwt, Wot, Wot, Wot, Wot, Wot, Wot, Wot, Wot, Wot, Wot, Wot, Wot, Wot, Wot, Wot, Wot, Wot, Wot, Wot, Wot
Gs^Fms, Gs^Fms, Gs^Fms, Gs^Fms, Gs^Fms, Hh^Fms, Hh, Hh, Gll, Gs^Fms, Gs^Fms, Gs, Ds, Ww, Ww, Ww, Ww, Ww, Ww, Gs, Gs, Cd, Cd, Re, Gg, Rmo, Rmo, Rmo, Rmo, Rmo, Gg, Gg, Re, Gg, Cd, Cd, Cd, Cd, Re, Gg, Gg, Ww, Ww, Ww, Ww, Ww, Ww, Ww, Ww, Ww, Ds, Ds, Hd, Ds, Wwt, Wwt, Wwt, Wot, Wot, Wot, Wot, Wot, Wot, Wot, Wot, Wot, Wot, Wot, Wot, Wot, Wot, Wot, Wot, Wot, Wot, Wot
Gll, Gs^Fms, Gll, Gs^Fms, Gll, Gll, Hh, Gll, Gs^Fms, Gs^Fms, Gg, Gs, Gs, Ds, Gs, Ww, Ww, Ww, Ww, Ww, Ww, Gg, Cd, Re, Gg, Rmo, Rmo, Gg, Cd, Gg, Cd, Cd, Cd, Cd, Gg, Gs, Gs, Gg, Re, Re, Re, Ww, Ww, Ds, Ds, Ww, Ww, Ww, Ds, Ds, Hd, Hd, Hd, Ds, Wwt, Wwt, Wwt, Wot, Wot, Wot, Wot, Wot, Wot, Wot, Wot, Wot, Wot, Wot, Wot, Wot, Wot, Wot, Wot, Wot, Wot, Wot
Gll, Gs^Fms, Gs^Fms, Gll, Hh^Fms, Hh, Hh, Hh^Fms, Hh^Fms, Gs^Fms, Gg, Gg, Gg, Gg, Rb^Gvs, Gg, Gg, Gg, Gg, Ww, Ww, Ww, Gs, Cd, Cd, Rmo, Rmo, Cd, Gg, Cd, Gs, Gg, Gs, Gs, Ww, Ww, Ww, Gs, Re, Ket, Ww^Bw\, Ww, Ww, Ds, Gs, Ds, Ds, Ds, Hd, Hd, Hh, Hh, Hd, Ds, Ds, Wwt, Wwt, Wot, Wot, Wot, Wot, Wot, Wot, Wot, Wot, Wot, Wot, Wot, Wot, Wot, Wot, Wot, Wot, Wot, Wot, Wot
Gll, Gs^Fms, Gs^Fms, Gs^Fms, Hh^Fms, Hh, Hh, Hh, Hh^Fms, Gs^Fms, Gg, Rmo^Vdm, Rb^Gvs, Rb^Gvs, Rb^Gvs, Rb^Gvs, Rb^Gvs, Gg, Gg, Gg, Ww, Ww, Ww, Gg, Cd, Rmo, Rmo, Cd, Ww, Gs, Ww, Ww, Ww, Ww, Ww, Ww, Ww, Ww, Ww, Ww, Ww, Ww, Ds, Ds, Gs^Es, Gs, Gs, Gs, Hh, Hh, Hh, Hh, Hd, Hd, Ds, Wwt, Wwt, Wot, Wot, Wot, Wot, Wot, Wot, Wot, Wot, Wot, Wot, Wot, Wot, Wot, Wot, Wot, Wot, Wot, Wot, Wot
Gll, Gs^Fms, Gll, Gs^Fms, Gs^Fms, Hh^Fms, Hh, Hh, Hh^Fms, Gs^Fms, Rb^Gvs, Gg, Gg, Rb^Gvs, Rb^Gvs, Rb^Gvs, Gg, Gg, Rb^Gvs, Gg, Gg, Ww, Ww, Ww, Ww, Ww^Bsb|, Ww^Bsb|, Ww, Ww, Ww, Ww, Ww, Ww, Ww, Gg, Gg, Gg, Ww, Ww, Ww, Ds, Ds, Gs, Gs^Es, Hh, Hh, Hh, Hh, Hh^Fms, Hh^Fms, Hh, Hd, Ds, Ds, Wwt, Wwt, Wwt, Wot, Wot, Wot, Wot, Wot, Wot, Wot, Wot, Wot, Wot, Wot, Wot, Wot, Wot, Wot, Wot, Wot, Wot, Wot
Gs^Fms, Gs^Fms, Gll, Gll, Gll, Gs^Fms, Gs, Hh, Rb^Gvs, Rb^Gvs, Rb^Gvs, Rb^Gvs, Rb^Gvs, Gg, Gg, Gg, Rb^Gvs, Rb^Gvs, Rb^Gvs, Rb^Gvs, Rb^Gvs, Gg, Gg, Ww, Gg, Ww^Bsb|, Ww^Bsb|, Ww, Gg, Ww, Gg, Gg, Gg, Gg, Rb^Gvs, Gg^Es, Gg, Gg, Gg, Gs, Gs, Gs, Hh, Hh, Hh, Hh, Hh^Fms, Hh^Fms, Hh^Fms, Hh, Gg, Hd, Ds, Wwt, Wwt, Wwt, Wot, Wot, Wot, Wot, Wot, Wot, Wot, Wot, Wot, Wot, Wot, Wot, Wot, Wot, Wot, Wot, Wot, Wot, Wot, Wot
Gs^Fms, Gs^Fms, Gs^Fms, Gs^Fms, Gs^Fms, Gs^Fms, Gs^Fms, Gs, Gs, Rb^Gvs, Rb^Gvs, Rb^Gvs, Gg, Gg, Rb^Gvs, Rmo^Vdm, Gg, Rb^Gvs, Rb^Gvs, Rb^Gvs, Gg, Rmo^Vdm, Gg, Gg, Gg, Rmo, Rmo, Gg, Gg, Gg, Rb^Gvs, Rmo^Vdm, Rb^Gvs, Rb^Gvs, Rb^Gvs, Rb^Gvs, Rb^Gvs, Rmo^Vdm, Gs, Gs, Gs, Hh, Hh^Fms, Hh, Hh, Hh^Fms, Hh^Fms, Hh^Fms, Hh^Fms, Hh, Gs, Gs, Ds, Wwt, Wwt, Wwt, Wot, Wot, Wot, Wot, Wot, Wot, Wot, Wot, Wot, Wot, Wot, Wot, Wot, Wot, Wot, Wot, Wot, Wot, Wot, Wot
Gs^Fms, Gs^Fms, Gs^Fms, Gs^Fms, Gll, Gs^Fms, Gll, Gs^Fms, Gs, Gg, Rmo^Vdm, Gg, Rb^Gvs, Rb^Gvs, Rb^Gvs, Rb^Gvs, Rb^Gvs, Gg, Gg, Gg, Rb^Gvs, Rb^Gvs, Rb^Gvs, Gg, Gg, Rmo, Rmo, Gg, Rb^Gvs, Rb^Gvs, Rb^Gvs, Rb^Gvs, Rb^Gvs, Rb^Gvs, Rb^Gvs, Rb^Gvs, Gs^Fms, Gs, Gs, Gs^Fms, Gs^Fms, Gll, Gs^Fms, Hh^Fms, Gll, Hh^Fms, Hh^Fms, Hh^Fms, Hh, Hh, Gs, Ds, Wwt, Wwt, Wwt, Wwt, Wot, Wot, Wot, Wot, Wot, Wot, Wot, Wot, Wot, Wot, Wot, Wot, Wot, Wot, Wot, Wot, Wot, Wot, Wot, Wot
Gll, Gs^Fms, Gs^Fms, Gs^Fms, Hh, Gll, Gs, Gs^Fms, Rb^Gvs, Rb^Gvs, Rb^Gvs, Gg, Gg, Rb^Gvs, Rb^Gvs, Rb^Gvs, Gs, Gs, Gs, Rb^Gvs, Rb^Gvs, Rb^Gvs, Rb^Gvs, Rb^Gvs, Gg, Rmo, Rmo, Gg, Gg, Rb^Gvs, Rb^Gvs, Rb^Gvs, Gg, Gg, Gs, Gg, Gs^Fms, Gs^Fms, Gs^Fms, Gs^Fms, Gs^Fms, Gs^Fms, Gll, Gs^Fms, Gll, Hh^Fms, Hh, Hh, Hh, Hh, Gs, Ds, Ds, Wwt, Wwt, Wwt, Wot, Wot, Wot, Wot, Wot, Wot, Wot, Wot, Wot, Wot, Wot, Wot, Wot, Wot, Wot, Wot, Wot, Wot, Wot, Wot
Gll, Hh^Fms, Hh^Fms, Hh^Fms, Hh, Hh, Gs, Rb^Gvs, Rb^Gvs, Rb^Gvs, Rb^Gvs, Rb^Gvs, Gg, Gg, Gs, Gs^Fms, Gs^Fms, Gs^Fms, Gs^Fms, Gs, Gs^Fms, Rb^Gvs, Gg, Gg, Gg, Rmo, Rmo, Gg, Rb^Gvs, Rb^Gvs, Rb^Gvs, Rmo^Vdm, Gg, Gs, Gs, Gs^Fms, Gs^Fms, Gs^Fms, Gs^Fms, Gs^Fms, Gs^Fms, Gs^Fms, Gs^Fms, Gs^Fms, Gll, Gs^Fms, Hh^Fms, Hh^Fms, Hh, Hh, Gg, Gs, Ds, Wwt, Wwt, Wwt, Wwt, Wwt, Wwt, Wot, Wot, Wot, Wot, Wot, Wot, Wot, Wot, Wot, Wot, Wot, Wot, Wot, Wot, Wot, Wot, Wot
Gs^Fms, Hh, Hh, Hh, Hh^Fms, Gll, Gs^Fms, Gs^Fms, Gs, Rb^Gvs, Gg, Gg, Gg, Gg, Gg, Gs, Gs, Gs^Fms, Hh^Fms, Gll, Gs^Fms, Gs^Fms, Gs, Gg, Gg, Rmo, Rmo, Rb^Gvs, Rb^Gvs, Rb^Gvs, Rb^Gvs, Rb^Gvs, Gs^Fms, Gs, Gs^Fms, Hh^Fms, Hh^Fms, Hh^Fms, Hh^Fms, Gs^Fms, Gll, Gll, Gll, Gs^Fms, Gs^Fms, Gll, Gs^Fms, Hh^Fms, Gs, Gg, Gg, Gs, Ds, Wwt, Wwt, Wwt, Wwt, Wwt, Wwt, Wwt, Wot, Wot, Wot, Wot, Wot, Wot, Wot, Wot, Wot, Wot, Wot, Wot, Wot, Wot, Wot, Wot
Gs^Fms, Hh^Fms, Hh^Fms, Hh^Fms, Gs^Fms, Gs^Fms, Gll, Gs^Fms, Gs, Gg, Hh, Hh, Hh, Gg, Hh, Gg, Hh, Hh^Fms, Hh, Hh^Fms, Gs^Fms, Gs^Fms, Gs, Gg, Gg, Rmo, Rmo, Gg, Gg, Rb^Gvs, Gs, Gs, Gs^Fms, Gs^Fms, Hh^Fms, Hh^Fms, Hh, Hh, Hh, Hh^Fms, Hh^Fms, Gs^Fms, Gll, Gs^Fms, Gll, Gs^Fms, Gs^Fms, Gs, Gg, Gg, Gg, Gs, Gs, Ds, Ds, Wwt, Wwt, Wwt, Wwt, Wwt, Wot, Wot, Wot, Wot, Wot, Wot, Wot, Wot, Wot, Wot, Wot, Wot, Wot, Wot, Wot, Wot
Gs^Fms, Gs^Fms, Gs^Fms, Gs^Fms, Gs^Fms, Gll, Gs^Fms, Gs, Gg, Gg, Hh, Hh, Mm, Hh, Hh, Hh, Hh, Mm, Mm, Hh^Fms, Hh, Gs, Gg, Gg, Gg, Rmo, Rmo, Gg, Gg, Gg, Gs, Gs^Fms, Gs^Fms, Gll, Hh, Hh, Mm, Hh, Mm, Hh, Hh, Hh^Fms, Gll, Gs^Fms, Gs^Fms, Gs^Fms, Gs^Fms, Gs, Gs, Gg^Es, Gg, Gg, Gs, Gs, Ds, Wwt, Wwt, Wwt, Wwt, Wwt, Wot, Wot, Wot, Wot, Wot, Wot, Wot, Wot, Wot, Wot, Wot, Wot, Wot, Wot, Wot, Wot
Gs^Fms, Gs^Fms, Gll, Gs^Fms, Gll, Gs^Fms, Gs, Gs, Hh, Gg, Hh, Hh, Mm, Mm, Mm, Hh, Mm, Mm, Mm, Hh, Hh, Hh, Gg, Gg, Gg, Rmo, Rmo, Gg, Gg, Gg, Gs, Gs^Fms, Gs^Fms, Hh^Fms, Hh, Hh, Mm, Mm, Mm, Mm, Hh, Hh, Hh^Fms, Gs^Fms, Gs^Fms, Gs^Fms, Gs^Fms, Gs^Fms, Gs, Gg, Gg, Gs, Ds, Ds, Wwt, Wwt, Wwt, Wwt, Wwt, Wwt, Wot, Wot, Wot, Wot, Wot, Wot, Wot, Wot, Wot, Wot, Wot, Wot, Wot, Wot, Wot, Wot
Gg, Gs^Fms, Gs^Fms, Gs^Fms, Gs^Fms, Gs^Fms, Gg, Gg, Hh, Hh, Hh, Mm, Mm, Mm, Mm, Mm, Gg, Mm, Mm, Mm, Mm, Hh, Hh, Gg, Gg, Rmo, Rmo, Gg, Gg, Gg, Gg, Gs^Fms, Hh^Fms, Hh^Fms, Gg, Mm, Mm, Mm, Mm, Mm, Gg, Hh, Hh, Hh^Fms, Gs^Fms, Gs^Fms, Gs^Fms, Gs^Fms, Gs, Gg^Es, Gg, Gs, Ds, Wwt, Wwt, Wwt, Wwt, Wwt, Wot, Wot, Wot, Wot, Wot, Wot, Wot, Wot, Wot, Wot, Wot, Wot, Wot, Wot, Wot, Wot, Wot, Wot
