border_size=1
usage=map

Wot, Wot, Wot, Wot, Wot, Wot, Wot, Wot, Wot, Wot, Wot, Wot, Wwrt, Wot, Wot, Wot, Wot, Wot, Wwrt, Wot, Wot, Wot, Wot, Wot, Wot, Wot, Wot, Wot, Wot, Wot, Wot, Wot, Wot, Wot, Wot, Wot, Wot, Wot, Wot, Wot, Wot, Wot, Wot, Wot, Wot, Wot, Wot, Wot, Wot, Wot, Wot, Wot, Wot, Wot, Wot, Wot, Wot, Wot, Wot, Wot, Wot
Wwt, Wot, Wot, Wot, Wot, Wwt, Wot, Wot, Wot, Wwt, Wot, Wwrt, Wot, Wot, Wwt, Wwrt, Wot, Wwrt, Wot, Wot, Wwrt, Wwrt, Wwrt, Wot, Wot, Wwrt, Wot, Wwrt, Wwrt, Wot, Wwrt, Wot, Wot, Wot, Wot, Wot, Wot, Wot, Wot, Wot, Wot, Wot, Wot, Wot, Wot, Wot, Wot, Wot, Wot, Wot, Wot, Wot, Wot, Wot, Wot, Wot, Wot, Wot, Wot, Wot, Wot
Wot, Wwt, Wot, Wot, Wot, Wot, Wwt, Wwt, Wwt, Wwt, Wwt, Wwt, Wwt, Wot, Wot, Wwrt, Wot, Wot, Wot, Wot, Wot, Wot, Wot, Wot, Wot, Wot, Wot, Wot, Wot, Wot, Wot, Wwrt, Wot, Wot, Wot, Wot, Wot, Wot, Wot, Wot, Wot, Wot, Wot, Wot, Wot, Wot, Wot, Wot, Wot, Wot, Wot, Wot, Wot, Wot, Wot, Wot, Wot, Wot, Wot, Wot, Wot
Wot, Wot, Wot, Wot, Wwt, Wwt, Wwt, Wwt, Ds, Wwt, Ds, Wwt, Wwt, Wwt, Wwt, Wot, Wot, Wwrt, Wot, Wot, Wot, Wot, Wot, Wot, Wwrt, Wot, Wot, Wot, Wot, Wot, Wot, Wot, Wwrt, Wot, Wot, Wwrt, Wwrt, Wot, Wot, Wwrt, Wot, Wot, Wot, Wot, Wot, Wot, Wot, Wot, Wot, Wot, Wot, Wot, Wot, Wot, Wot, Wot, Wot, Wot, Wot, Wot, Wot
Wwt, Wwt, Wwt, Wwt, Wwt, Wwt, Ds, Ds, Dd^Ftd, Ds, Dd^Ftd, Ds, Wwt, Wwt, Wwt, Wwt, Wwt, Wwt, Wwt, Wot, Wot, Wwrt, Wot, Wot, Wot, Wot, Wwrt, Wot, Wot, Wot, Wot, Wot, Wot, Wot, Wwrt, Wot, Wot, Wot, Wot, Wot, Wot, Wwrt, Wot, Wwrt, Wot, Wot, Wot, Wot, Wot, Wot, Wot, Wot, Wot, Wot, Wot, Wot, Wot, Wot, Wot, Wot, Wot
Wwt, Wwt, Wwt, Wwt, Ds, Ds, Ds, Dd^Ftd, Dd^Ftd, Dd^Ftd, Hd, Ds, Ds, Wwt, Wwt, Wwt, Wwt, Wwt, Wwt, Wwt, Wwt, Wot, Wot, Wot, Wot, Wot, Wot, Wot, Wot, Wwrt, Wwrt, Wot, Wot, Wot, Wwrt, Wot, Wot, Wwrt, Wot, Wot, Wot, Wot, Wot, Wot, Wot, Wwrt, Wwrt, Wot, Wwrt, Wot, Wot, Wot, Wot, Wot, Wot, Wot, Wot, Wot, Wot, Wot, Wot
Ds, Wwt, Ds, Ds, Ds, Ds, Gs, Dd^Ftd, Gs^Ftp, Hh^Ftp, Hh^Ftp, Hd, Hd, Ds, Ds, Ds, Ds, Wwt, Wwt, Wwt, Wot, Wot, Wwt, Wwrt, Wot, Wot, Wot, Wot, Wot, Wot, Wot, Wot, Wot, Wwrt, Wwrt, Wot, Wot, Wot, Wot, Wwrt, Wot, Wot, Wot, Wot, Wot, Wot, Wot, Wot, Wot, Wot, Wwrt, Wot, Wot, Wot, Wot, Wot, Wot, Wot, Wot, Wot, Wot
Dd^Ftd, Ds, Dd^Ftd, Dd^Ftd, Gs, Gs, Gll, Gs^Ftp, Gll, Hh^Ftp, Hh^Ftp, Hd^Ftd, Hh, Hd, Hd, Hd, Hd, Ds, Wwt, Wwt, Wwt, Wot, Wwt, Wot, Wwt, Wot, Wot, Wot, Wot, Wot, Wot, Wot, Wot, Wot, Wot, Wot, Wot, Wot, Wot, Wot, Wot, Wwrt, Wwrt, Wot, Wwrt, Wot, Wot, Wot, Wot, Wot, Wot, Wot, Wot, Wot, Wot, Wot, Wot, Wot, Wot, Wot, Wot
Hd^Ftd, Dd^Ftd, Gs^Ftp, Gs^Ftp, Gs^Ftp, Gs^Ftp, Gs^Ftp, Gs^Ftp, Gs^Ftp, Gs^Ftp, Gs^Ftp, Hd^Ftd, Hh, Hh, Hh, Hd, Ds, Ds, Wwt, Wwt, Wwt, Wwt, Wwt, Wot, Wwt, Wwt, Wot, Wot, Wot, Wot, Wot, Wot, Wot, Wot, Wot, Wwrt, Wot, Wot, Wot, Wot, Wot, Wot, Wot, Wwrt, Wot, Wwrt, Wot, Wot, Wot, Wot, Wot, Wot, Wot, Wot, Wot, Wot, Wot, Wot, Wot, Wot, Wot
Hh, Hh^Ftp, Hh^Ftp, Gs^Ftp, Gll, Gs^Ftp, Gll, Gs^Ftp, Gs^Ftp, Gs^Ftp, Gs^Ftp, Hh, Hh, Hh, Hh, Hd, Dd^Ftd, Ds, Ds, Ds, Ds, Wwt, Wwt, Wwt, Wwt, Wwt, Wot, Wwt, Wot, Wot, Wot, Wot, Wot, Wot, Wot, Wot, Wot, Wot, Wot, Wot, Wot, Wot, Wot, Wot, Wot, Wot, Wot, Wot, Wot, Wot, Wot, Wot, Wot, Wot, Wot, Wot, Wot, Wwrt, Wot, Wot, Wot
Hh^Ftp, Hh^Ftp, Hh^Ftp, Gll, Gs^Ftp, Gs^Ftp, Gs^Ftp, Gs^Ftp, Gs^Ftp, Gs^Ftp, Gll, Gll, Gll, Gll, Gs^Ftp, Dd^Ftd, Dd^Ftd, Dd^Ftd, Dd^Ftd, Ds, Ds, Ds, Wwt, Wwt, Wwt, Wwt, Wwt, Wot, Wwt, Wot, Wot, Wot, Wot, Wot, Wot, Wot, Wot, Wot, Wwt, Wot, Wot, Wot, Wot, Wwrt, Wwrt, Wot, Wot, Wot, Wot, Wot, Wot, Wot, Wot, Wot, Wot, Wot, Wot, Wot, Wot, Wwrt, Wot
Hh^Ftp, Hh^Ftp, Gs^Ftp, Gll, Gs^Ftp, Gs^Ftp, Gs^Ftp, Gll, Gll, Gll, Gs^Ftp, Gll, Gs^Ftp, Gs^Ftp, Gs^Ftp, Gs^Ftp, Gs^Ftp, Gs^Ftp, Dd^Ftd, Dd^Ftd, Ds, Ds, Ds, Wwt, Wwt, Wwt, Wwt, Wwt, Wwt, Wot, Wwt, Wot, Wot, Wot, Wot, Wot, Wwt, Wwt, Wot, Wot, Wwt, Wot, Wot, Wot, Wot, Wwrt, Wot, Wwrt, Wot, Wot, Wot, Wot, Wot, Wot, Wot, Wot, Wot, Wot, Wot, Wwrt, Wwrt
Gs, Gs^Ftp, Gs, Gs^Ftp, Gs, Gs, Gs, Gll, Gs^Ftp, Gs^Ftp, Gs^Ftp, Gll, Gs^Ftp, Gll, Gll, Gs^Ftp, Gs^Ftp, Gs^Ftp, Gs^Ftp, Dd^Ftd, Dd^Ftd, Ds, Ds, Wwt, Wwt, Wwt, Wwt, Wwt, Wwt, Wot, Wot, Wwt, Wwt, Wwt, Wwt, Wwt, Wwt, Wwt, Wwt, Wwt, Wwt, Wwt, Wot, Wwt, Wwt, Wot, Wot, Wot, Wot, Wwrt, Wot, Wot, Wot, Wot, Wot, Wot, Wwrt, Wot, Wot, Wot, Wot
Gg, Gs, Gg, Gs, Gs, Gg, Gg, Gs, Gs, Gs^Ftp, Gs^Ftp, Gll, Gs^Ftp, Gs^Ftp, Re^Vct, Gs, Gs^Ftp, Gs^Ftp, Gs^Ftp, Gs^Ftp, Dd^Ftd, Ds, Hd, Ds, Ds, Ds, Ds, Wwt, Wwt, Wwt, Wwt, Wot, Wwt, Wot, Wwt, Wwt, Wwt, Wwt, Wwt, Wwt, Wwt, Wwt, Wot, Wot, Wot, Wot, Wot, Wot, Wot, Wot, Wot, Wot, Wot, Wot, Wot, Wot, Wot, Wwrt, Wot, Wot, Wot
Rmo, Gg, Gg, Gs, Gs, Gg, Gs, Gg, Gs, Gs, Gs, Gs^Ftp, Gs, Gs, Gg, Gs, Gs, Gll, Gs^Ftp, Gs^Ftp, Gs^Ftp, Hd, Hd, Hd, Hd^Ftd, Hd, Hd, Ds, Ds, Wwt, Wwt, Wwt, Wwt, Wwt, Wwt, Wwt, Ds, Ds, Ds, Ds, Ds, Wwt, Wwt, Wot, Wot, Wwt, Wwt, Wwt, Wot, Wot, Wot, Wot, Wot, Wot, Wot, Wot, Wot, Wot, Wwrt, Wot, Wot
Rmo, Rmo, Rmo, Gg, Gg, Gg, Gs, Gg, Gs, Gg, Re^Vct, Gs, Gg, Gg, Ke, Gg, Ce, Gs, Re^Vct, Hh^Ftp, Hh^Ftp, Hh^Ftp, Hd^Ftd, Hd^Ftd, Hd^Ftd, Hd^Ftd, Hd^Ftd, Hd, Ds, Wwt, Wwt, Wwt, Wwt, Wwt, Ds, Ds, Dd^Ftd, Dd^Ftd, Dd^Ftd, Dd^Ftd, Ds, Wwt, Wwt, Wwt, Wwt, Wwt, Wwt, Wwt, Wwt, Wot, Wot, Wot, Wot, Wot, Wot, Wot, Wot, Wot, Wot, Wwrt, Wot
Gg, Rmo, Rmo, Rmo, Rmo, Gg, Gg, Gg, Gs, Gg, Gg, Gg, Gs, 1 Ke, Ce, Ce, Ce, Gs, Gs^Ftp, Hh^Ftp, Hh^Ftp, Hh, Hh, Hh, Hh, Hd^Ftd, Hd^Ftd, Hd, Hd, Ds, Wwt, Wwt, Wwt, Wwt, Ds, Dd^Ftd, Gs^Ftp, Dd^Ftd, Gs^Ftp, Gs^Ftp, Gs, Ds, Ds, Wwt, Wwt^Bsb/, Wwt, Wwt^Bsb/, Wwt, Wwt, Wot, Wwt, Wwt, Wwt, Wot, Wot, Wwt, Wwt, Wot, Wot, Wwrt, Wwrt
Gs, Gg, Gs, Rmo, Rmo, Rmo, Rmo, Gs, Gg, Gg, Rmo, Gg, Ce, Ce, Ce, Ce, Gs, Gs^Ftp, Gs^Ftp, Hh^Ftp, Hh^Ftp, Hh, Hh, Hh, Hh, Hh, Hd^Ftd, Hd^Ftd, Hd^Ftd, Ds, Ds, Ds, Ds, Ds, Gs^Ftp, Gs^Ftp, Gs^Ftp, Gs^Ftp, Gs^Ftp, Gs^Ftp, Gs, Gs, Cd, Ds^Bsb/, Cd, Wwt^Bsb/, Wwt^Bsb/, Wwt^Bsb/, Wwt, Wwt, Wwt, Wot, Wwt, Wwt, Wot, Wot, Wwt, Wwt, Wot, Wot, Wot
Gs^Ftp, Gs, Gs, Gs, Gg, Rmo, Rmo, Rmo, Rmo, Rmo, Rmo, Rmo, Rmo, Ce, Gg, Ce, Gg, Gs, Gs^Ftp, Gs^Ftp, Hh^Ftp, Hh, Hh^Ftp, Hh^Ftp, Hh, Hh, Hh^Ftp, Hh^Ftp, Hh^Ftp, Dd^Ftd, Dd^Ftd, Dd^Ftd, Gs^Ftp, Gs^Ftp, Gll, Gs^Ftp, Gll, Gs^Ftp, Gs^Ftp, Gs, Gs, Gg, Gg, Cd, Kd, Cd, Wwt^Bsb/, Wwt^Bsb/, Wwt, Wwt, Wwt, Wwt, Wwt, Wwt, Wwt, Wwt, Wwt, Wwt, Wwt, Wwt, Wot
Gs^Ftp, Gg, Gs^Ftp, Gs, Gs, Gg, Gg, Rmo, Rmo, Rmo, Gg, Rmo, Rmo, Rmo, Rmo, Gg, Gg, Gs, Re^Vct, Gs^Ftp, Hh^Ftp, Hh, Hh^Ftp, Hh^Ftp, Hh, Hh, Hh^Ftp, Hh^Ftp, Gs^Ftp, Dd^Ftd, Gs^Ftp, Gs^Ftp, Gs^Ftp, Gs^Ftp, Gll, Gll, Gs^Ftp, Gs^Ftp, Gs^Ftp, Gs, Gg, Gg, Gg, Rmo, Rmo, Cd, Gs, Ds, Ds, Ds, Ds, Ds, Ds, Ds, Ds, Wwt, Ds, Wwt, Wwt, Wwt, Wot
Gs^Ftp, Gs^Ftp, Gs^Ftp, Gs^Ftp, Gs, Re^Vct, Gg, Gg, Gs, Gs, Gg, Gg, Gg, Rmo, Rmo, Rmo, Rmo, Gg, Gs, Hh^Ftp, Hh, Hh, Hh, Hh^Ftp, Hh, Hh^Ftp, Gs, Gs^Ftp, Gs, Gs^Ftp, Gs^Ftp, Gll, Gs^Ftp, Gs^Ftp, Gs, Gs^Ftp, Gs, Gs^Ftp, Gs, Gs, Gg, Gs, Gg, Rmo, Rmo, Rmo, Gg, Gs, Gs^Ftp, Gs^Ftp, Gs^Ftp, Dd^Ftd, Gs^Ftp, Dd^Ftd, Dd^Ftd, Ds, Dd^Ftd, Ds, Ds, Wwt, Wwt
Gs^Ftp, Gs^Ftp, Gs^Ftp, Gs^Ftp, Gs^Ftp, Gs, Gg, Gg, Ce, Gg, Gg, Gs, Re^Vct, Gg, Gs, Rmo, Rmo, Rmo, Rmo, Gg, Gs, Hh, Gg, Hh, Gs, Gs, Rmo^Vdm, Gs, Gs, Gg, Gll, Gs^Ftp, Gg, Gs, Rmo^Vdm, Gs, Gg, Gs, Gg, Gg, Cd, Cd, Cd, Rmo, Rmo, Rmo, Cd, Cd, Cd, Gs^Ftp, Cd, Gs^Ftp, Cd, Gs^Ftp, Gs^Ftp, Dd^Ftd, Gs^Ftp, Dd^Ftd, Dd^Ftd, Wwt, Wwt
Gs^Ftp, Gll, Gs^Ftp, Gs^Ftp, Gs^Ftp, Gs, Gs, Ce, 2 Ke, Ce, Gg, Gs, Gs, Gs, Gs^Ftp, Gs, Gs, Rmo, Rmo, Rmo, Rmo, Gs, Gg, Gg, Gg, Re, Gs, Gs, Gs^Ftp, Gll, Gll, Gg, Gs, Gs, Gg, Gs, Gg, Gg, Gg, Cd, Rmo, Rmo, Cd, Rmo, Rmo, Rmo, Cd, Rmo, Rmo, Cd, Rmo, Cd, Rmo, Cd, Gs, Gs^Ftp, Gs^Ftp, Dd^Ftd, Gs^Ftp, Ds, Ds
Gs^Ftp, Gs^Ftp, Gs^Ftp, Gs^Ftp, Gs^Ftp, Gs, Gs, Ce, Ce, Ce, Gs, Gs, Gs^Ftp, Gs^Ftp, Gs^Ftp, Gs^Ftp, Gs^Ftp, Gs^Ftp, Gs^Ftp, Rmo, Rmo, Rmo, Rmo, Rmo, Rmo, Re, Gs, Gs^Ftp, Hh, Hh, Hh, Gs^Ftp, Gs^Ftp, Gs, Gs, Gs, Cd, Cd, Cd, Cd, Rmo, Rmo, Rmo, Rmo, Rmo, Rmo, Rmo, Rmo, Rmo^Vdm, Rmo, Rmo, Rmo, Rmo, Cd, Cd, Gs, Gs^Ftp, Gs^Ftp, Gs^Ftp, Dd^Ftd, Gs
Gs^Ftp, Gs^Ftp, Gs^Ftp, Gs^Ftp, Gs^Ftp, Gs, Gg, Gg, Gs, Gs, Gll, Gs^Ftp, Gs^Ftp, Gs^Ftp, Gs^Ftp, Gll, Gs^Ftp, Gll, Gs^Ftp, Gs^Ftp, Gs^Ftp, Rmo, Rmo, Rmo, Rmo, Rmo, Gs, Gs^Ftp, Hh^Ftp, Hh^Ftp, Hh^Ftp, Hh, Hh, Gs, Gg, Gg, Cd, Rmo, Rmo, Rmo, Rmo, Rmo, Rmo, Rmo, Rmo, Rmo, Rmo, Rmo, Rmo, Rmo, Rmo, Rmo^Vdm, Rmo, Rmo, Cd, Gs, Gs, Gs^Ftp, Gll, Gs^Ftp, Gs^Ftp
Gs, Gs, Gs, Gs, Re^Vct, Gs, Gg, Gg, Gs, Gs^Ftp, Gs^Ftp, Gs^Ftp, Gs^Ftp, Gll, Hh^Ftp, Gs^Ftp, Hh^Ftp, Hh^Ftp, Gs^Ftp, Gs^Ftp, Gs^Ftp, Gs, Gg, Gg, Rmo, Rmo, Gg, Gs, Gs^Ftp, Hh^Ftp, Gs^Ftp, Hh^Ftp, Gs, Gs, Cd, Cd, Rmo, Rmo, Rmo, Rmo^Vdm, Rmo, Rmo, Kd, Rmo, Rmo, Kd, Cd, Cd, Cd, Rmo, Rmo, Rmo, Rmo, Rmo, Rmo, Cd, Cd, Gs, Gs, Gs^Ftp, Gs^Ftp
Gg, Gg, Gs, Gg, Gg, Gg, Gg, Re^Vct, Gg, Gs^Ftp, Gs^Ftp, Gll, Hh^Ftp, Hh^Ftp, Hh, Hh^Ftp, Hh, Hh^Ftp, Hh^Ftp, Hh^Ftp, Hh^Ftp, Gs, Gg, Gg, Rmo, Rmo, Gg, Gs, Gs^Ftp, Gs^Ftp, Gs^Ftp, Gs^Ftp, Gs, Gg, Cd, Rmo, Rmo, Rmo, Rmo, Rmo, Rmo, Rmo, Cd, Rmo, Rmo, Rmo, Rmo, Rmo, Rmo, Cd, Cd, Rmo, Rmo, Rmo, Rmo, Rmo, Rmo, Cd, Gg, Gs, Gs^Ftp
Gg, Gs, Gg, Gg, Gg, Gg, Gs, Gs, Gs^Ftp, Gs^Ftp, Gs^Ftp, Gs^Ftp, Hh^Ftp, Hh, Hh, Hh, Hh, Hh, Hh^Ftp, Hh^Ftp, Gs^Ftp, Gs, Gg, Gg, Rmo, Rmo, Gs, Gs, Gs, Gs^Ftp, Gs, Gs, Cd, Cd, Rmo, Rmo, Rmo, Rmo^Vdm, Rmo, Rmo, Rmo, Cd, Rmo, Rmo, Rmo, Rmo, Kd, Rmo, Rmo, Rmo, Rmo, Cd, Rmo, Rmo, Rmo^Vdm, Rmo, Rmo, Cd, Gg, Gs, Gs
Rmo, Gg, Gg, Gs, Gg, Gg, Gg, Gs, Gs^Ftp, Gs^Ftp, Hh^Ftp, Hh^Ftp, Hh, Hh, Hh, Hh, Hh, Hh^Ftp, Hh^Ftp, Gs^Ftp, Gs^Ftp, Gs, Gs, Gg, Rmo, Rmo, Rmo, Gg, Gg, Gs, Gg, Cd, Rmo, Rmo, Rmo, Rmo, Rmo, Rmo, Cd, Rmo, Cd, Cd, Rmo, Rmo, Cd, Cd, Rmo^Vdm, Cd, Kd, Rmo, Rmo, Kd, Rmo, Rmo, Rmo, Rmo, Rmo, Cd, Gs, Gs, Gg
Rmo, Rmo, Rmo, Gs, Gg, Gg, Gs, Gs, Gg, Hh^Ftp, Hh^Ftp, Hh, Hh, Hh, Hh, Hh, Hh, Hh, Hh^Ftp, Gs^Ftp, Gs^Ftp, Gs^Ftp, Gs, Gg, Re, Rmo, Rmo, Rmo, Rmo, Gg, Gg, Cd, Rmo, Rmo, Rmo, Rmo, Cd, Cd, Rmo, Cd, Rmo, Rmo, Rmo, Rmo, Cd, 6 Kd, Cd, Rmo^Vdm, Rmo, Rmo, Rmo, Rmo, Rmo, Rmo, Rmo, Cd, Cd, Cd, Gs, Gg, Gg
Gs, Rmo, Rmo, Rmo, Gs, Gg, Gs, Gs, Gs, Hh^Ftp, Gs^Ftp, Hh^Ftp, Hh^Ftp, Hh, Hh, Hh, Hh, Hh, Hh^Ftp, Gs^Ftp, Gs^Ftp, Gs^Ftp, Gg, Rmo^Vdm, Gs, Gg, Gg, Rmo, Rmo, Rmo, Rmo, Rmo, Rmo, Rmo^Vdm, Rmo, Rmo, Cd, Rmo, Rmo, Rmo, Rmo, Rmo, Rmo, Rmo, Kd, Rmo^Vdm, Rmo^Vdm, Cd, Kd, Rmo, Rmo, Rmo, Rmo, Rmo, Rmo, Rmo, Rmo, Gg, Gg, Gs, Gs
Gg, Gg, Rmo, Rmo, Gg, Gs, Gg, Gs, Gg, Gs^Ftp, Gs^Ftp, Hh^Ftp, Hh^Ftp, Hh, Hh^Ftp, Hh, Hh^Ftp, Hh^Ftp, Hh^Ftp, Gll, Gll, Gll, Gll, Gs^Ftp, Gs^Ftp, Gs, Gg, Gg, Gg, Rmo, Rmo, Rmo, Rmo, Rmo, Rmo, Cd, Rmo, Rmo, Rmo, Rmo, Cd, Rmo, Rmo, Rmo, Rmo, Cd, Kd, Rmo, Rmo, Rmo, Rmo, Kd, Rmo, Rmo, Cd, Rmo, Rmo, Rmo, Rmo, Gg, Gg
Gg, Gg, Rmo, Rmo, Rmo, Gg, Gs, Gs, Gs^Ftp, Gs^Ftp, Gs^Ftp, Gs^Ftp, Hh^Ftp, Hh^Ftp, Hh^Ftp, Hh^Ftp, Hh, Hh^Ftp, Gs^Ftp, Gll, Gll, Gs^Ftp, Gll, Gg, Gg, Gs, Gg, Gg, Cd, Rmo, Rmo, Rmo, Rmo, Rmo, Kd, Cd, Rmo, Rmo, Kd, Cd, Rmo^Vdm, Kd, Rmo, Rmo, Rmo, Rmo, Rmo, Rmo, Rmo, Rmo, Cd, Cd, Rmo, Rmo, Rmo, Cd, Gg, Rmo, Rmo, Rmo, Rmo
Gg, Gs, Gg, Rmo, Rmo, Rmo, Rmo, Gg, Gs, Gs^Ftp, Gs^Ftp, Gs^Ftp, Gs, Hh^Ftp, Hh^Ftp, Gs^Ftp, Gs^Ftp, Gs^Ftp, Gs^Ftp, Gll, Gg, Gs^Ftp, Gs, Gs^Ftp, Gs, Gs, Cd, Cd, Rmo, Rmo, Rmo, Rmo, Rmo, Rmo, Rmo, Rmo, Rmo, Rmo, Cd, Cd, 4 Kd, Rmo^Vdm, Kd, Rmo, Rmo, Rmo, Rmo, Rmo, Cd, Cd, Rmo, Rmo, Rmo, Rmo, Rmo, Cd, Gs, Gs, Gg, Rmo, Rmo
Gs, Gs, Gg, Gg, Gg, Rmo, Rmo, Rmo, Rmo, Gs, Gg, Gs, Gs, Gs, Gs, Gs^Ftp, Gs^Ftp, Gs^Ftp, Gs, Gs^Ftp, Gs, Gs, Gg, Gs, Gg, Gg, Cd, Rmo, Rmo, Rmo^Vdm, Rmo, Rmo, Rmo, Rmo, Rmo, Rmo, Rmo, Rmo, Cd, Rmo^Vdm, Rmo^Vdm, Cd, Kd, Rmo, Rmo, Rmo, Cd, Cd, Rmo, Rmo, Rmo, Rmo, Rmo, Rmo^Vdm, Rmo, Cd, Gg, Gg, Gs, Gg, Gg
Gg, Gg, Re^Vct, Gs, Gg, Gg, Gg, Rmo, Rmo, Rmo, Rmo, Gg, Gg, Gg, Gg, Gs^Ftp, Gs, Gs, Gg, Gs, Gg, Gg, Rmo, Gg, Gg, Gg, Cd, Rmo, Rmo, Rmo, Cd, Kd, Rmo, Rmo, Rmo, Rmo, Rmo, Rmo, Rmo, Kd, Rmo, Kd, Rmo, Rmo, Rmo, Cd, Rmo, Rmo, Rmo, Rmo, Rmo^Vdm, Rmo, Rmo, Rmo, Cd, Cd, Gs, Gs, Gs^Ftp, Gs, Gs
Gg, Gg, Gs, Gs, Gg, Gs, Ce, Gg, Gg, Rmo, Rmo, Rmo, Rmo, Gg, Gg, Gg, Rmo, Rmo, Rmo, Gg, Rmo, Rmo, Rmo, Rmo, Rmo, Gg, Rmo, Rmo, Rmo, Rmo, Kd, Rmo, Rmo, Rmo, Cd, Kd, Cd, Rmo, Rmo, Rmo, Rmo, Rmo, Rmo, Rmo, Cd, Cd, Rmo, Rmo, Rmo, Rmo, Rmo, Rmo, Rmo, Rmo, Cd, Gll, Gs^Ftp, Gll, Gll, Gs, Gs
Gg, Gg, Gs, Gg, Gg, Ce, 3 Ke, Ce, Gs, Gg, Gg, Rmo, Rmo, Rmo, Rmo, Rmo, Rmo, Rmo, Rmo, Rmo, Rmo, Rmo, Gs, Rmo, Rmo, Rmo, Rmo, Rmo, Rmo, Rmo, Rmo, Rmo, Rmo, Cd, 5 Kd, Rmo^Vdm, Rmo^Vdm, Kd, Rmo, Rmo, Rmo, Rmo, Cd, Cd, Rmo, Rmo, Rmo, Rmo, Rmo, Rmo, Rmo, Rmo, Rmo, Cd, Gs, Gs, Gs^Ftp, Gll, Gg, Gs^Ftp, Gs
Gs, Gs, Gs, Re^Vct, Gs, Ce, Ce, Ce, Gs, Gg, Re^Vct, Gg, Gg, Rmo, Rmo, Rmo, Gg, Re, Gg, Rmo, Gg, Gs, Gg, Gs, Gg, Rmo, Rmo, Rmo, Rmo, Rmo, Rmo, Rmo, Rmo, Cd, Rmo^Vdm, Cd, Cd, Rmo, Rmo, Rmo, Cd, Cd, Rmo, Rmo, Rmo, Rmo, Rmo, Rmo, Rmo, Rmo, Rmo, Rmo, Cd, Cd, Gs, Gs^Ftp, Gll, Gs, Gs^Ftp, Gg, Gg
Gg, Gs^Ftp, Gs^Ftp, Gs, Gs, Gg, Gg, Gg, Gg, Gg, Gs, Gs, Gs, Gg, Gs, Gs, Gs, Rmo^Vdm, Gs, Gs, Gs, Gg, Gs^Ftp, Gg, Gg, Gg, Cd, Rmo, Rmo, Rmo, Kd, Rmo, Rmo, Kd, Cd, Rmo^Vdm, Rmo, Kd, Rmo, Rmo, Cd, Rmo, Rmo, Rmo, Rmo, Rmo, Rmo, Rmo^Vdm, Rmo, Rmo, Rmo, Rmo, Cd, Gg, Gs^Ftp, Gll, Gll, Gs, Gll, Gs^Ftp, Gg
Gs^Ftp, Gs^Ftp, Gs^Ftp, Gs^Ftp, Gs^Ftp, Gs, Gs, Re^Vct, Gs, Gs, Gll, Gs^Ftp, Gs^Ftp, Gs, Gs^Ftp, Gg, Gs^Ftp, Gs, Gll, Gs^Ftp, Gs, Gs, Gs, Gs, Gg, Gg, Cd, Rmo, Rmo, Rmo, Cd, Rmo, Rmo, Rmo, Rmo, Kd, Rmo, Rmo, Rmo, Rmo, Cd, Rmo, Rmo, Rmo, Rmo^Vdm, Rmo, Rmo, Rmo, Rmo, Rmo, Cd, Cd, Gg, Gg, Gs^Ftp, Gll, Gs^Ftp, Gs, Gll, Gs^Ftp, Gg
Gs^Ftp, Gll, Gll, Gll, Gll, Gs^Ftp, Gs, Gg, Gs, Gs, Gs^Ftp, Gs^Ftp, Gll, Gs^Ftp, Gs^Ftp, Gg, Gs^Ftp, Gs^Ftp, Gs^Ftp, Gg, Gg, Gs, Gs^Ftp, Gg, Gg, Cd, Rmo, Rmo, Rmo^Vdm, Rmo, Rmo, Cd, Cd, Rmo, Rmo, Rmo, Rmo, Rmo, Rmo, Kd, Rmo, Rmo, Rmo, Rmo, Rmo, Rmo, Rmo, Rmo, Cd, Cd, Gs, Gg, Gs, Gg, Gs^Ftp, Gll, Gll, Gll, Gs^Ftp, Gs^Ftp, Gs
Gll, Gs^Ftp, Gll, Gs^Ftp, Gll, Gs^Ftp, Gs, Gg, Gs, Gs^Ftp, Gll, Gs^Ftp, Gs^Ftp, Gll, Gs^Ftp, Gs^Ftp, Gs^Ftp, Gs^Ftp, Gs, Gs, Gg, Gs^Ftp, Gs, Gs, Gg, Cd, Rmo, Rmo, Rmo, Rmo, Rmo, Rmo, Rmo, Cd, Cd, Rmo, Kd, Rmo, Rmo, Rmo, Rmo, Rmo, Rmo, Rmo, Rmo, Rmo, Cd, Rmo, Cd, Gg, Gs, Gg, Gg, Gs^Ftp, Gs, Gs, Gs^Ftp, Gs^Ftp, Gs, Gg, Gs
Dd^Ftd, Gs^Ftp, Gs^Ftp, Gs^Ftp, Gs^Ftp, Gs^Ftp, Gg, Gg, Gs^Ftp, Gs^Ftp, Gs^Ftp, Gll, Gs, Gll, Gll, Gll, Dd^Ftd, Gll, Ds, Gs, Gs, Gg, Gs, Gg, Gg, Cd, Cd, Rmo, Rmo, Rmo, Rmo, Rmo, Rmo, Rmo, Rmo, Cd, Rmo, Rmo, Rmo, Rmo, Rmo, Rmo, Rmo, Rmo, Cd, Cd, Gg, Cd, Gg, Gs, Gs^Ftp, Gg, Gg, Gs^Ftp, Gll, Gll, Gll, Gs, Gs^Ftp, Gs^Ftp, Gs
Dd^Ftd, Dd^Ftd, Dd^Ftd, Gs^Ftp, Gs^Ftp, Gs^Ftp, Gs, Gs, Gs, Gs^Ftp, Gll, Gs, Dd^Ftd, Gs, Dd^Ftd, Dd^Ftd, Ds, Dd^Ftd, Ds, Ds, Ds, Gs, Gs^Ftp, Gg, Gg, Gg, Rmo, Rmo, Rmo, Rmo, Rmo, Rmo, Rmo, Rmo^Vdm, Rmo, Rmo, Rmo, Rmo, Rmo, Rmo, Rmo, Rmo, Cd, Rmo, Cd, Gg, Gg, Gg, Gg, Gs, Gs, Gll, Gg, Gs^Ftp, Gll, Gs^Ftp, Gll, Gs^Ftp, Gll, Gll, Gs^Ftp
Ds, Dd^Ftd, Dd^Ftd, Dd^Ftd, Dd^Ftd, Gll, Ds, Ds, Ds, Gs, Dd^Ftd, Dd^Ftd, Ds, Dd^Ftd, Ds, Ds, Wwt, Ds, Wwt, Ds, Ds, Gs, Gs, Gg, Rmo, Rmo, Rmo, Rmo, Rmo, Cd, Cd, Rmo, Rmo, Rmo, Rmo, Rmo, Rmo, Rmo, Rmo^Vdm, Rmo, Rmo, Rmo, Rmo, Cd, Gg, Gg, Gg, Gg, Gg, Gg, Gg, Gg, Gs^Ftp, Gg, Gs^Ftp, Gll, Gs^Ftp, Gll, Gg, Gg, Gs^Ftp
Wwt, Ds, Dd^Ftd, Dd^Ftd, Dd^Ftd, Dd^Ftd, Dd^Do, Dd^Do, Ds, Dd^Ftd, Ds, Dd^Ftd, Ds, Wwt, Wwt, Wwt, Wwt, Wwt, Wwt, Wwt, Wwt, Ds, Cd, Rmo, Rmo, Rmo, Rmo, Rmo, Gs^Ftp, Gs^Ftp, Gs^Ftp, Cd, Cd, Rmo, Rmo, Rmo, Rmo, Rmo, Rmo, Rmo, Cd, Rmo, Rmo, Rmo, Rmo, Gg, Gg, Gg, Gg, Gg, Gg, Gg, Gs, Gs, Gs, Gs, Gs, Gs, Gs^Ftp, Gg, Gs
Wwt, Ds, Ds, Ds, Ds, Ds, Ds, Ds, Wwt, Ds, Wwt, Ds, Wwt, Wwt, Wwt, Wwt, Wwt, Wwt, Wwt, Wwt, Wwt^Bsb/, Ds^Bsb/, Cd, Kd, Cd, Rmo, Ds, Gs^Ftp, Gs^Ftp, Gs^Ftp, Gs^Ftp, Gs^Ftp, Gs^Ftp, Cd, Cd, Rmo, Cd, Rmo, Cd, Rmo, Cd, Gg, Gg, Rmo, Rmo, Rmo, Rmo, Rmo, Rmo, Rmo, Rmo, Rmo, Rmo, Gg, Gg, Gg, Gg, Gs, Gg, Gs, Gg
Wwt, Wwt, Wwt, Wwt, Wwt, Wwt, Wwt, Wwt, Wwt, Wwt, Wwt, Wwt, Wwt, Wwt, Wot, Wot, Wwt, Wot, Wot, Wwt, Wwt^Bsb/, Wwt^Bsb/, Wwt^Bsb/, Cd, Wwt^Bsb/, Cd, Wwt, Ds, Ds, Dd^Ftd, Dd^Ftd, Gs^Ftp, Gs^Ftp, Gs^Ftp, Gs^Ftp, Cd, Gll, Cd, Gll, Cd, Gg, Gg, Gs, Gg, Gs, Rmo, Rmo, Rmo, Rmo, Rmo, Rmo, Rmo, Rmo, Rmo, Rmo, Gg, Gg, Gg, Rmo, Rmo, Rmo
Wwt, Wwt, Wot, Wwt, Wwt, Wwt, Wwt, Wwt, Wwt, Wwt, Wwt, Wwt, Wot, Wot, Wwt, Wwt, Wwt, Wot, Wot, Wwt, Wwt, Wwt^Bsb/, Wwt, Wwt^Bsb/, Wwt, Wwt, Wwt, Wwt, Wwt, Ds, Ds, Dd^Ftd, Ds, Ds, Ds, Gs^Ftp, Gs^Ftp, Gs^Ftp, Gs^Ftp, Gg, Gs, Gs, Gs^Ftp, Gs, Gs^Ftp, Gs, Gs, Gg, Gs, Gg, Gg, Gg, Gg, Rmo, Rmo, Rmo, Rmo, Rmo, Rmo, Rmo, Rmo
Wot, Wwt, Wwrt, Wot, Wwrt, Wwt, Wot, Wot, Wot, Wot, Wot, Wot, Wot, Wot, Wot, Wot, Wot, Wwt, Wot, Wot, Wot, Wwt, Wwt, Wwt, Wwt, Wwt, Wwt, Wwt, Wwt, Wwt, Wwt, Ds, Wwt, Wwt, Ds, Dd^Ftd, Ds, Dd^Ftd, Dd^Ftd, Gs^Ftp, Gs^Ftp, Gll, Gs^Ftp, Gll, Gll, Gll, Gs^Ftp, Gs, Gg, Gs, Gs, Gg, Gg, Gg, Gg, Rmo, Rmo, Rmo, Gg, Gg, Gg
Wot, Wwrt, Wot, Wot, Wot, Wot, Wwrt, Wwt, Wwrt, Wwt, Wwrt, Wwt, Wwrt, Wwrt, Wot, Wot, Wot, Wot, Wwt, Wot, Wot, Wot, Wot, Wwt, Wot, Wot, Wwrt, Wot, Wwt, Wwt, Wwt, Wwt, Wwt, Wwt, Wwt, Ds, Wwt, Ds, Dd^Ftd, Dd^Ftd, Gs^Ftp, Gll, Gs^Ftp, Gs^Ftp, Gs^Ftp, Gll, Gll, Gs^Ftp, Gs^Ftp, Gs^Ftp, Gs^Ftp, Gs, Gg, Gg, Gg, Gg, Gg, Gg, Gg, Gg, Gg
Wot, Wot, Wot, Wot, Wot, Wot, Wot, Wot, Wot, Wot, Wot, Wot, Wot, Wot, Wot, Wot, Wot, Wot, Wot, Wwt, Wot, Wwt, Wot, Wwt, Wot, Wwrt, Wot, Wwrt, Wot, Wwrt, Wwrt, Wot, Wot, Wwt, Wot, Wwt, Wot, Ds, Ds, Dd^Ftd, Gs^Ftp, Gs^Ftp, Wot, Gll, Gll, Gs^Ftp, Gs^Ftp, Gs^Ftp, Gll, Gll, Gs^Ftp, Gs, Gg, Gg, Gg, Gg, Gg, Gg, Gg, Gg, Gg
