border_size=1
usage=map

Gs^Ftp, Gg, Gs^Ftp, Gg, Gs^Ftp, Gg, Gs^Ftp, Gs^Ftp, Gs, Gg, Gg, Gg, Gs^Ftp, Gg, Gs, Ds, Ds, Ds, Ds, Wwt, Wwt, Wot, Wwt, Wot, Wwt, Wot, Wwt, Wwt, Wwt, Wot, Wwt, Wot, Wot, Wot, Wot, Wot, Wot, Wot, Wot, Wot, Wot, Wot, Wot, Wot, Wot, Wot, Wot, Wot, Wot, Wot, Wot, Wot, Wot, Wot, Wot, Wot, Wot, Wot, Wot, Wwrt, Wot, Wot, Wot, Wot, Wot, Wot
Gs^Ftp, Gs^Ftp, Gs^Ftp, Gs^Ftp, Gs^Ftp, Gs^Ftp, Gs^Ftp, Gs^Ftp, Gs, Gg, Gg, Gs, Gs^Ftp, Gs, Gs, Gs, Gs, Ds, Ds, Wwt, Ds, Wwt, Wwt, Wwt, Wwt, Wwt, Wwt, Wwt, Wwt, Wwt, Wwt, Wwt, Wwt, Wot, Wot, Wot, Wot, Wot, Wot, Wot, Wot, Wot, Wot, Wot, Wot, Wwrt, Wwrt, Wot, Wot, Wwrt, Wot, Wot, Wot, Wot, Wot, Wot, Wot, Wot, Wot, Wot, Wot, Wot, Wot, Wot, Wot, Wot
Gs^Ftp, Gs^Ftp, Gs^Ftp, Gs^Ftp, Gs^Ftp, Gs, Gs, Gs, Gg, Gg, Gg, Gs, Gs, Gs^Ftp, Gs^Ftp, Gs, Gs, Ds, Dd^Ftd, Ds, Ds, Ds, Ds, Ds, Ds, Wwt, Wwt, Wwt, Wwt, Wwt, Wwt, Wwt, Wwt, Wwt, Wwt, Wot, Wot, Wot, Wot, Wot, Wot, Wot, Wwrt, Wot, Wot, Wot, Wot, Wot, Wot, Wot, Wot, Wwrt, Wot, Wot, Wot, Wot, Wot, Wot, Wot, Wot, Wot, Wwrt, Wwrt, Wot, Wot, Wot
Gs^Ftp, Gs^Ftp, Gs, Gs^Ftp, Gs, Gs, Gg, Gg, Gg, Gg, Re^Vct, Gg, Gg, Gs, Gs^Ftp, Gs, Gs^Ftp, Gs, Gs^Ftp, Dd^Ftd, Dd^Ftd, Ds, Ds, Ds, Dd^Ftd, Ds, Ds, Ds, Ds, Ds, Wwt, Wwt, Wwt, Wwt, Wwt, Wot, Wot, Wot, Wot, Wot, Wot, Wot, Wot, Wwrt, Wwrt, Wot, Wot, Wot, Wot, Wot, Wot, Wot, Wwrt, Wot, Wot, Wot, Wot, Wot, Wot, Wot, Wot, Wwrt, Wot, Wot, Wot, Wot
Gs, Gs, Gg, Gs, Gg, Gg, Gg, Gg, Gg, Gg, Gg, Gg, Gs, Gg, Gs, Gs, Gs^Ftp, Gs^Ftp, Gs^Ftp, Gs^Ftp, Gs, Ds, Dd^Ftd, Dd^Ftd, Gs^Ftp, Dd^Ftd, Dd^Ftd, Dd^Ftd, Dd^Ftd, Ds, Ds, Wwt, Wwt, Wwt, Wwt, Wwt, Wot, Wot, Wot, Wot, Wot, Wot, Wot, Wot, Wot, Wot, Wwrt, Wot, Wot, Wot, Wot, Wot, Wot, Wot, Wot, Wot, Wot, Wot, Wot, Wot, Wot, Wwrt, Wot, Wot, Wot, Wot
Gg, Gg, Gg, Gg, Gg, Gg, Gg, Gg, Gg, Gg, Gg, Gg, Gg, Gg, Gg, Gg, Gs, Gg, Gs, Gs, Gs, Gs, Gg, Gs^Ftp, Gs^Ftp, Gs^Ftp, Gs^Ftp, Gs^Ftp, Dd^Ftd, Dd^Ftd, Ds, Ds, Ds, Ds, Wwt, Wwt, Wwt, Wot, Wot, Wot, Wot, Wot, Wot, Wot, Wot, Wot, Wot, Wot, Wot, Wot, Wot, Wot, Wot, Wot, Wot, Wot, Wot, Wot, Wot, Wot, Wot, Wot, Wot, Wot, Wot, Wot
Gg, Gg, Gg, Gs, Re^Vct, Gs, Gg, Gg, 1 Ke, Ce, Gg, Gs, Gg, Gg, Gg, Gg, Gg, Gs, Gs^Ftp, Gs, Gs, Gs^Ftp, Gs^Ftp, Gs^Ftp, Gs, Gs^Ftp, Gs^Ftp, Gs^Ftp, Gs, Ds, Dd^Ftd, Dd^Ftd, Dd^Ftd, Ds, Ds, Wwt, Wwt, Wwt, Wwt, Wot, Wot, Wot, Wot, Wot, Wot, Wot, Wot, Wwrt, Wot, Wot, Wot, Wot, Wot, Wot, Wot, Wot, Wot, Wot, Wot, Wot, Wot, Wot, Wot, Wwrt, Wot, Wot
Gg, Gs, Gg, Gg, Gg, Gs, Ce, Ke, Ce, Ce, Ce, Gg, Gs^Ftp, Gs, Gs^Ftp, Gs^Ftp, Gs^Ftp, Gs, Gs, Gs, Gs, Gg, Gs, Gs, Gs, Gg, Gs, Gs, Gg, Gs, Gs^Ftp, Gs^Ftp, Gs^Ftp, Dd^Ftd, Dd^Ftd, Ds, Ds, Wwt, Wwt, Wot, Wot, Wot, Wot, Wot, Wot, Wot, Wot, Wot, Wwrt, Wot, Wot, Wot, Wwrt, Wot, Wot, Wot, Wot, Wot, Wot, Wot, Wot, Wot, Wot, Wot, Wwrt, Wot
Gg, Gg, Gg, Gg, Gg, Gg, Gg, Ce, Ce, Ce, Ce, Gg, Gs, Gs, Gs^Ftp, Gs, Gs^Ftp, Gg, Gs, Gs, Gs, Gs, Gg, Gg, Gg, Gs, Gg, Gs, Gg, Gs, Gs, Gs, Gs^Ftp, Gs^Ftp, Gs^Ftp, Dd^Ftd, Ds, Wwt, Wwt, Wot, Wot, Wot, Wot, Wot, Wot, Wot, Wot, Wot, Wot, Wot, Wot, Wot, Wot, Wot, Wot, Wot, Wot, Wot, Wot, Wot, Wot, Wot, Wot, Wot, Wot, Wot
Gg, Gg, Gg, Gg, Gg, Gg, Gg, Ce, Ce, Gg, Gg, Gg, Gs^Ftp, Gs^Ftp, Gs, Gs, Gs, Gs^Ftp, Gs^Ftp, Gg, Gg, Gs^Ftp, Gg, Gg, Gg, Gg, Gg, Gg, Gg, Gg, Gg, Gs, Gg, Gs^Ftp, Gs^Ftp, Dd^Ftd, Ds, Wwt, Wwt, Wwt, Wot, Wot, Wot, Wot, Wot, Wot, Wot, Wot, Wot, Wot, Wwrt, Wot, Wot, Wwrt, Wwrt, Wot, Wot, Wot, Wot, Wot, Wot, Wot, Wot, Wot, Wot, Wot
Gg, Gg, Gg, Gg, Re^Vct, Gg, Gg, Gg, Gg, Gg, Gs, Gg, Gg, Gg, Gg, Gg, Gs, Gg, Gs^Ftp, Gs^Ftp, Gs, Gs, Gg, Gs^Ftp, Gg, Gg, Gg, Gg, Gg, Gg, Gg, Gg, Gg, Gs, Gs, Dd^Ftd, Ds, Ds, Wwt, Wwt, Wwt, Wot, Wot, Wot, Wot, Wot, Wot, Wot, Wot, Wot, Wwrt, Wot, Wot, Wot, Wwrt, Wot, Wot, Wot, Wot, Wot, Wot, Wot, Wot, Wot, Wot, Wot
Gg, Gg, Gg, Gg, Gg, Gg, Gg, Gs, Gs, Gs, Gs^Ftp, Gs, Gg, Gs^Ftp, Gg, Gg, Gs^Ftp, Gg, Gg, Gs, Gs, Gs, Gs^Ftp, Gs^Ftp, Gs^Ftp, Gg, Gg, Gg, Gg^Efm, Gg, Gg^Efm, Gg^Efm, Gg^Efm, Gg, Gg, Gs, Ds, Ds, Wwt, Wwt, Wwt, Wwt, Wwt, Wot, Wot, Wot, Wot, Wot, Wot, Wot, Wot, Wot, Wot, Wot, Wot, Wot, Wot, Wwrt, Wot, Wot, Wot, Wot, Wot, Wot, Wot, Wot
Gg, Gg, Gg, Gg, Ce, Gg, Gg, Gg, Gs^Ftp, Gs^Ftp, Gs^Ftp, Gs^Ftp, Gg, Gg, Gg, Gg, Gg, Gs^Ftp, Gs, Gs, Gs^Ftp, Gs, Gg, Gs, Gs^Ftp, Gg, Gg, Gg, Gg, Gg^Efm, Gg, Gg^Efm, Gg^Efm, Gg^Efm, Gg^Efm, Gs, Dd^Ftd, Ds, Ds, Wwt, Wwt, Wwt, Wwt, Wwt, Wot, Wot, Wot, Wot, Wot, Wot, Wot, Wot, Wot, Wot, Wot, Wot, Wot, Wot, Wot, Wwrt, Wot, Wot, Wot, Wot, Wot, Wot
Gg, Re^Vct, Gg, Ce, 2 Ke, Ce, Gs, Gg, Gg, Gs^Ftp, Gg, Gg, Gg, Gs, Gs, Gg, Gs, Gg, Gs, Gs, Gg, Gs, Gg, Gs, Gs^Ftp, Gg, Gg, Gg^Efm, Gg, Gg^Efm, Gg^Efm, Gg, Gg^Efm, Gg^Efm, Gg^Efm, Gg^Efm, Gs^Ftp, Dd^Ftd, Ds, Ds, Ds, Ds, Wwt, Wwt, Wwt, Wwt, Wwt, Wot, Wot, Wot, Wot, Wot, Wot, Wot, Wot, Wot, Wot, Wwrt, Wwrt, Wot, Wot, Wot, Wot, Wot, Wot, Wot
Gg, Gg, Gs, Ce, Ce, Ce, Gg, Gg, Gg, Gg, Gg, Gs, Gg, Gg, Gg, Gs^Ftp, Gg, Gg, Gg, Gs^Ftp, Gg, Gg, Gg, Gg, Gg, Gg, Gg, Gg^Efm, Gg^Efm, Gg^Efm, Gg^Efm, Gg^Efm, Gg^Efm, Gg^Efm, Gg, Gg^Efm, Kdr, Gs^Ftp, Gs, Dd^Ftd, Dd^Ftd, Ds, Wwt, Wwt, Wwt, Wwt, Wwt, Wwt, Wwt, Wot, Wot, Wot, Wot, Wot, Wot, Wot, Wot, Wot, Wwrt, Wot, Wot, Wot, Wot, Wot, Wot, Wot
Gg, Gs, Gg, Gg, Gg, Gs, Gs, Gs, Gs, Gg, Gg, Gg, Gg, Gg, Gg, Rmo^Vdm, Gg, Gg, Gg, Gg, Gg, Gg, Gg, Gg, Gg, Gg, Gg, Gg^Efm, Gg^Efm, Gg^Efm, Gg^Efm, Gg, Gg^Efm, Gg^Efm, Kdr, Cdr, Cdr, Cdr, Kd, Gs^Ftp, Dd^Ftd, Ds, Ds, Wwt, Ds, Wwt, Wwt, Wwt, Wwt, Wwt, Wwt, Wot, Wot, Wot, Wot, Wot, Wot, Wot, Wot, Wot, Wot, Wot, Wot, Wot, Wot, Wot
Gs, Gg, Gg, Gg, Gg, Gs, Gg, Gg, Gg, Gg, Gg, Rmo^Vdm, Gg, Gg, Gg, Gg, Gg, Gs^Ftp, Gs^Ftp, Gg, Gg, Gg, Gg, Gg, Gs, Gs, Gg, Gg^Efm, Gg^Efm, Gg^Efm, Gg^Efm, Gg^Efm, Gg, Gg^Efm, Cdr, Rmp, Kdr, Rmp, Cdr, Gs^Ftp, Gs^Ftp, Ds, Ds, Ds, Dd^Ftd, Ds, Ds, Wwt, Wwt, Wwt, Wwt, Wot, Wot, Wot, Wot, Wot, Wot, Wot, Wot, Wwrt, Wot, Wot, Wot, Wot, Wot, Wot
Gg, Gs, Gs, Gg, Gs, Gg, Gg, Rmo^Vdm, Gg, Gg, Gg, Gg, Cd, Gg, Gg, Gg, Gg, Rmo^Vdm, Gg, Gg, Gg, Gg, Gg, Gg, Gs, Gs^Ftp, Gs^Ftp, Gg, Gg, Gg^Efm, Gg, Gg^Efm, Gg^Efm, Gg, Gg, Cdr, Rmo, Cd, Gg, Gg, Gg, Gs, Gs, Dd^Ftd, Gs^Ftp, Dd^Ftd, Ds, Ds, Wwt, Wwt, Wwt, Wwt, Wwt, Wot, Wot, Wot, Wot, Wot, Wot, Wwrt, Wwrt, Wot, Wwrt, Wot, Wot, Wot
Gg, Gg, Gg, Gs, Gg, Gg, Gg, Gg, Gg, Gg, Cd, Cd, Rmp, Cd, Cd, Gg, Gg, Gg, Gg, Gg, Gg, Gg, Gg, Gg, Gs, Gs^Ftp, Gs^Ftp, Gs, Gg, Gs, Gs, Gg, Gg, Gs^Ftp, Gs^Ftp, Gs, Rmo, Gg, Gs, Gs, Gs, Rmo^Vdm, Gs, Gs^Ftp, Gs^Ftp, Dd^Ftd, Dd^Ftd, Dd^Ftd, Dd^Ftd, Wwt, Wwt, Wwt, Wwt, Wwt, Wot, Wot, Wot, Wot, Wot, Wot, Wot, Wot, Wot, Wot, Wot, Wot
Rmo, Gg, Rmo, Gg, Gg, Gg, Rmo, Gg, Gg, Cd, Rmp, Rmp, Cd, Rmp, Rmp, Cd, Gg, Gg, Gg, Gg, Rmo, Rmo, Rmo, Gg, Gs, Gs^Ftp, Gs, Gs, Gg, Gg, Gg, Gs, Gg, Gs^Ftp, Gs, Gs, Rmo, Gg, Gg, Gg, Gg, Gs, Gg, Gs^Ftp, Kd, Gs^Ftp, Gs^Ftp, Gs^Ftp, Kd, Dd^Ftd, Rmp, Ds, Ds, Wwt, Wwt, Wot, Wot, Wot, Wot, Wot, Wot, Wot, Wwrt, Wot, Wot, Wot
Rmo, Rmo, Rmo, Rmo, Rmo, Rmo, Rmo, Rmo, Rmo, Cd, Cd, Cd, Kd, Cd, Cd, Cd, Rmo, Rmo, Rmo, Rmo, Gg, Gg, Gg, Rmo, Rmo, Gg, Gg, Gg, Rmo, Rmo, Rmo, Rmo, Rmo, Rmo, Rmo, Rmo, Rmo, Gg, Kd, Gg, Cd, Gg, Cd, Cd, Rmo, Cd, Cd, Cd, Rmo, Cd, Rmo, Ds, Ds, Wwt, Wwt, Wot, Wot, Wot, Wot, Wot, Wot, Wot, Wwrt, Wot, Wot, Wot
Gg, Rmo, Gg, Rmo, Rmo, Rmo, Gg, Rmo, Rmo, Rmo, Rmo, Rmp, Cd, Rmp, Rmo, Rmo, Gg, Gg, Gg, Gg, Gs^Ftp, Gs, Gs, Gg, Gg, Rmo, Kdr, Rmo, Gg, Gg, Gg, Gg, Gs, Gg, Gg, Gs, Rmo, Rmo, Rmo, Kd, Rmo, Cd, Rmo, Rmo, Rmo, Rmo, Rmo, Rmo, Rmo, Rmo, Rmo, Rmo, Cd, Wwt, Wwt, Wwt, Wwt, Wot, Wot, Wot, Wot, Wot, Wot, Wot, Wot, Wot
Gg, Gg, Gg, Gg, Gg, Gg, Gs, Gg, Gg, Rmo, Rmo, Rmo, Rmo, Rmo, Gg, Gs, Gs, Gs, Gs, Gs^Ftp, Rmo^Vdm, Gs^Ftp, Gs, Gg, Cdr, Cdr, Cd, Cdr, Cdr, Gg, Gs, Gs, Gg, Gs, Gg, Kd, Rmo, Rmo, Rmo, Rmo, Rmo^Vdm, Rmo, Rmo, Rmo^Vdm, Rmo, Rmo, Rmo, Rmo^Vdm, Rmo, Rmo, Rmo, Rmo, Rmo, Cd, Kd, Wwt, Wwt, Wot, Wot, Wot, Wot, Wot, Wot, Wwrt, Wot, Wot
Gg, Gg, Gs, Gg, Gg, Gg, Ce, Gs, Gs, Gg, Gg, Rmo, Rmo, Rmo, Rmo, Gg, Gg, Gg, Gs, Gs, Gg, Gs, Gg, Gg, Cdr, Rmp, Cd, Rmp, Cd, Gs, Gs, Rmo^Vdm, Gg, Gg, Cd, Kd, Rmo, Rmo, Rmo, Rmo, Rmo, Rmo, Rmo, Rmo, Rmo, Rmo, Rmo, Rmo, Rmo, Rmo, Rmo^Vdm, Rmo, Rmo, Rmo, Cd, Wwt, Wwt, Wot, Wot, Wot, Wot, Wot, Wot, Wwrt, Wot, Wot
Hh, Gg, Gg, Re^Vct, Gs, Ce, 3 Ke, Ce, Gs, Gs, Gs, Gg, Gg, Rmo, Rmo, Rmo, Rmo, Gg, Gg, Gg, Gs, Gg, Gs, Gs, Gg, Kdr, Rmo, Kdr, Gg, Gg, Gs, Gg, Gg, Cd, Rmo, Rmo, Rmo, Rmo, Rmo, Rmo^Vdm, Rmo, Rmo, Kd, Rmo, Rmo, Rmo, Kd, Rmo, Rmo, Rmo, Rmo, Rmo, Rmo, Rmo, Cd, Wwt, Wwt, Wot, Wot, Wot, Wot, Wot, Wot, Wot, Wot, Wot
Hh, Hh, Gg, Gg, Gg, Ce, Ce, Ce, Gg, Gg, Gg, Gg, Gg, Gg, Gg, Rmo, Rmo, Rmo, Rmo, Gg, Gg, Gs, Gs, Gg, Gg, Gg, Rmo, Gg, Gs, Gs, Gs, Gg, Cd, Cd, Rmo, Rmo, Rmo^Vdm, Rmo, Rmo, Rmo, Cd, Cd, Rmo, Rmo, Rmo, Rmo, Rmo, Cd, Cd, Rmo, Rmo, Rmo, Rmo^Vdm, Rmo, Cd, Wwt, Wwt, Wwt, Wot, Wot, Wot, Wot, Wot, Wwrt, Wot, Wot
Hh^Ftp, Hh, Hh, Gg, Gg, Gg, Gg, Gg, Gg, Rmo^Vdm, Gg, Gs, Gg, Gg, Gg, Gg, Gg, Rmo, Rmo, Rmo, Rmo, Gg, Rmo, Gg, Kd, Rmo, Gg, Gg, Gs, Rmo^Vdm, Gg, Gg, Cd, Rmo, Rmo, Rmo, Rmo, Rmo, Cd, Cd, Rmo, Rmo, Rmo^Vdm, Rmo, Rmo, Rmo, Rmo, Rmo, Rmo, Cd, Cd, Rmo, Rmo, Rmo, Rmo, Rmp, Wwt, Wwt, Wot, Wot, Wot, Wot, Wot, Wwrt, Wwrt, Wot
Hh^Ftp, Hh^Ftp, Hh, Hh, Gg, Gg, Gs, Gg, Gg, Gg, Gs, Gg, Gs, Gg, Gs, Gg, Gg, Gg, Gg, Rmo, Rmo, Rmo, Kd, Cd, Rmp, Cd, Kd, Gg, Gs, Gg, Gs, Gg, Cd, Rmo, Rmo, Rmo, Rmo^Vdm, Rmo, Cd, Rmo, Rmo, Rmo, Rmo, Rmo, Kd, Rmo, Rmo, Rmo^Vdm, Rmo, Rmo, Cd, Rmo, Rmo, Rmo, Rmo, Ds, Wwt^Bsb/, Wwt, Wwt, Wot, Wot, Wot, Wot, Wot, Wwrt, Wot
Hh, Hh, Hh, Gg, Gg, Gs, Gs, Gg, Gg, Gg, Gg, Gg, Gs, Gg, Gg, Gg, Gg, Gg, Gg, Gg, Gg, Rmo, Cd, Rmp, 6 Kd, Rmp, Cd, Gg, Gg, Gs, Gg, Gg, Gg, Cd, Rmo, Rmo, Rmo, Rmo, Cd, Rmo, Rmo^Vdm, Rmo, Kd, Kd, Rmp, Kd, Kd, Rmo, Rmo, Rmo, Kd, Rmo, Rmo, Rmo, Kd, Wwt^Bsb/, Wwt^Bsb/, Wwt^Bsb/, Wwt^Bsb/, Wot, Wot, Wot, Wot, Wot, Wwrt, Wot
Hh, Hh, Gg, Gg, Gs, Gs, Gg, Gg, Gg, Gg, Gg, Gg, Gs, Gg, Gg, Rmo^Vdm, Gg, Gs, Gs, Gg, Gg, Gg, Kd, Rmp, Rmp, Cd, Kd, Gg, Gg, Gs, Rmo, Gg, Gg, Kd, Rmo, Rmo, Rmo, Rmo, Kd, Rmo, Rmo, Rmo, Kd, Cd, 4 Kd, Cd, Kd, Rmo, Rmo^Vdm, Rmo, Rmo, Rmo, Rmo, Rmo, Rmo, Kd, Kd, Wwt^Bsb/, Wwt^Bsb/, Wot, Wot, Wot, Wot, Wot, Wwrt, Wot
Gg, Gg, Gs, Gs, Gg, Gg, Gg, Gg, Gg, Rmo^Vdm, Gg, Gg, Gg, Gs, Gg, Gg, Gg, Gg, Gs, Gs, Gg, Gs, Gg, Cd, Kd, Cd, Rmo, Gg, Rmo, Rmo, Rmo, Rmo, Rmo, Rmo, Rmo, Rmo^Vdm, Rmo, Rmo, Rmo, Rmo, Rmo, Rmo, Kd, Rmp, Cd, Rmp, Kd, Rmo, Rmo, Rmo, Rmo, Rmo, Rmo, Rmo^Vdm, Rmo, Rmo, Kd, Wwt^Bsb/, Wwt^Bsb/, Wot, Wot, Wot, Wwrt, Wot, Wot, Wot
Gg, Gg, Gg, Gs, Gs, Gg, Gg, Gg, Gs, Gg, Gs, Gg, Gg, Gg, Gs, Gs, Gs, Gg, Gg, Gs, Gg, Gg, Gg, Gg, Gg, Rmo, Rmo, Rmo, Rmo, Rmo, Gg, Rmo, Rmo, Rmo, Rmo, Rmo, Rmo, Rmo, Rmo, Rmo, Rmo^Vdm, Rmo, Rmo, Kd, Kd, Kd, Rmo, Rmo, Rmo, Rmo, Kd, Rmo, Rmo, Rmo, Rmo, Rmo, Kd, Wwt^Bsb/, Wwt, Wot, Wot, Wot, Wot, Wot, Wot, Wot
Gs, Gs, Gs, Gs, Gs^Ftp, Gs, Gs, Gs, Gs^Ftp, Gs, Gs^Ftp, Gs, Gs, Gs, Gs^Ftp, Gs, Gs^Ftp, Gs, Gg, Gg, Gg, Rmo^Vdm, Gg, Gg, Gs, Gg, Gg, Rmo, Gg, Gg, Gs, Gg, Gg, Rmo, Rmo, Rmo, Rmo^Vdm, Rmo, Kd, Rmo, Rmo, Rmo, Rmo, Rmo, Rmo, Rmo, Rmo^Vdm, Rmo, Rmo, Rmo, Cd, Rmo, Rmo, Rmo, Cd, Rmp, Wwt, Wwt, Wot, Wot, Wot, Wot, Wwrt, Wot, Wot, Wot
Dd^Ftd, Dd^Ftd, Gs^Ftp, Gs^Ftp, Dd^Ftd, Gs^Ftp, Gs^Ftp, Gs^Ftp, Gs^Ftp, Gs^Ftp, Gs^Ftp, Gs^Ftp, Gs, Gs, Gs, Gs, Gs^Ftp, Gs, Gs^Ftp, Gs, Gs, Gg, Gs, Gs, Gs^Ftp, Gs, Gs, Gg, Gg, Gs, Gg, Gs, Gg, Kd, Rmo, Rmo, Rmo, Rmo, Cd, Rmo, Rmo, Rmo^Vdm, Rmo, Rmo, Rmo, Rmo, Rmo, Rmo, Rmo, Rmo, Cd, Rmo, Rmo, Cd, Wwt, Wwt, Wwt, Wwt, Wot, Wot, Wot, Wot, Wwrt, Wot, Wot, Wot
Ds, Dd^Ftd, Dd^Ftd, Dd^Ftd, Ds, Dd^Ftd, Dd^Ftd, Gs^Ftp, Gs^Ftp, Gs^Ftp, Dd^Ftd, Gs^Ftp, Dd^Ftd, Gs, Gs, Gs^Ftp, Gs^Ftp, Gs^Ftp, Gs^Ftp, Gs, Ds, Gs, Gs^Ftp, Gs^Ftp, Gs^Ftp, Gs^Ftp, Gs^Ftp, Gs, Rmo^Vdm, Gg, Gg, Gs, Gg, Cd, Rmo, Rmo, Rmo^Vdm, Rmo, Cd, Rmo, Rmo, Rmo, Rmo, Rmo^Vdm, Rmo, Rmo, Rmo, Rmo^Vdm, Rmo, Cd, Rmo, Rmo, Cd, Cd, Wwt, Wwt, Wwt, Wwt, Wot, Wot, Wot, Wot, Wot, Wot, Wot, Wot
Ds, Ds, Ds, Ds, Ds, Ds, Ds, Dd^Ftd, Dd^Ftd, Dd^Ftd, Ds, Dd^Ftd, Ds, Ds, Ds, Dd^Ftd, Dd^Ftd, Gs^Ftp, Dd^Ftd, Dd^Ftd, Ds, Dd^Do, Dd^Ftd, Gs^Ftp, Gs^Ftp, Gs^Ftp, Gs^Ftp, Gs^Ftp, Gs, Gg, Gg, Gs, Gs, Cd, Cd, Rmo, Rmo, Rmo, Rmo, Cd, Rmo, Rmo, Rmo, Rmo, Rmo, Rmo, Rmo, Rmo, Rmo, Cd, Rmo, Rmo, Cd, Wwt, Wwt, Wwt, Wwt, Wwt, Wot, Wot, Wot, Wot, Wwrt, Wwrt, Wot, Wot
Wwt, Wwt, Wwt, Ds, Wwt, Ds, Ds, Ds, Ds, Ds, Ds, Ds, Ds, Ds, Ds, Ds, Ds, Dd^Ftd, Ds, Ds, Ds, Ds, Ds, Dd^Ftd, Dd^Ftd, Dd^Ftd, Dd^Ftd, Gs^Ftp, Dd^Ftd, Gs, Gg, Gg, Gs, Gg, Kd, Rmo, Rmo, Rmo, Cd, Kd, Cd, Rmo, Cd, Kd, Wot^Bsb|, Kd, Cd, Rmo, Cd, Kd, Rmo, Cd, Wwt, Wwt, Wwt, Wwt, Wwt, Wot, Wot, Wot, Wot, Wot, Wwrt, Wot, Wot, Wot
Wwt, Wwt, Wwt, Wwt, Wwt, Wwt, Wwt, Wwt, Wwt, Ds, Wwt, Ds, Wwt, Ds, Wwt, Ds, Ds, Ds, Wwt, Ds, Wwt, Wwt, Wwt, Ds, Ds, Ds, Ds, Dd^Ftd, Ds, Ds, Ds, Ds, Ds, Gs, Dd^Ftd, Cd, Kd, Cd, Ds, Ds, Wwt, Cd, Wwt, Wwt, Wot^Bsb|, Wwt, Wwt, Kd, Wwt, Cd, Cd, Cd, Wwt, Wwt, Wwt, Wwt, Wot, Wot, Wot, Wot, Wot, Wot, Wot, Wot, Wot, Wot
Wot, Wwt, Wot, Wwt, Wot, Wot, Wot, Wwt, Wwt, Wwt, Wwt, Wwt, Wwt, Wwt, Wwt, Wwt, Wwt, Wwt, Wwt, Wwt, Wwt, Wwt, Wwt, Wwt, Wwt, Ds, Ds, Ds, Ds, Ds, Ds, Ds, Ds, Ds, Ds, Dd^Ftd, Ds, Ds, Wwt, Wwt, Wwt, Wwt, Wwt, Wwt, Wot^Bsb|, Wwt, Wwt, Wwt, Wwt, Wwt, Wwt, Wwt, Wwt, Wot, Wot, Wwt, Wot, Wot, Wot, Wot, Wwrt, Wwrt, Wot, Wot, Wot, Wot
Wot, Wot, Wot, Wot, Wot, Wot, Wot, Wot, Wot, Wwt, Wot, Wwt, Wot, Wwt, Wwt, Wwt, Wwt, Wwt, Wwt, Wwt, Wot, Wot, Wot, Wwt, Wwt, Wwt, Wwt, Wwt, Wwt, Ds, Wwt, Ds, Wwt, Ds, Wwt, Ds, Wwt, Wwt, Wwt, Wwt, Wwt, Wwt, Dd^Ftd, Cd, Rmp, Cd, Dd^Ftd, Wwt, Wwt, Wwt, Wot, Wwt, Wot, Wot, Wot, Wot, Wot, Wot, Wot, Wot, Wot, Wot, Wot, Wot, Wot, Wot
Wot, Wot, Wot, Wot, Wot, Wot, Wot, Wot, Wot, Wot, Wot, Wot, Wot, Wot, Wot, Wot, Wot, Wot, Wot, Wot, Wot, Wot, Wot, Wot, Wot, Wwt, Wot, Wwt, Wwt, Wwt, Wwt, Wwt, Wot, Wwt, Wot, Wwt, Wot, Wot, Wot, Wwt, Ds, Dd^Ftd, Rmp, Rmp, Cd, Gs^Ftp, Gs^Ftp, Dd^Ftd, Wwt, Wot, Wot, Wot, Wot, Wot, Wot, Wot, Wot, Wot, Wwrt, Wot, Wot, Wot, Wot, Wot, Wwrt, Wwrt
Wwrt, Wot, Wwrt, Wot, Wot, Wot, Wot, Wot, Wot, Wot, Wot, Wot, Wot, Wot, Wot, Wot, Wot, Wot, Wot, Wot, Wot, Wot, Wot, Wot, Wot, Wot, Wot, Wot, Wot, Wot, Wot, Wot, Wot, Wot, Wot, Wot, Wot, Wot, Wot, Wwt, Dd^Ftd, Gs^Ftp, Rmp, 5 Kd, Kd, Cd, Gs^Ftp, Dd^Ftd, Wwt, Wwt, Wot, Wot, Wot, Wot, Wot, Wot, Wwrt, Wot, Wot, Wot, Wot, Wot, Wot, Wot, Wwrt, Wwrt
Wot, Wot, Wot, Wot, Wot, Wwrt, Wot, Wot, Wot, Wot, Wot, Wot, Wot, Wot, Wot, Wot, Wot, Wot, Wot, Wot, Wot, Wot, Wot, Wot, Wot, Wot, Wot, Wot, Wot, Wot, Wot, Wot, Wot, Wot, Wot, Wot, Wot, Wot, Wot, Wwt, Ds, Rmp, Cd, Kd, Cd, Cd, Dd^Ftd, Ds, Wwt, Wwt, Wot, Wot, Wot, Wot, Wot, Wot, Wot, Wot, Wot, Wot, Wot, Wot, Wot, Wwrt, Wot, Wot
Wot, Wot, Wot, Wot, Wot, Wwrt, Wot, Wwrt, Wot, Wot, Wot, Wwrt, Wwrt, Wot, Wot, Wot, Wot, Wot, Wot, Wot, Wot, Wot, Wot, Wot, Wot, Wot, Wot, Wot, Wot, Wot, Wot, Wot, Wot, Wot, Wot, Wot, Wot, Wot, Wot, Wwt, Dd^Ftd, Gs^Ftp, Gs^Ftp, Cd, Dd^Ftd, Gs^Ftp, Dd^Ftd, Wwt, Wot, Wot, Wot, Wot, Wot, Wot, Wwrt, Wwrt, Wot, Wot, Wot, Wot, Wot, Wot, Wot, Wwrt, Wot, Wot
Wot, Wot, Wot, Wot, Wot, Wwrt, Wwrt, Wot, Wot, Wot, Wot, Wot, Wot, Wot, Wot, Wot, Wot, Wot, Wwrt, Wot, Wwrt, Wot, Wwrt, Wot, Wot, Wot, Wot, Wot, Wot, Wwrt, Wot, Wwrt, Wot, Wot, Wot, Wot, Wot, Wot, Wot, Wwt, Wwt, Dd^Ftd, Ds, Dd^Ftd, Wwt, Dd^Ftd, Wwt, Wwt, Wot, Wot, Wot, Wot, Wot, Wot, Wot, Wot, Wot, Wot, Wot, Wot, Wot, Wot, Wot, Wwrt, Wot, Wot
Wot, Wot, Wot, Wot, Wot, Wot, Wot, Wwrt, Wot, Wot, Wot, Wot, Wwrt, Wot, Wot, Wwrt, Wwrt, Wwrt, Wot, Wot, Wot, Wot, Wot, Wwrt, Wwrt, Wot, Wot, Wot, Wot, Wot, Wot, Wwrt, Wot, Wot, Wot, Wwrt, Wwrt, Wot, Wot, Wot, Wot, Wwt, Wwt, Wwt, Wot, Wwt, Wot, Wot, Wot, Wot, Wot, Wot, Wot, Wwrt, Wot, Wot, Wot, Wot, Wot, Wot, Wot, Wot, Wot, Wwrt, Wot, Wot
Wot, Wot, Wot, Wot, Wot, Wot, Wot, Wot, Wot, Wot, Wot, Wot, Wot, Wot, Wot, Wot, Wot, Wot, Wot, Wot, Wot, Wot, Wot, Wot, Wwrt, Wwrt, Wot, Wot, Wwrt, Wot, Wot, Wot, Wot, Wot, Wot, Wot, Wwrt, Wwrt, Wot, Wot, Wot, Wot, Wot, Wot, Wot, Wot, Wot, Wot, Wot, Wot, Wot, Wot, Wwrt, Wwrt, Wot, Wot, Wot, Wot, Wot, Wot, Wwrt, Wwrt, Wot, Wot, Wot, Wot
Wot, Wot, Wot, Wot, Wot, Wot, Wot, Wot, Wot, Wot, Wot, Wot, Wot, Wot, Wot, Wot, Wot, Wot, Wot, Wot, Wot, Wot, Wot, Wot, Wot, Wot, Wot, Wot, Wot, Wot, Wot, Wot, Wot, Wot, Wot, Wot, Wot, Wwrt, Wwrt, Wot, Wot, Wot, Wot, Wot, Wot, Wot, Wot, Wot, Wot, Wot, Wot, Wot, Wot, Wot, Wot, Wot, Wot, Wwrt, Wot, Wwrt, Wot, Wot, Wot, Wot, Wot, Wot
Wot, Wot, Wot, Wot, Wot, Wot, Wot, Wot, Wot, Wot, Wot, Wot, Wot, Wot, Wot, Wot, Wot, Wot, Wot, Wot, Wot, Wot, Wot, Wot, Wot, Wot, Wot, Wot, Wot, Wot, Wot, Wot, Wot, Wot, Wot, Wot, Wot, Wot, Wot, Wot, Wot, Wot, Wot, Wot, Wwrt, Wwrt, Wwrt, Wot, Wot, Wwrt, Wot, Wot, Wot, Wot, Wot, Wot, Wot, Wwrt, Wot, Wot, Wot, Wot, Wot, Wot, Wot, Wot
Wot, Wot, Wot, Wot, Wot, Wot, Wot, Wot, Wot, Wot, Wot, Wot, Wot, Wot, Wot, Wot, Wot, Wot, Wot, Wot, Wot, Wot, Wot, Wot, Wot, Wot, Wot, Wot, Wot, Wot, Wot, Wot, Wot, Wot, Wot, Wot, Wot, Wot, Wot, Wot, Wot, Wwrt, Wot, Wot, Wot, Wot, Wot, Wwrt, Wot, Wot, Wot, Wot, Wot, Wot, Wot, Wot, Wot, Wwrt, Wot, Wot, Wot, Wot, Wot, Wot, Wot, Wot
Wot, Wot, Wwrt, Wwrt, Wwrt, Wwrt, Wot, Wot, Wot, Wot, Wot, Wot, Wot, Wot, Wot, Wot, Wot, Wot, Wot, Wot, Wot, Wot, Wot, Wot, Wot, Wot, Wot, Wot, Wot, Wot, Wot, Wot, Wot, Wot, Wot, Wot, Wot, Wot, Wot, Wot, Wot, Wot, Wot, Wot, Wot, Wot, Wot, Wot, Wot, Wot, Wot, Wot, Wot, Wot, Wot, Wot, Wwrt, Wot, Wot, Wot, Wot, Wot, Wot, Wot, Wot, Wot
Wwrt, Wot, Wot, Wot, Wot, Wot, Wot, Wwrt, Wot, Wwrt, Wot, Wwrt, Wwrt, Wot, Wot, Wot, Wot, Wot, Wot, Wot, Wot, Wot, Wot, Wot, Wot, Wot, Wot, Wot, Wwrt, Wwrt, Wot, Wot, Wwrt, Wot, Wwrt, Wot, Wot, Wot, Wot, Wot, Wot, Wot, Wot, Wot, Wot, Wot, Wot, Wot, Wot, Wot, Wot, Wot, Wot, Wot, Wot, Wot, Wwrt, Wot, Wot, Wot, Wot, Wot, Wot, Wot, Wot, Wot
