Rmo, Rmo, Rmo, Xoi, Xoi, Xoi, Xoi, Xoi, Xoi, Xoi, Xoi, Xoi, Xoi, Xoi, Xoi, Rmo, Rmo, Rmo, Xoi, Xoi, Xoi, Xoi, Xoi, Xoi, Xoi, Xoi, Xoi, Xoi, Xoi, Xoi, Rmo, Rmo, Rmo
Rmo, Rmo, 2 Rmo, Rmo, Rmo, Xoi, Rmo, Xoi, Rmo, Xoi, Rmo, Xoi, Rmo, Xoi, Rmo, Rmo^Xo, Rmo, Rmo, Rmo, Xoi, Rmo, Xoi, Rmo, Xoi, Rmo, Xoi, Rmo, Xoi, Rmo, Rmo, Rmo, Rmo, Rmo
Xoi, Rmo, Rmo, Rmo, Rmo, Rmo, Rmo, Rmo, Rmo, Rmo, Rmo, Rmo, Rmo, Rmo, Rmo, Rmo^Xo, Rmo, Rmo, Rmo, Rmo, Rmo, Rmo, Rmo, Rmo, Rmo, Rmo, Rmo, Rmo, Rmo, Rmo, Rmo, Rmo, Xoi
Xoi, Xoi, Xoi, Rmo, Rmo, Rmo, Rmo, Rmo, Rmo, Rmo, Rmo, Rmo, Rmo, Rmo, Rmo, Rmo^Xo, Rmo, Rmo, Rmo, Rmo, Rmo, Rmo, Rmo, Rmo, Rmo, Rmo, Rmo, Rmo, Rmo, Rmo, Xoi, Xoi, Xoi
Xoi, Xoi, Xoi, Rmo, Rmo, Rmo, 1 Rmo, Rmo, Rmo, Rmo, Rmo, Rmo, Rmo, Rmo, Rmo, Rmo^Xo, Rmo, Rmo, Rmo, Rmo, Rmo, Rmo, Rmo, Rmo, Rmo, Rmo, Rmo, Rmo, Rmo, Rmo, Xoi, Xoi, Xoi
Xoi, Xoi, Xoi, Rmo, Rmo, Rmo, Rmo, Rmo, Rmp, Rmp, Rmp, Rmo, Rmo, Rmo, Rmo, Rmo^Xo, Rmo, Rmo, Rmo, Rmo, Rmo, Rmo, Rmp, Rmp, Rmp, Rmo, Rmo, Rmo, Rmo, Rmo, Xoi, Xoi, Xoi
Xoi, Xoi, Xoi, Rmo, Rmo, Rmo, Rmp, Rmp, Rmp, Rmp, Rmp, Rmp, Rmo, Rmo, Rmo, Rmo, Rmp, Rmo, Rmo, Rmo, Rmo, Rmp, Rmp, Rmp, Rmp, Rmp, Rmp, Rmo, Rmo, Rmo, Xoi, Xoi, Xoi
Xoi, Xoi, Xoi, Rmo, Rmo, Rmo, Rmp, Rmp, Rmp, Rmp, Rmo, Rmo, Rmo, Rmo, Rmo, Rmp, Rmp^Ys, Rmp, Rmo, Rmo, Rmo, Rmo, Rmo, Rmp, Rmp, Rmp, Rmp, Rmo, Rmo, Rmo, Xoi, Xoi, Xoi
Xoi, Xoi, Xoi, Rmo, Rmo, Rmp, Rmp, Rmp, Rmp, Rmo, Rmo, Rmo, Rmo, Rmo, Rmo, Rmp, Rmp, Rmp, Rmo, Rmo, Rmo, Rmo, Rmo, Rmo, Rmp, Rmp, Rmp, Rmp, Rmo, Rmo, Xoi, Xoi, Xoi
Xoi, Xoi, Xoi, Rmo, Rmo, Rmp, Rmp, Rmp, Rmp, Rmo, Rmp, Rmo, Rmp, Rmo, Rmp, Rmp, Rmp, Rmo, Rmp, Rmo, Rmp, Rmo, Rmp, Rmo, Rmp, Rmp, Rmp, Rmp, Rmo, Rmo, Xoi, Xoi, Xoi
Xoi, Xoi, Xoi, Rmo, Rmo^Xo, Rmp, Rmp, Rmp, Rmp^Cov, Rmp^Cov, Rmp^Cov, Rmp, Rmp, Rmp, Rmp, Rmp, Rmp, Rmp, Rmp, Rmp, Rmp, Rmp, Rmp^Cov, Rmp^Cov, Rmp^Cov, Rmp, Rmp, Rmp, Rmo, Rmo, Xoi, Xoi, Xoi
Xoi, Xoi, Xoi, Rmo^Xo, Rmo, Rmp^Xo, Rmp, Rmp, Rmp^Cov, Rmp^Kov, Rmp^Cov, Rmp, Rmp, Rmp, Rmp, Rmp, Rmp, Rmp, Rmp, Rmp, Rmp, Rmp, Rmp^Cov, 4 Rmp^Kov, Rmp^Cov, Rmp, Rmp, Rmp, Rmo, Rmo, Xoi, Xoi, Xoi
Xoi, Xoi, Xoi, Rmo, Rmo, Rmo, Rmo, Rmp, Rmp, Rmp^Cov, Rmp, Rmp, Rmp, Rmp, Rmp, Rmp, Rmp, Rmp, Rmp, Rmp, Rmp, Rmp, Rmp, Rmp^Cov, Rmp, Rmp, Rmo, Rmo, Rmo, Rmo, Xoi, Xoi, Xoi
Xoi, Xoi, Xoi, Rmo, Rmo, Rmo, Rmo, Rmo, Rmo, Rmp, Rmo, Rmp, Rmo, Rmp, Rmo, Rmp, Rmp, Rmp, Rmo, Rmp, Rmo, Rmp, Rmo, Rmp, Rmo, Rmo, Rmo, Rmo, Rmo, Rmo, Xoi, Xoi, Xoi
Xoi, Xoi, Xoi, Rmo, Rmo, Rmo, Rmo, Rmo, Rmo, Rmo, Rmo, Rmo, Rmo, Rmo, Rmo, Rmp, Rmp, Rmp, Rmo, Rmo, Rmo, Rmo, Rmo, Rmo, Rmo, Rmo, Rmo, Rmo, Rmo, Rmo, Xoi, Xoi, Xoi
Xoi, Xoi, Xoi, Rmo, Rmo, Rmo, Rmo, Rmo, Rmo, Rmo, Rmo, Rmo, Rmo, Rmo, Rmo, Rmp, Rmp, Rmp, Rmo, Rmo, Rmo, Rmo, Rmo, Rmo, Rmo, Rmo, Rmo, Rmo, Rmo, Rmo, Xoi, Xoi, Xoi
Xoi, Xoi, Xoi, Rmo, Rmo, Rmo, Rmo, Rmo, Rmo, Rmo, Rmo, Rmo, Rmo, Rmo, Rmo, Rmp, Rmp, Rmp, Rmo, Rmo, Rmo, Rmo, Rmo, Rmo, Rmo, Rmo, Rmo, Rmo, Rmo, Rmo, Xoi, Xoi, Xoi
Xoi, Xoi, Xoi, Rmo, Rmo, Rmo, Rmo, Rmo, Rmo, Rmo, Rmo, Rmo, Rmo, Rmo, Rmo, Rmp, Rmp, Rmp, Rmo, Rmo, Rmo, Rmo, Rmo, Rmo, Rmo, Rmo, Rmo, Rmo, Rmo, Rmo, Xoi, Xoi, Xoi
Xoi, Xoi, Xoi, Rmo, Rmo, Rmo, Rmo, Rmo, Rmo, Rmo, Rmo, Rmo, Rmo, Rmo, Rmo, Rmp, Rmp, Rmp, Rmo, Rmo, Rmo, Rmo, Rmo, Rmo, Rmo, Rmo, Rmo, Rmo, Rmo, Rmo, Xoi, Xoi, Xoi
Xoi, Xoi, Xoi, Rmo, Rmo, Rmo, Rmo, Rmo, Rmo, Rmo, Rmo, Rmo, Rmo, Rmo, Rmo, Rmp, Rmp, Rmp, Rmp, Rmo, Rmo, Rmo, Rmo, Rmo, Rmo, Rmo, Rmo, Rmo, Rmo, Rmo, Xoi, Xoi, Xoi
Xoi, Xoi, Rmo, Rmo, Rmo, Rmo, Rmo, Rmo, Rmo, Rmo, Rmo, Rmo, Rmo, Rmo, Rmo, Rmp, Rmo, Rmp, Rmo, Rmo, Rmo, Rmo, Rmo, Rmo, Rmo, Rmo, Rmo, Rmo, Rmo, Rmo, Rmo, Xoi, Xoi
Rmo, Rmo, Rmo, Rmo, Rmo, Rmo, Xoi, Rmo, Xoi, Rmo, Xoi, Rmo, Xoi, Rmo, Xoi, Rmo, Rmo, Rmo, Xoi, Rmo, Xoi, Rmo, Xoi, Rmo, Xoi, Rmo, Xoi, Rmo, Rmo, Rmo, Rmo, Rmo, Rmo
Rmo, Rmo, Rmo, Rmo, Xoi, Xoi, Xoi, Xoi, Xoi, Xoi, Xoi, Xoi, Xoi, Xoi, Xoi, Rmo, Rmo, Rmo, Xoi, Xoi, Xoi, Xoi, Xoi, Xoi, Xoi, Xoi, Xoi, Xoi, Xoi, Rmo, Rmo, Rmo, Rmo
