border_size=1
usage=map

Hh^Fp, Hh^Fp, Hh^Fp, Hh^Fp, Hh^Fp, Hh^Fp, Hh^Fp, Hh^Fp, Gs, Gs, Rr, Rr, Rr, Gs, Hh^Fp, Hh^Fp, Hh^Fp, Hh^Fp, Mm, Gg
Hh^Fp, Hh^Fp, Mm, Hh^Fp, Mm, Hh^Fp, Hh^Fp, Hh^Fp, Gs, Gs, Rr, Rr, Rr, Gs, Hh^Fp, Hh^Fp, Mm, Mm, Mm, Mm
Mm, Mm, Mm, Mm, Mm, Mm, Mm, Hh^Fp, Hh^Fp, Gs, Rr, Rr, Rr, Gs, Hh^Fp, Hh^Fp, Mm, Mm, Mm, Mm
Xuc, Mm, Mm, Mm, Mm, Mm, Mm, Mm, Mm, Gs, Rr, Rr, Rr, Gs, Hh^Fp, Mm, Mm, Mm, Xuc, Mm
Xuc, Xuc, Xuc, Xuc, Xuc, Xuc, Xuc, Mm, Mm, Gs, Rr, Rr, Rr, Gs, Mm, Mm, Xuc, Xuc, Xuc, Xuc
Xuc, Xuc, Xuc, Xuc, Xuc, Xuc, Xuc, Xuc, Xuc, Cud, Rr, Rr, Rr, Cud, Xuc, Xuc, Xuc, Xuc, Xuc, Xuc
Xuc, Xuc, Xuc, Xuc, Xuc, Xuc, Xuc, Xuc, Cud, Cud, Rr, Rr, Rr, Cud, Cud, Xuc, Xuc, Xuc, Xuc, Xuc
Xuc, Xuc, Xuc, Xuc, Cud, Xuc, Urb, Urb, Urb, Urb, Rr, Rr, Rr, Urb, Urb, Urb, Urb, Xuc, Cud, Xuc
Cud, Xuc, Urb, Cud, Urb, Cud, Urb, Urb, Urb, Urb, Rr, Rr, Rr, Urb, Urb, Urb, Urb, Cud, Urb, Cud
Urb, Cud, Urb, Urb, Urb, Urb, Cud, Cud, Rr, Rr, Rr, Rr, Rr, Rr, Rr, Cud, Cud, Urb, Urb, Urb
Urb, Urb, Urb, Urb, Urb, Urb, Cud, Rr, Rr, Rr, Rr, Rr, Rr, 1 Rr, Rr, Rr, Cud, Urb, Urb, Urb
Urb, Urb, Urb, Urb, Urb, Urb, Urb, Rr, Rr, Rr, Rr, Rr, Rr, Rr, Rr, Rr, Urb, Urb, Urb, Urb
Urb, Urb, Urb, Urb, Urb, Urb, Cud, Rr, Rr, Rr, Rr, Rr, Rr, Rr, Rr, Rr, Cud, Urb, Urb, Urb
Urb, Urb, Urb, Urb, Urb, Urb, Cud, Rr, Urb, Rr, Urb, Rr, Rr, Rr, Rr, Rr, Cud, Urb, Urb, Urb
