border_size=1
usage=map

Xos^Efs, Xos^Efs, Xos^Efs, Xos^Efs, Xos^Efs, Xos^Efs, Xos^Efs, Xos^Efs, Xos^Efs, Xos^Efs, Xos^Efs, Xos^Efs, Xos^Efs, Xos^Efs, Xos^Efs, Xos^Efs, Xos^Efs
Xos^Efs, Xos^Efs, Xos^Efs, Xos^Efs, Xos^Efs, Xos^Efs, Xos^Efs, Xos^Efs, Xos^Efs, Xos^Efs, Xos^Efs, Xos^Efs, Xos^Efs, Xos^Efs, Xos^Efs, Xos^Efs, Xos^Efs
Xos^Efs, Xos^Efs, Xos^Efs, Xos^Efs, Xos^Efs, Xos^Efs, Xos^Efs, Xos^Efs, Xos^Efs, Xos^Efs, Xos^Efs, Xos^Efs, Xos^Efs, Xos^Efs, Xos^Efs, Xos^Efs, Xos^Efs
Xos^Efs, Xos^Efs, Xos^Efs, Xos^Efs, Xos^Efs, Xos^Efs, Xos^Efs, Xos^Efs, Urb, Xos^Efs, Xos^Efs, Xos^Efs, Xos^Efs, Xos^Efs, Xos^Efs, Xos^Efs, Xos^Efs
Xos^Efs, Xos^Efs, Xos^Efs, Xos^Efs, Xos^Efs, Xos^Efs, Urb, Urb, Urb, Urb, Urb, Xos^Efs, Xos^Efs, Xos^Efs, Xos^Efs, Xos^Efs, Xos^Efs
Xos^Efs, Xos^Efs, Xos^Efs, Xos^Efs, Qlf^Ii, Urb, Urb, Urb, Kud, Urb, Urb, Urb, Qlf^Ii, Xos^Efs, Xos^Efs, Xos^Efs, Xos^Efs
Xos^Efs, Xos^Efs, Xos^Efs, Xos^Efs, Urb, Urb, Kud, Urb, Urb, Urb, Kud, Urb, Urb, Xos^Efs, Xos^Efs, Xos^Efs, Xos^Efs
Xos^Efs, Xos^Efs, Xos^Efs, Xos^Efs, Urb, Urb, Urb, Urb, Urb, Urb, Urb, Urb, Urb, Xos^Efs, Xos^Efs, Xos^Efs, Xos^Efs
Xos^Efs, Xos^Efs, Xos^Efs, Xos^Efs, Urb, Kud, Urb, Urb, Urb, Urb, Urb, Kud, Urb, Xos^Efs, Xos^Efs, Xos^Efs, Xos^Efs
Xos^Efs, Xos^Efs, Xos^Efs, Xos^Efs, Urb, Urb, Urb, Urb, Urb, Urb, Urb, Urb, Urb, Xos^Efs, Xos^Efs, Xos^Efs, Xos^Efs
Xos^Efs, Xos^Efs, Xos^Efs, Xos^Efs, Urb, Kud^Ii, Urb, Urb, Urb, Urb, Urb, Kud, Urb, Xos^Efs, Xos^Efs, Xos^Efs, Xos^Efs
Xos^Efs, Xos^Efs, Xos^Efs, Xos^Efs, Qlf^Ii, Urb, Kud, Urb, Urb, Urb, Kud, Urb, Qlf^Ii, Xos^Efs, Xos^Efs, Xos^Efs, Xos^Efs
Xos^Efs, Xos^Efs, Xos^Efs, Xos^Efs, Qlf^Ii, Urb, Urb, Urb, Urb, Urb, Urb, Urb, Qlf^Ii, Xos^Efs, Xos^Efs, Xos^Efs, Xos^Efs
Xos^Efs, Xos^Efs, Xos^Efs, Xos^Efs, Xos^Efs, Qlf^Ii, Urb, Urb, Urb, Urb, Urb, Qlf^Ii, Xos^Efs, Xos^Efs, Xos^Efs, Xos^Efs, Xos^Efs
Xos^Efs, Xos^Efs, Xos^Efs, Xos^Efs, Xos^Efs, Xos^Efs, Xos^Efs, Urb, Urb, Urb, Xos^Efs, Xos^Efs, Xos^Efs, Xos^Efs, Xos^Efs, Xos^Efs, Xos^Efs
Xos^Efs, Xos^Efs, Xos^Efs, Xos^Efs, Xos^Efs, Xos^Efs, Xos^Efs, Urb, Urb, Urb, Xos^Efs, Xos^Efs, Xos^Efs, Xos^Efs, Xos^Efs, Xos^Efs, Xos^Efs
Xos^Efs, Xos^Efs, Xos^Efs, Xos^Efs, Xos^Efs, Xos^Efs, Xos^Efs, Urb, Urb, Urb, Xos^Efs, Xos^Efs, Xos^Efs, Xos^Efs, Xos^Efs, Xos^Efs, Xos^Efs
Xos^Efs, Xos^Efs, Xos^Efs, Xos^Efs, Xos^Efs, Xos^Efs, Xos^Efs, Urb, Urb, Urb, Xos^Efs, Xos^Efs, Xos^Efs, Xos^Efs, Xos^Efs, Xos^Efs, Xos^Efs
Xos^Efs, Xos^Efs, Xos^Efs, Xos^Efs, Xos^Efs, Xos^Efs, Xos^Efs, Urb, Urb, Urb, Xos^Efs, Xos^Efs, Xos^Efs, Xos^Efs, Xos^Efs, Xos^Efs, Xos^Efs
