border_size=1
usage=map

Qxdp, Qxdp, Qxdp, Qxdp, Qxdp, Qxdp, Qxdp, Qxdp, Qxdp, Qxdp, Qxdp, Qxdp, Qxdp, Qxdp, Qxdp, Qxdp, Qxdp, Qxdp, Qxdp, Qxdp, Qxdp, Qxdp, Qxdp, Qxdp, Qxdp, Qxdp, Qxdp, Qxdp, Qxdp, Qxdp, Qxdp, Qxdp, Qxdp, Qxdp, Qxdp, Qxdp, Qxdp, Qxdp, Qxdp, Qxdp, Qxdp, Qxdp
Qxdp, Qxdp, Qxdp, Qxdp, Qxdp, Qxdp, Qxdp, Qxdp, Qxdp, Qxdp, Qxdp, Qxdp, Qxdp, Qxdp, Qxdp, Qxdp, Qxdp, Qxdp, Qxdp, Qxdp, Qxdp, Qxdp, Qxdp, Qxdp, Qxdp, Qxdp, Qxdp, Qxdp, Qxdp, Qxdp, Qxdp, Qxdp, Qxdp, Qxdp, Qxdp, Qxdp, Qxdp, Qxdp, Qxdp, Qxdp, Qxdp, Qxdp
Qxdp, Qxdp, Qxdp, Qxdp, Qxdp, Qxdp, Qxdp, Qxdp, Qxdp, Qxdp, Qxdp, Qxdp, Qxdp, Qxdp, Qxdp, Qxdp, Qxdp, Qxdp, Qxdp, Qxdp, Qxdp, Qxdp, Qxdp, Qxdp, Qxdp, Qxdp, Qxdp, Qxdp, Qxdp, Qxdp, Qxdp, Qxdp, Qxdp, Qxdp, Qxdp, Qxdp, Qxdp, Qxdp, Qxdp, Qxdp, Qxdp, Qxdp
Qxdp, Qxdp, Qxdp, Qxdp, Qxdp, Qxdp, Qxdp, Qxdp, Qxdp, Qxdp, Qxdp, Qxdp, Qxdp, Qxdp, Qxdp, Qxdp, Qxdp, Qxdp, Qxdp, Qxdp, Qxdp, Qxdp, Qxdp, Qxdp, Qxdp, Qxdp, Qxdp, Qxdp, Qxdp, Qxdp, Qxdp, Qxdp, Qxdp, Qxdp, Qxdp, Qxdp, Qxdp, Qxdp, Qxdp, Qxdp, Qxdp, Qxdp
Qxdp, Qxdp, Qxdp, Qxdp, Qxdp, Qxdp, Qxdp, Qxdp, Qxdp, Qxdp, Qxdp, Qxdp, Qxdp, Qxdp, Qxdp, Qxdp, Qxdp, Qxdp, Qxdp, Qxdp, Qxdp, Qxdp, Qxdp, Qxdp, Qxdp, Qxdp, Qxdp, Qxdp, Qxdp, Qxdp, Qxdp, Qxdp, Qxdp, Qxdp, Qxdp, Qxdp, Qxdp, Qxdp, Qxdp, Qxdp, Qxdp, Qxdp
Qxdp, Qxdp, Qxdp, Qxdp, Qxdp, Qxdp, Qxdp, Qxdp, Qxdp, Qxdp, Qxdp, Qxdp, Qxdp, Qxdp, Qxdp, Qxdp, Qxdp, Qxdp, Qxdp, Qxdp, Qxdp, Qxdp, Qxdp, Qxdp, Qxdp, Qxdp, Qxdp, Qxdp, Qxdp, Qxdp, Qxdp, Qxdp, Qxdp, Qxdp, Qxdp, Qxdp, Qxdp, Qxdp, Qxdp, Qxdp, Qxdp, Qxdp
Qxdp, Qxdp, Qxdp, Qxdp, Qxdp, Qxdp, Qxdp, Qxdp, Qxdp, Qxdp, Qxdp, Qxdp, Qxdp, Qxdp, Qxdp, Qxdp, Qxdp, Qxdp, Qxdp, Qxdp, Qxdp, Qxdp, Qxdp, Qxdp, Qxdp, Qxdp, Qxdp, Qxdp, Qxdp, Qxdp, Qxdp, Qxdp, Qxdp, Qxdp, Qxdp, Qxdp, Qxdp, Qxdp, Qxdp, Qxdp, Qxdp, Qxdp
Qxdp, Qxdp, Qxdp, Qxdp, Qxdp, Qxdp, Qxdp, Qxdp, Qxdp, Qxdp, Qxdp, Qxdp, Qxdp, Qxdp, Qxdp, Qxdp, Qxdp, Qxdp, Qxdp, Qxdp, Qxdp, Qxdp, Qxdp, Qxdp, Qxdp, Qxdp, Qxdp, Qxdp, Qxdp, Qxdp, Qxdp, Qxdp, Qxdp, Qxdp, Qxdp, Qxdp, Qxdp, Qxdp, Qxdp, Qxdp, Qxdp, Qxdp
Qxdp, Qxdp, Qxdp, Qxdp, Qxdp, Qxdp, Qxdp, Qxdp, Qxdp, Qxdp, Qxdp, Qxdp, Qxdp, Qxdp, Qxdp, Qxdp, Qxdp, Qxdp, Qxdp, Qxdp, Qxdp, Qxdp, Qxdp, Qxdp, Qxdp, Qxdp, Qxdp, Qxdp, Qxdp, Qxdp, Qxdp, Qxdp, Qxdp, Qxdp, Qxdp, Qxdp, Qxdp, Qxdp, Qxdp, Qxdp, Qxdp, Qxdp
Qxdp, Qxdp, Qxdp, Qxdp, Qxdp, Qxdp, Qxdp, Qxdp, Qxdp, Qxdp, Qxdp, Qxdp, Qxdp, Qxdp, Qxdp, Qxdp, Qxdp, Qxdp, Qxdp, Qxdp, Qxdp, Qxdp, Qxdp, Qxdp, Qxdp, Qxdp, Qxdp, Qxdp, Qxdp, Qxdp, Qxdp, Qxdp, Qxdp, Qxdp, Qxdp, Qxdp, Qxdp, Qxdp, Qxdp, Qxdp, Qxdp, Qxdp
Qxdp, Qxdp, Qxdp, Qxdp, Qxdp, Qxdp, Qxdp, Qxdp, Qxdp, Qxdp, Qxdp, Qxdp, Qxdp, Qxdp, Qxdp, Qxdp, Qxdp, Qxdp, Qxdp, Qxdp, Qxdp, Qxdp, Qxdp, Qxdp, Qxdp, Qxdp, Qxdp, Qxdp, Qxdp, Qxdp, Qxdp, Qxdp, Qxdp, Qxdp, Qxdp, Qxdp, Qxdp, Qxdp, Qxdp, Qxdp, Qxdp, Qxdp
Qxdp, Qxdp, Qxdp, Qxdp, Qxdp, Qxdp, Qxdp, Qxdp, Qxdp, Qxdp, Qxdp, Qxdp, Qxdp, Qxdp, Qxdp, Qxdp, Qxdp, Qxdp, Qxdp, Qxdp, Qxdp, Qxdp, Qxdp, Qxdp, Qxdp, Qxdp, Qxdp, Qxdp, Qxdp, Qxdp, Qxdp, Qxdp, Qxdp, Qxdp, Qxdp, Qxdp, Qxdp, Qxdp, Qxdp, Qxdp, Qxdp, Qxdp
Qxdp, Qxdp, Qxdp, Qxdp, Qxdp, Qxdp, Qxdp, Qxdp, Qxdp, Qxdp, Qxdp, Qxdp, Qxdp, Qxdp, Qxdp, Qxdp, Qxdp, Qxdp, Qxdp, Qxdp, Qxdp, Qxdp, Qxdp, Qxdp, Qxdp, Qxdp, Qxdp, Qxdp, Qxdp, Qxdp, Qxdp, Qxdp, Qxdp, Qxdp, Qxdp, Qxdp, Qxdp, Qxdp, Qxdp, Qxdp, Qxdp, Qxdp
Qxdp, Qxdp, Qxdp, Qxdp, Qxdp, Qxdp, Qxdp, Qxdp, Qxdp, Qxdp, Qxdp, Qxdp, Qxdp, Qxdp, Qxdp, Qxdp, Qxdp, Qxdp, Qxdp, Qxdp, Qxdp, Qxdp, Qxdp, Qxdp, Qxdp, Qxdp, Qxdp, Qxdp, Qxdp, Qxdp, Qxdp, Qxdp, Qxdp, Qxdp, Qxdp, Qxdp, Qxdp, Qxdp, Qxdp, Qxdp, Qxdp, Qxdp
Qxdp, Qxdp, Qxdp, Qxdp, Qxdp, Qxdp, Qxdp, Qxdp, Qxdp, Qxdp, Qxdp, Qxdp, Qxdp, Qxdp, Qxdp, Qxdp, Qxdp, Qxdp, Qxdp, Qxdp, Qxdp, Qxdp, Qxdp, Qxdp, Qxdp, Qxdp, Qxdp, Qxdp, Qxdp, Qxdp, Qxdp, Qxdp, Qxdp, Qxdp, Qxdp, Qxdp, Qxdp, Qxdp, Qxdp, Qxdp, Qxdp, Qxdp
Qxdp, Qxdp, Qxdp, Qxdp, Qxdp, Qxdp, Qxdp, Qxdp, Qxdp, Qxdp, Qxdp, Qxdp, Qxdp, Qxdp, Qxdp, Qxdp, Qxdp, Qxdp, Qxdp, Qxdp, Qxdp, Qxdp, Qxdp, Qxdp, Qxdp, Qxdp, Qxdp, Qxdp, Qxdp, Qxdp, Qxdp, Qxdp, Qxdp, Qxdp, Qxdp, Qxdp, Qxdp, Qxdp, Qxdp, Qxdp, Qxdp, Qxdp
Qxdp, Qxdp, Qxdp, Qxdp, Qxdp, Qxdp, Qxdp, Qxdp, Qxdp, Qxdp, Qxdp, Qxdp, Qxdp, Qxdp, Qxdp, Qxdp, Qxdp, Qxdp, Qxdp, Qxdp, Qxdp, Qxdp, Qxdp, Qxdp, Qxdp, Qxdp, Qxdp, Qxdp, Qxdp, Qxdp, Qxdp, Qxdp, Qxdp, Qxdp, Qxdp, Qxdp, Qxdp, Qxdp, Qxdp, Qxdp, Qxdp, Qxdp
Qxdp, Qxdp, Qxdp, Qxdp, Qxdp, Qxdp, Qxdp, Qxdp, Qxdp, Qxdp, Qxdp, Qxdp, Qxdp, Qxdp, Qxdp, Qxdp, Qxdp, Qxdp, Qxdp, Qxdp, Qxdp, Qxdp, Qxdp, Qxdp, Qxdp, Qxdp, Qxdp, Qxdp, Qxdp, Qxdp, Qxdp, Qxdp, Qxdp, Qxdp, Qxdp, Qxdp, Qxdp, Qxdp, Qxdp, Qxdp, Qxdp, Qxdp
Qxdp, Qxdp, Qxdp, Qxdp, Qxdp, Qxdp, Qxdp, Qxdp, Qxdp, Qxdp, Qxdp, Qxdp, Qxdp, Qxdp, Qxdp, Qxdp, Qxdp, Qxdp, Qxdp, Qxdp, Qxdp, Qxdp, Qxdp, Qxdp, Qxdp, Qxdp, Qxdp, Qxdp, Qxdp, Qxdp, Qxdp, Qxdp, Qxdp, Qxdp, Qxdp, Qxdp, Qxdp, Qxdp, Qxdp, Qxdp, Qxdp, Qxdp
Qxdp, Qxdp, Qxdp, Qxdp, Qxdp, Qxdp, Qxdp, Qxdp, Qxdp, Qxdp, Qxdp, Qxdp, Qxdp, Qxdp, Qxdp, Qxdp, Qxdp, Qxdp, Qxdp, Qxdp, Qxdp, Qxdp, Qxdp, Qxdp, Qxdp, Qxdp, Qxdp, Qxdp, Qxdp, Qxdp, Qxdp, Qxdp, Qxdp, Qxdp, Qxdp, Qxdp, Qxdp, Qxdp, Qxdp, Qxdp, Qxdp, Qxdp
Qxdp, Qxdp, Qxdp, Qxdp, Qxdp, Qxdp, Qxdp, Qxdp, Qxdp, Qxdp, Qxdp, Qxdp, Qxdp, Qxdp, Qxdp, Qxdp, Qxdp, Qxdp, Qxdp, Qxdp, Qxdp, Qxdp, Qxdp, Qxdp, Qxdp, Qxdp, Qxdp, Qxdp, Qxdp, Qxdp, Qxdp, Qxdp, Qxdp, Qxdp, Qxdp, Qxdp, Qxdp, Qxdp, Qxdp, Qxdp, Qxdp, Qxdp
Qxdp, Qxdp, Qxdp, Qxdp, Qxdp, Qxdp, Qxdp, Qxdp, Qxdp, Qxdp, Qxdp, Qxdp, Qxdp, Qxdp, Qxdp, Qxdp, Qxdp, Qxdp, Qxdp, Qxdp, Qxdp, Qxdp, Qxdp, Qxdp, Qxdp, Qxdp, Qxdp, Qxdp, Qxdp, Qxdp, Qxdp, Qxdp, Qxdp, Qxdp, Qxdp, Qxdp, Qxdp, Qxdp, Qxdp, Qxdp, Qxdp, Qxdp
Qxdp, Qxdp, Qxdp, Qxdp, Qxdp, Qxdp, Qxdp, Qxdp, Qxdp, Qxdp, Qxdp, Qxdp, Qxdp, Qxdp, Qxdp, Qxdp, Qxdp, Qxdp, Qxdp, Qxdp, Qxdp, Qxdp, Qxdp, Qxdp, Qxdp, Qxdp, Qxdp, Qxdp, Qxdp, Qxdp, Qxdp, Qxdp, Qxdp, Qxdp, Qxdp, Qxdp, Qxdp, Qxdp, Qxdp, Qxdp, Qxdp, Qxdp
Qxdp, Qxdp, Qxdp, Qxdp, Qxdp, Qxdp, Qxdp, Qxdp, Qxdp, Qxdp, Qxdp, Qxdp, Qxdp, Qxdp, Qxdp, Qxdp, Qxdp, Qxdp, Qxdp, Qxdp, Qxdp, Qxdp, Qxdp, Qxdp, Qxdp, Qxdp, Qxdp, Qxdp, Qxdp, Qxdp, Qxdp, Qxdp, Qxdp, Qxdp, Qxdp, Qxdp, Qxdp, Qxdp, Qxdp, Qxdp, Qxdp, Qxdp
Qxdp, Qxdp, Qxdp, Qxdp, Qxdp, Qxdp, Qxdp, Qxdp, Qxdp, Qxdp, Qxdp, Qxdp, Qxdp, Qxdp, Qxdp, Qxdp, Qxdp, Qxdp, Qxdp, Qxdp, Qxdp, Qxdp, Qxdp, Qxdp, Qxdp, Qxdp, Qxdp, Qxdp, Qxdp, Qxdp, Qxdp, Qxdp, Qxdp, Qxdp, Qxdp, Qxdp, Qxdp, Qxdp, Qxdp, Qxdp, Qxdp, Qxdp
Qxdp, Qxdp, Qxdp, Qxdp, Qxdp, Qxdp, Qxdp, Qxdp, Qxdp, Qxdp, Qxdp, Qxdp, Qxdp, Qxdp, Qxdp, Qxdp, Qxdp, Qxdp, Qxdp, Qxdp, Qxdp, Qxdp, Qxdp, Qxdp, Qxdp, Qxdp, Qxdp, Qxdp, Qxdp, Qxdp, Qxdp, Qxdp, Qxdp, Qxdp, Qxdp, Qxdp, Qxdp, Qxdp, Qxdp, Qxdp, Qxdp, Qxdp
Qxdp, Qxdp, Qxdp, Qxdp, Qxdp, Qxdp, Qxdp, Qxdp, Qxdp, Qxdp, Qxdp, Qxdp, Qxdp, Qxdp, Qxdp, Qxdp, Qxdp, Qxdp, Qxdp, Qxdp, Qxdp, Qxdp, Qxdp, Qxdp, Qxdp, Qxdp, Qxdp, Qxdp, Qxdp, Qxdp, Qxdp, Qxdp, Qxdp, Qxdp, Qxdp, Qxdp, Qxdp, Qxdp, Qxdp, Qxdp, Qxdp, Qxdp
Qxdp, Qxdp, Qxdp, Qxdp, Qxdp, Qxdp, Qxdp, Qxdp, Qxdp, Qxdp, Qxdp, Qxdp, Qxdp, Qxdp, Qxdp, Qxdp, Qxdp, Qxdp, Qxdp, Qxdp, Qxdp, Qxdp, Qxdp, Qxdp, Qxdp, Qxdp, Qxdp, Qxdp, Qxdp, Qxdp, Qxdp, Qxdp, Qxdp, Qxdp, Qxdp, Qxdp, Qxdp, Qxdp, Qxdp, Qxdp, Qxdp, Qxdp
Qxdp, Qxdp, Qxdp, Qxdp, Qxdp, Qxdp, Qxdp, Qxdp, Qxdp, Qxdp, Qxdp, Qxdp, Qxdp, Qxdp, Qxdp, Qxdp, Qxdp, Qxdp, Qxdp, Qxdp, Qxdp, Qxdp, Qxdp, Qxdp, Qxdp, Qxdp, Qxdp, Qxdp, Qxdp, Qxdp, Qxdp, Qxdp, Qxdp, Qxdp, Qxdp, Qxdp, Qxdp, Qxdp, Qxdp, Qxdp, Qxdp, Qxdp
Qxdp, Qxdp, Qxdp, Qxdp, Qxdp, Qxdp, Qxdp, Qxdp, Qxdp, Qxdp, Qxdp, Qxdp, Qxdp, Qxdp, Qxdp, Qxdp, Qxdp, Qxdp, Qxdp, Qxdp, Qxdp, Qxdp, Qxdp, Qxdp, Qxdp, Qxdp, Qxdp, Qxdp, Qxdp, Qxdp, Qxdp, Qxdp, Qxdp, Qxdp, Qxdp, Qxdp, Qxdp, Qxdp, Qxdp, Qxdp, Qxdp, Qxdp
Qxdp, Qxdp, Qxdp, Qxdp, Qxdp, Qxdp, Qxdp, Qxdp, Qxdp, Qxdp, Qxdp, Qxdp, Qxdp, Qxdp, Qxdp, Qxdp, Qxdp, Qxdp, Qxdp, Qxdp, Qxdp, Qxdp, Qxdp, Qxdp, Qxdp, Qxdp, Qxdp, Qxdp, Qxdp, Qxdp, Qxdp, Qxdp, Qxdp, Qxdp, Qxdp, Qxdp, Qxdp, Qxdp, Qxdp, Qxdp, Qxdp, Qxdp
Qxdp, Qxdp, Qxdp, Qxdp, Qxdp, Qxdp, Qxdp, Qxdp, Qxdp, Qxdp, Qxdp, Qxdp, Qxdp, Qxdp, Qxdp, Qxdp, Qxdp, Qxdp, Qxdp, Qxdp, Qxdp, Qxdp, Qxdp, Qxdp, Qxdp, Qxdp, Qxdp, Qxdp, Qxdp, Qxdp, Qxdp, Qxdp, Qxdp, Qxdp, Qxdp, Qxdp, Qxdp, Qxdp, Qxdp, Qxdp, Qxdp, Qxdp
Qxdp, Qxdp, Qxdp, Qxdp, Qxdp, Qxdp, Qxdp, Qxdp, Qxdp, Qxdp, Qxdp, Qxdp, Qxdp, Qxdp, Qxdp, Qxdp, Qxdp, Qxdp, Qxdp, Qxdp, Qxdp, Qxdp, Qxdp, Qxdp, Qxdp, Qxdp, Qxdp, Qxdp, Qxdp, Qxdp, Qxdp, Qxdp, Qxdp, Qxdp, Qxdp, Qxdp, Qxdp, Qxdp, Qxdp, Qxdp, Qxdp, Qxdp
Qxdp, Qxdp, Qxdp, Qxdp, Qxdp, Qxdp, Qxdp, Qxdp, Qxdp, Qxdp, Qxdp, Qxdp, Qxdp, Qxdp, Qxdp, Qxdp, Qxdp, Qxdp, Qxdp, Qxdp, Qxdp, Qxdp, Qxdp, Qxdp, Qxdp, Qxdp, Qxdp, Qxdp, Qxdp, Qxdp, Qxdp, Qxdp, Qxdp, Qxdp, Qxdp, Qxdp, Qxdp, Qxdp, Qxdp, Qxdp, Qxdp, Qxdp
Qxdp, Qxdp, Qxdp, Qxdp, Qxdp, Qxdp, Qxdp, Qxdp, Qxdp, Qxdp, Qxdp, Qxdp, Qxdp, Qxdp, Qxdp, Qxdp, Qxdp, Qxdp, Qxdp, Qxdp, Qxdp, Qxdp, Qxdp, Qxdp, Qxdp, Qxdp, Qxdp, Qxdp, Qxdp, Qxdp, Qxdp, Qxdp, Qxdp, Qxdp, Qxdp, Qxdp, Qxdp, Qxdp, Qxdp, Qxdp, Qxdp, Qxdp
Qxdp, Qxdp, Qxdp, Qxdp, Qxdp, Qxdp, Qxdp, Qxdp, Qxdp, Qxdp, Qxdp, Qxdp, Qxdp, Qxdp, Qxdp, Qxdp, Qxdp, Qxdp, Qxdp, Qxdp, Qxdp, Qxdp, Qxdp, Qxdp, Qxdp, Qxdp, Qxdp, Qxdp, Qxdp, Qxdp, Qxdp, Qxdp, Qxdp, Qxdp, Qxdp, Qxdp, Qxdp, Qxdp, Qxdp, Qxdp, Qxdp, Qxdp
Qxdp, Qxdp, Qxdp, Qxdp, Qxdp, Qxdp, Qxdp, Qxdp, Qxdp, Qxdp, Qxdp, Qxdp, Qxdp, Qxdp, Qxdp, Qxdp, Qxdp, Qxdp, Qxdp, Qxdp, Qxdp, Qxdp, Qxdp, Qxdp, Qxdp, Qxdp, Qxdp, Qxdp, Qxdp, Qxdp, Qxdp, Qxdp, Qxdp, Qxdp, Qxdp, Qxdp, Qxdp, Qxdp, Qxdp, Qxdp, Qxdp, Qxdp
Qxdp, Qxdp, Qxdp, Qxdp, Qxdp, Qxdp, Qxdp, Qxdp, Qxdp, Qxdp, Qxdp, Qxdp, Qxdp, Qxdp, Qxdp, Qxdp, Qxdp, Qxdp, Qxdp, Qxdp, Qxdp, Qxdp, Qxdp, Qxdp, Qxdp, Qxdp, Qxdp, Qxdp, Qxdp, Qxdp, Qxdp, Qxdp, Qxdp, Qxdp, Qxdp, Qxdp, Qxdp, Qxdp, Qxdp, Qxdp, Qxdp, Qxdp
Qxdp, Qxdp, Qxdp, Qxdp, Qxdp, Qxdp, Qxdp, Qxdp, Qxdp, Qxdp, Qxdp, Qxdp, Qxdp, Qxdp, Qxdp, Qxdp, Qxdp, Qxdp, Qxdp, Qxdp, Qxdp, Qxdp, Qxdp, Qxdp, Qxdp, Qxdp, Qxdp, Qxdp, Qxdp, Qxdp, Qxdp, Qxdp, Qxdp, Qxdp, Qxdp, Qxdp, Qxdp, Qxdp, Qxdp, Qxdp, Qxdp, Qxdp
Qxdp, Qxdp, Qxdp, Qxdp, Qxdp, Qxdp, Qxdp, Qxdp, Qxdp, Qxdp, Qxdp, Qxdp, Qxdp, Qxdp, Qxdp, Qxdp, Qxdp, Qxdp, Qxdp, Qxdp, Qxdp, Qxdp, Qxdp, Qxdp, Qxdp, Qxdp, Qxdp, Qxdp, Qxdp, Qxdp, Qxdp, Qxdp, Qxdp, Qxdp, Qxdp, Qxdp, Qxdp, Qxdp, Qxdp, Qxdp, Qxdp, Qxdp
Qxdp, Qxdp, Qxdp, Qxdp, Qxdp, Qxdp, Qxdp, Qxdp, Qxdp, Qxdp, Qxdp, Qxdp, Qxdp, Qxdp, Qxdp, Qxdp, Qxdp, Qxdp, Qxdp, Qxdp, Qxdp, Qxdp, Qxdp, Qxdp, Qxdp, Qxdp, Qxdp, Qxdp, Qxdp, Qxdp, Qxdp, Qxdp, Qxdp, Qxdp, Qxdp, Qxdp, Qxdp, Qxdp, Qxdp, Qxdp, Qxdp, Qxdp
Qxdp, Qxdp, Qxdp, Qxdp, Qxdp, Qxdp, Qxdp, Qxdp, Qxdp, Qxdp, Qxdp, Qxdp, Qxdp, Qxdp, Qxdp, Qxdp, Qxdp, Qxdp, Qxdp, Qxdp, Qxdp, Qxdp, Qxdp, Qxdp, Qxdp, Qxdp, Qxdp, Qxdp, Qxdp, Qxdp, Qxdp, Qxdp, Qxdp, Qxdp, Qxdp, Qxdp, Qxdp, Qxdp, Qxdp, Qxdp, Qxdp, Qxdp
Qxdp, Qxdp, Qxdp, Qxdp, Qxdp, Qxdp, Qxdp, Qxdp, Qxdp, Qxdp, Qxdp, Qxdp, Qxdp, Qxdp, Qxdp, Qxdp, Qxdp, Qxdp, Qxdp, Qxdp, Qxdp, Qxdp, Qxdp, Qxdp, Qxdp, Qxdp, Qxdp, Qxdp, Qxdp, Qxdp, Qxdp, Qxdp, Qxdp, Qxdp, Qxdp, Qxdp, Qxdp, Qxdp, Qxdp, Qxdp, Qxdp, Qxdp
Qxdp, Qxdp, Qxdp, Qxdp, Qxdp, Qxdp, Qxdp, Qxdp, Qxdp, Qxdp, Qxdp, Qxdp, Qxdp, Qxdp, Qxdp, Qxdp, Qxdp, Qxdp, Qxdp, Qxdp, Qxdp, Qxdp, Qxdp, Qxdp, Qxdp, Qxdp, Qxdp, Qxdp, Qxdp, Qxdp, Qxdp, Qxdp, Qxdp, Qxdp, Qxdp, Qxdp, Qxdp, Qxdp, Qxdp, Qxdp, Qxdp, Qxdp
Qxdp, Qxdp, Qxdp, Qxdp, Qxdp, Qxdp, Qxdp, Qxdp, Qxdp, Qxdp, Qxdp, Qxdp, Qxdp, Qxdp, Qxdp, Qxdp, Qxdp, Qxdp, Qxdp, Qxdp, Qxdp, Qxdp, Qxdp, Qxdp, Qxdp, Qxdp, Qxdp, Qxdp, Qxdp, Qxdp, Qxdp, Qxdp, Qxdp, Qxdp, Qxdp, Qxdp, Qxdp, Qxdp, Qxdp, Qxdp, Qxdp, Qxdp
