border_size=1
usage=map

Xos^Efs, Xos^Efs, Xos^Efs, Xos^Efs, Xos^Efs, Xos^Efs, Xos^Efs, Xos^Efs, Xos^Efs, Xos^Efs, Xos^Efs, Xos^Efs, Xos^Efs
Xos^Efs, Xos^Efs, Urb, Xos^Efs, Qxdp, Xos^Efs, Ql^Ii, Xos^Efs, Qxdp, Xos^Efs, Urb, Xos^Efs, Xos^Efs
Xos^Efs, Urb, Urb, Qxdp, Ql^Ii, Ql^Ii, Wot, Ql^Ii, Ql^Ii, Qxdp, Urb, Urb, Xos^Efs
Xos^Efs, Urb, Urb, Qxdp, Ql^Ii, Wot, Gg^Ii, Wot, Ql^Ii, Qxdp, Urb, Urb, Xos^Efs
Xos^Efs, Urb, Urb, Qxdp, Ql^Ii, Wot, Wot, Wot, Ql^Ii, Qxdp, Urb, Urb, Xos^Efs
Xos^Efs, Urb, Urb, Qxdp, Qxdp, Ql^Ii, Ql^Ii, Ql^Ii, Qxdp, Qxdp, Urb, Urb, Xos^Efs
Xos^Efs, Urb, Urb, Urb, Urb, Qxdp, Qxdp, Qxdp, Urb, Urb, Urb, Urb, Xos^Efs
Xos^Efs, Urb, Urb, Urb, Urb, Urb, Urb, Urb, Urb, Urb, Urb, Urb, Xos^Efs
Xos^Efs, Urb, Urb, Urb, Urb, Urb, Urb, Urb, Urb, Urb, Urb, Urb, Xos^Efs
Xos^Efs, Urb, Urb, Urb, Urb, Urb, Urb, Urb, Urb, Urb, Urb, Urb, Xos^Efs
Xos^Efs, Urb, Xos^Efs, Urb, Xos^Efs, Urb, Urb, Urb, Xos^Efs, Urb, Xos^Efs, Urb, Xos^Efs
Xos^Efs, Xos^Efs, Xos^Efs, Xos^Efs, Xos^Efs, Xos^Efs, Urb, Xos^Efs, Xos^Efs, Xos^Efs, Xos^Efs, Xos^Efs, Xos^Efs
