border_size=1
usage=map

Md, Md, Md, Md, Md, Md, Md, Md, Md, Md, Dd, Dd, Dd, Dd, Dd, Dd, Dd, Dd, Dd, Dd, Dd, Dd, Dd, Dd, Dd, Dd, Cd, Dd, Dd, Rmo, Dd, Dd, Cd, Dd, Dd, Dd, Dd, Dd, Dd, Dd, Dd, Dd, Dd, Dd, Dd, Dd, Dd, Dd, Dd, Dd, Dd, Dd, Dd
Md, Md, Md, Md, Md, Md, Md, Md, Md, Md, Dd, Dd, Dd, Dd, Dd, Dd, Dd, Dd, Dd, Dd, Dd, Dd, Cd, Cd, Cd, Cd, Gs, Kd, Rmo, Rmo, Rmo, Kd, Gs, Cd, Cd, Cd, Cd, Dd, Dd, Dd, Dd, Dd, Dd, Dd, Dd, Dd, Dd, Dd, Dd, Dd, Dd, Dd, Dd
Md, Md, Md, Md, Md, Md, Md, Md, Dd, Dd, Dd, Dd, Dd, Dd, Dd, Dd, Dd, Dd, Dd, Dd, Dd, Cd, Gs, Gs, Gs, Gs, Gs, Gs, Rmo, Gll^Ftr, Rmo, Gs, Gs, Gs, Gs, Gs, Gs, Cd, Dd, Dd, Dd, Dd, Dd, Dd, Dd, Dd, Dd, Dd, Dd, Dd, Dd, Dd, Dd
Md, Md, Dd, Dd, Dd, Dd, Dd, Dd, Dd, Dd, Dd, Dd, Kd, Dd, Dd, Dd, Dd, Dd, Dd, Dd, Cd, Cd, Gs, Gs, Gs, Gs, Rmo, Rmo, Rmo, Gll^Ftr, Rmo, Rmo, Rmo, Gs, Gs, Gs, Gs, Cd, Cd, Dd, Cd, Dd, Cd, Dd, Cd, Cd, Rmo, Dd, Dd, Dd, Dd, Dd, Dd
Dd, Dd, Dd, Dd, Dd, Dd, Dd, Dd, Dd, Dd, Rmo, Rmo, Rmo, Cd, Cd, Cd, Cd, Cd, Cd, Cd, Gs, Gs, Cd, Cd, Cd, Rmo, Rmo, Rmo, Rmo, Gll^Ftr, Rmo, Rmo, Rmo, Rmo, Cd, Cd, Cd, Gs, Gs, Cd, Gs, Cd, Gs, Cd, Rmo, Rmo, Rmo, Rmo, Cd, Dd, Dd, Dd, Dd
Dd, Dd, Dd, Dd, Dd, Dd, Dd, Dd, Dd, Kd, Cd, Rmo, Rmo, Rmo, Rmo, Gs, Gs, Gs, Gs, Gs, Rmo, Rmo, Cd, Kd, Cd, Rmo, Gs, Gs, Rmo, Gll^Ftr, Rmo, Gs, Gs, Rmo, Cd, Kd, Cd, Rmo, Rmo, Gs, Gs, Gs, Rmo, Rmo, Rmo, Rmo, Cd, Cd, Dd, Dd, Dd, Dd, Dd
Dd, Dd, Dd, Dd, Dd, Dd, Dd, Dd, Dd, Dd, Dd, Cd, Gs, Rmo, Rmo, Rmo, Rmo, Gs, Cd, Rmo, Gll^Ftr, Gll^Ftr, Rmo, Cd, Gs, Gs, Gs, Gs, Cd, Rmo, Cd, Gs, Gs, Gs, Gs, Cd, Rmo, Gll^Ftr, Gll^Ftr, Rmo, Cd, Rmo, Rmo, Rmo, Gs, Gs, Cd, Dd, Dd, Dd, Dd, Dd, Dd
Dd, Dd, Dd, Dd, Dd, Dd, Dd, Dd, Dd, Dd, Cd, Cd, Gs, Gs, Gs, Rmo, Rmo, Cd, Kd, Cd, Rmo, Rmo, Gs, Gs, Gs, Gs, Gll^Ftr, Cd, Qxe, Rmo, Qxe, Cd, Gll^Ftr, Gll^Ftr, Gs, Gs, Gs, Rmo, Rmo, Cd, Kd, Cd, Rmo, Gs, Gs, Gs, Gs, Cd, Dd, Dd, Dd, Dd, Dd
Dd, Dd, Dd, Dd, Dd, Dd, Dd, Dd, Dd, Dd, Cd, Gs, Gs, Gs, Rmo, Rmo, Gll^Ftr, Cd, Cd, Cd, Gs, Gs, Gll^Ftr, Gll^Ftr, Gll^Ftr, Gll^Ftr, Qxe, Qxe, Qxe, Qxu^Bs|, Qxe, Qxe, Qxe, Gll^Ftr, Gll^Ftr, Gs, Gs, Gs, Gs, Cd, Cd, Cd, Gll^Ftr, Rmo, Gs, Gs, Gs, Cd, Dd, Dd, Dd, Dd, Dd
Hd, Dd, Dd, Dd, Dd, Dd, Dd, Dd, Dd, Dd, Cd, Gs, Cd, Cd, Cd, Gll^Ftr, Rmo, Rmo, Gs, Gs, Gs, Gs, Gll^Ftr, Gll^Ftr, Qxe, Qxe, Qxe, Qxe, Qxe, Qxu^Bs|, Qxe, Qxe, Qxe, Qxe, Qxe, Gll^Ftr, Gll^Ftr, Gs, Gs, Gs, Gs, Rmo, Gll^Ftr, Rmo, Cd, Gs, Gs, Cd, Cd, Dd, Dd, Dd, Dd
Dd, Dd, Dd, Dd, Dd, Dd, Dd, Dd, Dd, Cd, Gs, Gs, Cd, Kd, Cd, Rmo, Gs, Gs, Gs, Gs, Gs, Gs, Qxe, Qxe, Qxe, Qxe, Qxe, Qxe, Cd, Cd, Cd, Qxe, Qxe, Qxe, Qxe, Qxe, Gll^Ftr, Gs, Gs, Gs, Gs, Rmo, Rmo, Cd, Kd, Cd, Gs, Gs, Cd, Dd, Dd, Dd, Dd
Dd, Dd, Dd, Dd, Dd, Dd, Dd, Dd, Dd, Cd, Gs, Gs, Rmo, Cd, Rmo, Gs, Gs, Gs, Gs, Gs, Cd, Cd, Qxe, Qxe, Qxe, Qxe, Qxe, Qxe, Cd, Kd, Cd, Qxe, Qxe, Qxe, Qxe, Qxe, Qxe, Cd, Cd, Gs, Gs, Gs, Gs, Cd, Cd, Cd, Gs, Gs, Cd, Dd, Dd, Dd, Dd
Dd, Dd, Dd^Esd, Dd, Dd, Dd, Dd, Dd, Dd, Cd, Gs, Gs, Rmo, Gll^Ftr, Rmo, Gs, Gs, Gs, Cd, Gs, Qxu^Bs\, Qxe, Qxe, Qxe, Qxe, Qxe, Qxu^Bs/, Qxu^Bs/, Qxe, Cd, Qxe, Qxu^Bs\, Qxu^Bs\, Qxe, Qxe, Qxe, Qxe, Qxe, Gs, Gs, Cd, Gs, Gs, Rmo, Gll^Ftr, Rmo, Gs, Gs, Cd, Dd, Dd, Dd, Dd
Dd, Dd, Dd^Esd, Dd, Dd, Dd, Dd, Dd, Cd, Cd, Gs, Gs, Rmo, Gll^Ftr, Rmo, Gs, Gs, Gs, Cd, Qxe, Qxe, Qxu^Bs\, Cd, Cd, Cd, Qxu^Bs/, Qxe, Qxe, Qxe, Qxu^Bs|, Qxe, Qxe, Qxe, Qxu^Bs\, Cd, Cd, Cd, Qxu^Bs/, Qxe, Qxe, Cd, Gs, Gs, Rmo, Gll^Ftr, Rmo, Gs, Gs, Gs, Cd, Dd, Dd, Dd
Dd, Dd, Dd, Dd^Esd, Dd, Dd^Esd, Dd, Dd, Cd, Gs, Gs, Gs, Cd, Cd, Cd, Gs, Gll^Ftr, Gll^Ftr, Gll^Ftr, Qxe, Qxe, Qxe, Cd, Kd, Cd, Qxe, Qxe, Qxe, Kd, Rmp, Kd, Qxe, Qxe, Qxe, Cd, Kd, Cd, Qxe, Qxe, Qxe, Gll^Ftr, Gs, Gs, Rmo, Cd, Rmo, Gs, Gs, Gs, Cd, Dd, Dd, Dd
Dd, Dd, Dd, Dd, Dd, Dd, Dd, Dd, Cd, Gll^Ftr, Gll^Ftr, Gs, Cd, Kd, Cd, Gs, Gs, Gll^Ftr, Qxe, Qxe, Qxe, Qxe, Qxe, Cd, Qxe, Qxu^Bs\, Rmp, Kd, Cd, Rmp, Cd, Kd, Rmp, Qxu^Bs/, Qxe, Cd, Qxe, Qxe, Qxe, Qxe, Gll^Ftr, Gs, Gs, Cd, Kd, Cd, Gs, Gs, Gs, Cd, Dd, Dd, Dd
Dd, Dd, Dd, Dd, Dd, Dd, Dd, Dd, Cd, Gll^Ftr, Gs, Gs, Rmo, Cd, Rmo, Gs, Gs, Gll^Ftr, Qxe, Qxe, Qxe, Qxe, Qxe, Qxu^Bs|, Qxe, Qxe, Kd, Rmp, Cd, Cd, Cd, Rmp, Kd, Qxe, Qxe, Qxu^Bs|, Qxe, Qxe, Qxe, Qxe, Gll^Ftr, Gll^Ftr, Gs, Cd, Cd, Cd, Gs, Gs, Gs, Cd, Dd, Dd, Dd
Dd, Dd, Dd, Dd, Dd, Dd, Dd, Dd, Cd, Gs, Gs, Gs, Rmo, Gll^Ftr, Rmo, Gs, Gll^Ftr, Gll^Ftr, Qxe, Qxe, Qxe, Qxe, Qxe, Qxu^Bs|, Qxe, Qxe, Kd, Cd, Cd, Kd, Cd, Cd, Kd, Qxe, Qxe, Qxu^Bs|, Qxe, Qxe, Qxe, Qxe, Gll^Ftr, Gll^Ftr, Gs, Rmo, Gll^Ftr, Rmo, Gs, Gs, Gs, Cd, Dd, Dd, Dd
Dd, Dd, Dd, Dd, Dd, Dd, Dd, Dd, Cd, Gs, Gs, Gs, Rmo, Gll^Ftr, Rmo, Gs, Gs, Gll^Ftr, Gll^Ftr, Qxe, Qxe, Qxe, Qxe, Qxu^Bs|, Qxe, Qxe, Rmp, Rmp, Cd, Cd, Cd, Rmp, Rmp, Qxe, Qxe, Qxu^Bs|, Qxe, Qxe, Qxe, Qxe, Gll^Ftr, Gll^Ftr, Gs, Rmo, Gll^Ftr, Rmo, Gs, Gs, Gs, Cd, Dd, Dd, Dd
Dd, Dd, Dd, Dd, Dd, Dd, Dd, Dd, Cd, Gll^Ftr, Gll^Ftr, Gs, Cd, Cd, Cd, Gs, Gs, Gll^Ftr, Gll^Ftr, Gll^Ftr, Qxe, Qxe, Cd, Cd, Cd, Qxu^Bs/, Qxe, Kd, Kd, Rmp, Kd, Kd, Qxe, Qxu^Bs\, Cd, Cd, Cd, Qxe, Qxe, Qxe, Gll^Ftr, Gll^Ftr, Gs, Rmo, Cd, Rmo, Gs, Gs, Gs, Cd, Dd, Dd, Dd
Dd, Dd, Dd, Dd, Dd, Dd, Dd, Dd, Cd, Gll^Ftr, Gll^Ftr, Gs, Cd, Kd, Cd, Rmo, Rmo, Gs, Cd, Qxe, Qxe, Qxe, Cd, Kd, Cd, Qxe, Qxe, Qxe, Qxe, Rmp, Qxe, Qxe, Qxe, Qxe, Cd, Kd, Cd, Qxe, Qxe, Qxe, Cd, Gs, Gs, Cd, Kd, Cd, Gs, Gs, Cd, Cd, Dd, Dd, Dd
Dd, Dd, Dd, Dd, Dd, Dd, Dd, Dd, Dd, Cd, Gs, Gs, Gs, Cd, Rmo, Gs, Rmo, Gs, Cd, Qxe, Qxu^Bs/, Qxu^Bs/, Qxe, Cd, Qxe, Qxu^Bs\, Qxu^Bs\, Qxe, Qxe, Qxu^Bs|, Qxe, Qxe, Qxu^Bs/, Qxu^Bs/, Qxe, Cd, Qxe, Qxu^Bs\, Qxu^Bs\, Cd, 2 Gs, Gs, Rmo, Cd, Cd, Cd, Gs, Gs, Cd, Dd, Dd, Dd, Dd
Dd, Dd, Dd, Dd, Dd, Dd, Dd, Dd, Dd, Cd, Cd, Gs, Gs, Gs, Gs, Rmo, Gll^Ftr, Rmo, Gs, Gs, Qxe, Qxe, Qxe, Qxe, Qxe, Qxe, Qxe, Qxu^Bs\, Cd, Cd, Cd, Qxu^Bs/, Qxe, Qxe, Qxe, Qxe, Qxe, Qxe, Cd, Rmo, Rmo, Gs, Rmo, Gs, Rmo, Gs, Cd, Cd, Dd, Dd, Dd, Dd, Dd
Dd, Dd, Dd, Dd, Dd, Dd, Dd, Dd, Dd, Dd, Dd, Cd, Gs, Gs, Rmo, Rmo, Rmo, Rmo, Rmo, Cd, Cd, Qxe, Qxe, Qxe, Qxe, Qxe, Qxe, Qxe, Cd, Kd, Cd, Qxe, Qxe, Qxe, Qxe, Qxe, Qxe, Qxe, Cd, Gs, Gs, Rmo, Gll^Ftr, Rmo, Rmo, Gs, Cd, Dd, Dd, Dd, Dd, Dd, Dd
Dd, Dd, Dd, Dd, Dd, Dd, Dd, Dd, Dd, Dd^Esd, Kd, Cd, Rmo, Rmo, Rmo, Rmo, Rmo, Gll^Ftr, Rmo, Gs, Gs, Qxe, Gll^Ftr, Qxe, Qxe, Qxe, Qxe, Qxe, Qxe, Cd, Qxe, Qxe, Qxe, Qxe, Qxe, Qxe, Gll^Ftr, Gll^Ftr, Gs, Gs, Rmo, Rmo, Rmo, Rmo, Rmo, Rmo, Rmo, Kd, Dd, Dd, Dd, Dd, Dd
Dd, Dd, Dd, Dd, Dd, Dd, Dd, Dd, Dd, Dd, Dd, Rmo, Rmo, Rmo, Cd, Gs, Gs, Rmo, Cd, Cd, Cd, Gs, Gll^Ftr, Gll^Ftr, Gll^Ftr, Qxe, Qxe, Qxe, Qxe, Qxu^Bs|, Qxe, Qxe, Qxe, Qxe, Qxe, Gll^Ftr, Gll^Ftr, Gs, Cd, Cd, Cd, Rmo, Gs, Gs, Cd, Rmo, Dd, Dd, Dd, Dd, Dd, Dd, Dd
Dd, Dd, Dd, Dd, Dd, Dd, Dd, Dd, Dd, Dd, Dd, Dd, Dd, Kd, Dd, Cd, Cd, Gs, Cd, Kd, Cd, Gs, Gs, Gll^Ftr, Gll^Ftr, Qxe, Qxe, Qxe, Qxe, Qxu^Bs|, Qxe, Qxe, Qxe, Qxe, Qxe, Qxe, Rmo, Rmo, Cd, Kd, Cd, Gs, Cd, Cd, Dd, Kd, Dd, Dd, Dd, Dd, Dd, Dd, Dd
Dd, Dd, Dd, Dd, Dd, Dd, Dd, Dd, Dd, Dd, Dd, Dd, Dd, Dd, Dd, Dd, Cd, Gs, Gs, Cd, Gll^Ftr, Rmo, Rmo, Gs, Gs, Qxe, Qxe, Qxe, Cd, Qxu^Bs|, Cd, Gs^Ftp, Qxe, Qxe, Qxe, Gll^Ftr, Rmo, Gll^Ftr, Rmo, Cd, Gs, Gs, Cd, Dd, Dd, Dd, Dd, Dd, Dd, Dd, Dd, Dd, Md
Dd, Dd, Dd, Dd, Dd, Dd, Dd, Dd, Dd, Dd, Dd, Dd, Dd, Dd, Dd, Dd, Dd, Cd, Gs, Rmo, Rmo, Gll^Ftr, Gll^Ftr, Rmo, Rmo, Qxe, Qxe, Cd, Rmo, Rmo, Rmo, Cd, Gs, Qxe, Gs, Rmo, Gll^Ftr, Gll^Ftr, Rmo, Gs, Gs, Cd, Dd, Dd, Dd, Dd, Dd, Dd, Md, Md, Md, Md, Md
Dd, Dd, Dd, Dd, Dd, Dd, Dd, Dd, Dd, Dd, Dd, Dd, Dd, Dd, Dd, Dd, Dd, Cd, Cd, Gs, Gs, Rmo, Rmo, Gll^Ftr, Cd, Gs, Gs, Gs, Rmo, Gll^Ftr, Rmo, Gs, Gs, Gs, Cd, Rmo, Gll^Ftr, Rmo, Gs, Gs, Cd, Cd, Dd, Dd, Dd, Dd, Dd, Dd, Md, Md, Md, Md, Md^Xm
Dd, Hd, Hd, Dd, Dd, Dd, Dd, Dd, Dd, Dd, Dd, Dd, Dd, Dd, Dd, Dd, Dd, Dd, Dd, Cd, Cd, Gs, Gs, Cd, Kd, Cd, Rmo, Gs, Rmo, Gll^Ftr, Rmo, Gs, Rmo, Cd, Kd, Cd, Rmo, Rmo, Cd, Cd, Dd, Dd, Dd, Dd, Dd, Dd, Md, Md, Md^Xm, Md, Md^Xm, Md^Xm, Md
Hd, Hd, Hd, Hd, Hd, Dd, Dd, Dd, Dd, Dd, Dd, Dd, Dd, Dd, Dd, Dd, Dd, Dd, Dd, Dd, Cd, Gs, Gs, Cd, Cd, Cd, Gll^Ftr, Rmo, Rmo, Gll^Ftr, Rmo, Rmo, Gll^Ftr, Cd, Cd, Cd, Gs, Gs, Cd, Dd, Dd, Dd, Dd, Dd, Dd, Dd, Md, Md, Md^Xm, Md^Xm, Md, Md, Md
Hd, Hd, Hd, Hd, Hd, Dd, Hd, Dd, Dd, Dd, Dd, Dd, Dd, Dd, Dd, Dd, Dd, Dd, Dd, Dd, Dd, Cd, Cd, Gs, Gs, Rmo, Rmo, Gll^Ftr, Rmo, Gll^Ftr, Rmo, Gll^Ftr, Rmo, Rmo, Gs, Gs, Cd, Cd, Dd, Dd, Dd, Dd, Dd, Dd, Dd, Dd, Md, Md^Xm, Md^Xm, Md, Md, Md, Md
Hd, Hd, Hd, Hd, Hd, Dd, Hd, Hd, Dd, Dd, Dd, Dd, Dd, Dd, Dd, Dd, Dd, Dd, Dd, Dd, Dd, Dd, Dd, Cd, Gs, Gs, Gs, Rmo, Rmo, Gll^Ftr, Rmo, Rmo, Gs, Gs, Gs, Cd, Dd, Dd, Dd, Dd, Dd, Dd, Dd, Dd, Md, Md, Md^Xm, Md^Xm, Md, Md, Md, Md, Hd
Hd, Hd, Hd, Hd, Hd, Hd, Hd, Hd, Hd, Dd, Dd, Dd, Dd, Dd, Dd, Dd, Dd, Dd, Dd, Dd, Dd, Dd, Dd, Cd, Cd, Cd, Cd, Gs, Rmo, Gll^Ftr, Rmo, Gs, Cd, Cd, Cd, Cd, Dd, Dd, Dd, Dd, Dd, Dd, Dd, Md, Md, Md, Md^Xm, Md^Xm, Md, Md, Md, Hd, Hd
Hd, Hd, Hd, Hd, Md, Hd, Hd, Hd, Hd, Dd, Dd, Dd, Dd, Dd, Dd, Dd, Dd, Dd, Dd, Dd, Dd, Dd, Dd, Dd, Dd, Dd, Dd, Cd, Rmo, Rmo, Rmo, Cd, Dd, Dd, Dd, Dd, Dd, Dd, Dd, Dd, Dd, Dd, Dd, Md, Md, Md^Xm, Md^Xm, Md, Md, Md, Md, Hd, Hd
Md, Md, Md, Md, Md, Md, Md, Hd, Hd, Hd, Dd, Dd, Dd, Dd, Dd, Dd, Dd, Dd, Dd, Dd, Dd, Dd, Dd, Dd, Dd, Dd, Dd, Kd, Dd, Rmo, Dd, Kd, Dd, Dd, Dd, Dd, Dd, Dd, Dd, Dd, Dd, Dd, Dd, Md, Md, Md^Xm, Md, Md, Md, Md, Md, Hd, Hd
Md, Md, Md, Md, Md, Md, Md, Hd, Hd, Hd, Hd, Dd, Dd, Dd, Dd, Dd, Dd, Dd, Dd, Dd, Dd, Dd, Dd, Dd, Dd, Dd, Dd, Dd, Dd, Rmo, Dd, Dd, Dd, Dd, Dd, Dd, Dd, Dd, Dd, Dd, Dd, Dd, Dd, Md, Md, Md, Md, Md, Md, Md, Hd, Hd, Hd
Md, Md, Md, Md, Md, Md, Md, Hd, Hd, Hd, Hd, Dd, Dd, Dd, Dd, Dd, Dd, Dd, Dd, Dd, Dd, Dd, Dd, Dd, Dd, Dd, Dd, Dd, Dd, Rmo, Dd, Dd, Dd, Dd, Dd, Dd, Dd, Dd, Dd, Dd, Dd, Dd, Dd, Dd, Dd, Md, Md, Md, Md, Md, Md, Hd, Hd
Md, Md, Md, Md, Md, Md, Md, Hd, Hd, Hd, Hd, Hd, Hd, Dd, Dd, Dd, Dd, Dd, Dd, Dd, Dd, Dd, Dd, Dd, Dd, Dd, Dd, Dd, Dd, Rmo, Dd, Dd, Dd, Dd, Dd, Dd, Dd, Dd, Dd, Dd, Dd, Dd, Dd, Dd, Dd, Md, Md, Md, Md, Md, Hd, Hd, Hd
