border_size=1
usage=map

Gs^Ftp, Gg, Gs^Ftp, Gg, Gs^Ftp, Gg, Gs^Ftp, Gs^Ftp, Gll, Gs^Ftp, Gs^Ftp, Gs^Ftp, Gs^Ftp, Gg, Dd^Ftd, Ds, Ds, Wwt, Wwt, Wwt, Wwt, Wot, Wwt, Wot, Wwt, Wot, Wot, Wwt, Wot, Wot, Wwt, Wot, Wot, Wot, Wot, Wot, Wot, Wot, Wot, Wwrt, Wot, Wot, Wot, Wot, Wot, Wot, Wot, Wot, Wot, Wot, Wot, Wot, Wwrt, Wot, Wot, Wot, Wot, Wot, Wot, Wwrt, Wot, Wot, Wot, Wot, Wot, Wot
Gs^Ftp, Gs^Ftp, Gs^Ftp, Gs^Ftp, Gs^Ftp, Gs^Ftp, Gs^Ftp, Gs^Ftp, Gll, Gs^Ftp, Gs^Ftp, Gll, Gs^Ftp, Gs, Dd^Ftd, Ds, Ds, Wwt, Wwt, Wwt, Wwt, Wwt, Wwt, Wwt, Wwt, Wwt, Wwt, Wot, Wot, Wwt, Wot, Wwt, Wot, Wot, Wot, Wot, Wot, Wot, Wot, Wot, Wot, Wot, Wot, Wwrt, Wot, Wwrt, Wwrt, Wot, Wot, Wwrt, Wot, Wot, Wot, Wwrt, Wot, Wot, Wwrt, Wot, Wot, Wot, Wot, Wot, Wot, Wot, Wot, Wot
Gs^Ftp, Gs^Ftp, Gs^Ftp, Gs^Ftp, Gs^Ftp, Gll, Gll, Gll, Gs^Ftp, Gs^Ftp, Gs^Ftp, Gll, Gll, Gs^Ftp, Gs^Ftp, Dd^Ftd, Ds, Wwt, Wwt, Wwt, Wwt, Wwt, Wwt, Wwt, Wwt, Wwt, Wwt, Wwt, Wwt, Wwt, Wot, Wwt, Wot, Wwt, Wwt, Wot, Wot, Wot, Wot, Wot, Wot, Wot, Wwrt, Wot, Wot, Wwrt, Wot, Wot, Wot, Wot, Wot, Wwrt, Wot, Wot, Wwrt, Wot, Wot, Wwrt, Wot, Wot, Wot, Wwrt, Wwrt, Wot, Wot, Wot
Gs^Ftp, Gs^Ftp, Gll, Gs^Ftp, Gll, Gll, Gs^Ftp, Gs^Ftp, Gs^Ftp, Gs^Ftp, Gs^Ftp, Gs^Ftp, Gs^Ftp, Gll, Gs^Ftp, Dd^Ftd, Ds, Wwt, Wwt, Wwt, Wwt, Wwt, Wwt, Wwt, Wwt, Wwt, Wwt, Wwt, Wwt, Wwt, Wwt, Wot, Wwt, Wot, Wwt, Wot, Wot, Wot, Wot, Wot, Wot, Wot, Wot, Wwrt, Wwrt, Wot, Wot, Wwrt, Wwrt, Wot, Wot, Wot, Wwrt, Wot, Wot, Wot, Wot, Wot, Wwrt, Wot, Wot, Wwrt, Wot, Wot, Wot, Wot
Gll, Gll, Gs^Ftp, Gll, Gs^Ftp, Gs^Ftp, Gs^Ftp, Gs^Ftp, Gs^Ftp, Gs^Ftp, Gs^Ftp, Gs^Ftp, Gll, Gs^Ftp, Gll, Dd^Ftd, Dd^Ftd, Ds, Ds, Ds, Ds, Wwt, Wwt, Wwt, Wwt, Wwt, Wwt, Wwt, Wwt, Wwt, Wwt, Wwt, Wwt, Wwt, Wwt, Wot, Wot, Wot, Wot, Wot, Wot, Wot, Wot, Wot, Wot, Wot, Wwrt, Wot, Wot, Wot, Wot, Wot, Wot, Wot, Wot, Wwrt, Wot, Wot, Wot, Wwrt, Wot, Wwrt, Wot, Wot, Wot, Wot
Gs^Ftp, Gs^Ftp, Gs^Ftp, Gs^Ftp, Gs^Ftp, Gs^Ftp, Gs^Ftp, Gs^Ftp, Gs^Ftp, Gs^Ftp, Gs^Ftp, Gs^Ftp, Gs^Ftp, Gs^Ftp, Gs^Ftp, Gs^Ftp, Dd^Ftd, Dd^Ftd, Dd^Ftd, Ds, Ds, Ds, Ds, Ds, Ds, Wwt, Wwt, Wwt, Wwt, Wwt, Wwt, Wwt, Wwt, Wwt, Wwt, Wwt, Wwt, Wot, Wot, Wot, Wot, Wot, Wot, Wot, Wot, Wot, Wot, Wot, Wot, Wot, Wot, Wwrt, Wot, Wot, Wot, Wot, Wwrt, Wot, Wot, Wwrt, Wot, Wot, Wot, Wot, Wot, Wot
Gs^Ftp, Gs^Ftp, Gs^Ftp, Gs, Gs^Ftp, Gll, Gs^Ftp, Gs^Ftp, Gs^Ftp, Gs^Ftp, Gs^Ftp, Gll, Gs^Ftp, Gs^Ftp, Gs^Ftp, Gs^Ftp, Gs^Ftp, Dd^Ftd, Dd^Ftd, Dd^Ftd, Dd^Ftd, Dd^Ftd, Dd^Ftd, Dd^Ftd, Dd^Ftd, Ds, Ds, Ds, Ds, Wwt, Wwt, Wwt, Wwt, Wwt, Wwt, Wwt, Wwt, Wot, Wot, Wot, Wot, Wot, Wot, Wot, Wot, Wot, Wot, Wwrt, Wot, Wot, Wot, Wot, Wot, Wot, Wot, Wot, Wot, Wwrt, Wot, Wot, Wwrt, Wot, Wot, Wwrt, Wot, Wot
Gs^Ftp, Gs, Gs^Ftp, Gs^Ftp, Gs^Ftp, Gll, Gs^Ftp, Gs^Ftp, Gs^Ftp, Gs^Ftp, Gs^Ftp, Gs^Ftp, Gs^Ftp, Gll, Gs^Ftp, Gs^Ftp, Gs^Ftp, Gs^Ftp, Gs^Ftp, Dd^Ftd, Dd^Ftd, Dd^Ftd, Gs^Ftp, Dd^Ftd, Dd^Ftd, Dd^Ftd, Dd^Ftd, Ds, Dd^Ftd, Ds, Ds, Ds, Ds, Wwt, Wwt, Wwt, Wwt, Wwt, Wot, Wot, Wot, Wot, Wot, Wot, Wot, Wot, Wot, Wot, Wwrt, Wot, Wot, Wot, Wwrt, Wwrt, Wot, Wot, Wot, Wot, Wwrt, Wot, Wot, Wwrt, Wot, Wot, Wwrt, Wot
Gs^Ftp, Gs^Ftp, Gs^Ftp, Gs^Ftp, Gs^Ftp, Gs^Ftp, Gs^Ftp, Gs^Ftp, Gs^Ftp, Gs^Ftp, Gs^Ftp, Gs^Ftp, Gll, Gll, Gs^Ftp, Gll, Gs^Ftp, Gll, Gs^Ftp, Gs^Ftp, Gs^Ftp, Gs^Ftp, Gs^Ftp, Gs^Ftp, Gs^Ftp, Gs^Ftp, Dd^Ftd, Dd^Ftd, Dd^Ftd, Dd^Ftd, Dd^Ftd, Ds, Dd^Ftd, Ds, Wwt, Wwt, Wwt, Wot, Wot, Wot, Wot, Wot, Wot, Wot, Wot, Wot, Wot, Wot, Wot, Wot, Wot, Wot, Wot, Wot, Wot, Wot, Wot, Wot, Wot, Wot, Wot, Wot, Wwrt, Wot, Wot, Wot
Gs^Ftp, Gs^Ftp, Gs^Ftp, Gs^Ftp, Gs^Ftp, Gs^Ftp, Gs^Ftp, Gs^Ftp, Gs^Ftp, Gs^Ftp, Gs^Ftp, Gs^Ftp, Gs^Ftp, Gs^Ftp, Gll, Gll, Gll, Gs^Ftp, Gs^Ftp, Gll, Gll, Gs^Ftp, Gs^Ftp, Gs^Ftp, Gs^Ftp, Gs^Ftp, Gs^Ftp, Gs^Ftp, Gs^Ftp, Dd^Ftd, Dd^Ftd, Dd^Ftd, Dd^Ftd, Ds, Ds, Wwt, Wwt, Wwt, Wot, Wot, Wot, Wot, Wot, Wot, Wot, Wot, Wot, Wot, Wot, Wot, Wwrt, Wot, Wot, Wwrt, Wwrt, Wot, Wot, Wot, Wot, Wwrt, Wwrt, Wot, Wot, Wot, Wot, Wot
Gs^Ftp, Gs^Ftp, Gs^Ftp, Gs^Ftp, Gs^Ftp, Gs^Ftp, Gs^Ftp, Gs^Ftp, Gs^Ftp, Gs^Ftp, Gs, Gs^Ftp, Gs^Ftp, Gs^Ftp, Gs^Ftp, Gs^Ftp, Gll, Gs^Ftp, Gs^Ftp, Gs^Ftp, Gll, Gll, Gs^Ftp, Gs^Ftp, Gs^Ftp, Gs^Ftp, Gs^Ftp, Gs^Ftp, Gs^Ftp, Gs^Ftp, Gs^Ftp, Dd^Ftd, Dd^Ftd, Ds, Ds, Wwt, Wwt, Wwt, Wot, Wwt, Wwt, Wot, Wot, Wot, Wot, Wot, Wot, Wot, Wot, Wot, Wwrt, Wot, Wot, Wot, Wwrt, Wot, Wot, Wot, Wot, Wot, Wot, Wot, Wot, Wot, Wot, Wot
Gs^Ftp, Gs^Ftp, Gs^Ftp, Gs^Ftp, Gs^Ftp, Gs^Ftp, Gs^Ftp, Gs, Gs, Gs, Gs^Ftp, Gs, Gs^Ftp, Gs^Ftp, Gs^Ftp, Gs^Ftp, Gs^Ftp, Gs^Ftp, Gs^Ftp, Gll, Gll, Gll, Gs^Ftp, Gs^Ftp, Gs^Ftp, Gs^Ftp, Gs^Ftp, Gs^Ftp, Gs^Ftp, Gs^Ftp, Gs^Ftp, Dd^Ftd, Dd^Ftd, Ds, Ds, Wwt, Wwt, Wwt, Wwt, Wwt, Wot, Wwt, Wwt, Wot, Wot, Wot, Wot, Wot, Wot, Wot, Wot, Wot, Wwrt, Wot, Wot, Wot, Wot, Wwrt, Wot, Wot, Wot, Wot, Wwrt, Wot, Wot, Wot
Gs^Ftp, Gs^Ftp, Gs^Ftp, Gs^Ftp, Gs^Ftp, Gs^Ftp, Gs^Ftp, Gs^Ftp, Gs^Ftp, Gs^Ftp, Gs^Ftp, Gs^Ftp, Gs^Ftp, Gs^Ftp, Gs^Ftp, Gs^Ftp, Gs^Ftp, Gs^Ftp, Gll, Gll, Gs^Ftp, Gll, Gs^Ftp, Gll, Gs^Ftp, Gs^Ftp, Gs^Ftp, Gs^Ftp, Gs^Ftp, Gs^Ftp, Gs^Ftp, Gs^Ftp, Gs^Ftp, Dd^Ftd, Dd^Ftd, Ds, Ds, Wwt, Wwt, Wwt, Wwt, Wot, Wwt, Wwt, Wot, Wot, Wot, Wot, Wot, Wot, Wot, Wot, Wot, Wot, Wot, Wot, Wot, Wot, Wot, Wwrt, Wot, Wwrt, Wot, Wwrt, Wot, Wot
Gs^Ftp, Gs^Ftp, Gs^Ftp, Gs^Ftp, Gs^Ftp, Gs^Ftp, Gs, Gs^Ftp, Gs^Ftp, Gs^Ftp, Gs^Ftp, Gs^Ftp, Gs^Ftp, Gs, Gs, Gs^Ftp, Gs, Gs^Ftp, Gll, Gll, Gs^Ftp, Gll, Gs^Ftp, Gll, Gs^Ftp, Gs^Ftp, Gs^Ftp, Gs^Ftp, Gs^Ftp, Gs^Ftp, Gs^Ftp, Gs^Ftp, Gs^Ftp, Gs^Ftp, Dd^Ftd, Dd^Ftd, Dd^Ftd, Ds, Ds, Wwt, Wwt, Wwt, Wwt, Wot, Wwt, Wot, Wot, Wot, Wot, Wot, Wot, Wot, Wot, Wwrt, Wwrt, Wot, Wot, Wwrt, Wwrt, Wot, Wot, Wwrt, Wot, Wwrt, Wwrt, Wot
Gs^Ftp, Gs^Ftp, Gs, Gs^Ftp, Gs^Ftp, Gs^Ftp, Gs^Ftp, Gs^Ftp, Gs^Ftp, Gs^Ftp, Gs^Ftp, Gs, Gs^Ftp, Gs^Ftp, Gs^Ftp, Gs^Ftp, Gs^Ftp, Gs^Ftp, Gs^Ftp, Gs^Ftp, Gs^Ftp, Gs^Ftp, Gs^Ftp, Gs^Ftp, Gs^Ftp, Gs^Ftp, Gs^Ftp, Gs^Ftp, Gs^Ftp, Gs^Ftp, Gs^Ftp, Gs^Ftp, Gs^Ftp, Gs^Ftp, Gs^Ftp, Dd^Ftd, Kdr, Dd^Ftd, Dd^Ftd, Ds, Ds, Wwt, Wwt, Wwt, Wwt, Wot, Wwt, Wwt, Wwt, Wot, Wot, Wot, Wot, Wot, Wwrt, Wot, Wot, Wot, Wwrt, Wot, Wot, Wot, Wot, Wot, Wwrt, Wot
Gs^Ftp, Gs, Gs^Ftp, Gs^Ftp, Gs^Ftp, Gs, Gs, Gs, Gs, Gs^Ftp, Gs^Ftp, Gs^Ftp, Gs^Ftp, Gs^Ftp, Gs^Ftp, Gs^Ftp, Gs^Ftp, Gs^Ftp, Gs^Ftp, Gs^Ftp, Gs^Ftp, Gs^Ftp, Gs^Ftp, Gs^Ftp, Gs^Ftp, Gs^Ftp, Gs^Ftp, Gs^Ftp, Gs^Ftp, Gs^Ftp, Gs^Ftp, Gs^Ftp, Gs^Ftp, Gs^Ftp, Kdr, Cdr, Cdr, Cdr, Kdr, Dd^Ftd, Ds, Wwt, Wwt, Wwt, Wwt, Wot, Wwt, Wot, Wwt, Wwt, Wwt, Wot, Wot, Wot, Wot, Wwrt, Wwrt, Wot, Wot, Wot, Wot, Wot, Wot, Wot, Wot, Wwrt
Gs, Gs^Ftp, Gs^Ftp, Gs^Ftp, Gs^Ftp, Gs, Gs^Ftp, Gs^Ftp, Gs^Ftp, Gs^Ftp, Gs^Ftp, Gs^Ftp, Gs^Ftp, Gs^Ftp, Gs^Ftp, Gs^Ftp, Gs^Ftp, Gs^Ftp, Gs^Ftp, Gs^Ftp, Gs^Ftp, Gs^Ftp, Gs^Ftp, Gs^Ftp, Gs, Gs, Gs^Ftp, Gs^Ftp, Gs^Ftp, Gs^Ftp, Gs^Ftp, Gs^Ftp, Gs^Ftp, Gs^Ftp, Cdr, Dd^Ftd, Kdr, Dd^Ftd, Cdr, Dd^Ftd, Ds, Wwt, Wwt, Wwt, Wwt, Wot, Wot, Wwt, Wot, Wot, Wot, Wot, Wot, Wot, Wot, Wot, Wot, Wot, Wot, Wwrt, Wot, Wot, Wot, Wot, Wot, Wwrt
Gs^Ftp, Gs, Gs, Gs^Ftp, Gs, Gs^Ftp, Gs^Ftp, Gs^Ftp, Gs^Ftp, Gs^Ftp, Gs^Ftp, Gs^Ftp, Cdr, Gs^Ftp, Gs^Ftp, Gs^Ftp, Gs^Ftp, Gs^Ftp, Gs^Ftp, Gs^Ftp, Gs^Ftp, Gs^Ftp, Gs^Ftp, Gs^Ftp, Gs, Gs^Ftp, Gs^Ftp, Gs^Ftp, Gs^Ftp, Gs^Ftp, Gs^Ftp, Gs^Ftp, Gs^Ftp, Gs^Ftp, Gg, Cdr, Rmo, Cd, Dd^Ftd, Dd^Ftd, Ds, Wwt, Wwt, Wwt, Wwt, Wwt, Wwt, Wwt, Wwt, Wot, Wot, Wot, Wwt, Wot, Wot, Wot, Wot, Wwrt, Wot, Wwrt, Wwrt, Wot, Wwrt, Wot, Wot, Wot
Gs^Ftp, Gs^Ftp, Gs^Ftp, Gs, Gs^Ftp, Gs^Ftp, Gs^Ftp, Gs^Ftp, Gs^Ftp, Gs^Ftp, Cdr, Cdr, Gs^Ftp, Cdr, Cdr, Gs^Ftp, Gs^Ftp, Gs^Ftp, Gs^Ftp, Gs^Ftp, Gs^Ftp, Gs^Ftp, Gs^Ftp, Gs^Ftp, Gs, Gs^Ftp, Gs^Ftp, Gs, Gs^Ftp, Gs^Ftp, Gs^Ftp, Gs^Ftp, Gs^Ftp, Gs^Ftp, Gs^Ftp, Gs^Ftp, Rmo, Gs^Ftp, Gs^Ftp, Dd^Ftd, Ds, Ds, Ds, Ds, Wwt, Wwt, Wwt, Wwt, Wwt, Wwt, Wwt, Wwt, Wot, Wwt, Wot, Wot, Wot, Wwrt, Wot, Wot, Wot, Wot, Wot, Wot, Wot, Wot
Rmo, Gs^Ftp, Rmo, Gs^Ftp, Gs^Ftp, Gs^Ftp, Rmo, Gs^Ftp, Gs^Ftp, Cdr, Gs^Ftp, Gs^Ftp, Cdr, Gs^Ftp, Gs^Ftp, Cdr, Gs^Ftp, Gs^Ftp, Gs^Ftp, Gs^Ftp, Gs^Ftp, Rmo, Gs^Ftp, Gs^Ftp, Gs^Ftp, Gs^Ftp, Gs, Gs, Gs^Ftp, Gs^Ftp, Gs^Ftp, Gs^Ftp, Gs^Ftp, Gs^Ftp, Gs^Ftp, Gs^Ftp, Rmo, Gs^Ftp, Gs^Ftp, Dd^Ftd, Dd^Ftd, Dd^Ftd, Ds, Ds, Kdr, Wwt, Wwt, Wwt, Kdr, Wwt, Wwt, Wwt, Wot, Wwt, Wot, Wot, Wot, Wwrt, Wwrt, Wot, Wot, Wot, Wwrt, Wot, Wot, Wot
Rmo, Rmo, Gs^Ftp, Gs^Ftp, Gs^Ftp, Rmo, Rmo, Rmo, Gs^Ftp, Cdr, Cdr, Cdr, 1 Kdr, Cdr, Cdr, Cdr, Rmo, Rmo, Rmo, Gs^Ftp, Gs^Ftp, Gs^Ftp, Gs^Ftp, Gs^Ftp, Rmo, Gs^Ftp, Gs^Ftp, Gs^Ftp, Rmo, Rmo, Gs^Ftp, Gs^Ftp, Rmo, Rmo, Rmo, Rmo, Gs^Ftp, Gs^Ftp, Kdr, Gs^Ftp, Cdr, Dd^Ftd, Cdr, Cdr, Dd^Ftd, Cdr, Cdr, Cdr, Ds, Cdr, Wwt, Wwt, Wwt, Wwt, Wwt, Wot, Wot, Wot, Wwrt, Wot, Wot, Wot, Wwrt, Wot, Wot, Wot
Gs^Ftp, Gs^Ftp, Gs^Ftp, Rmo, Rmo, Gs^Ftp, Gs^Ftp, Rmo, Gs^Ftp, Gs^Ftp, Gs^Ftp, Gs^Ftp, Cd, Gs^Ftp, Gs^Ftp, Rmo, Gs^Ftp, Gs^Ftp, Gs^Ftp, Gs^Ftp, Gs^Ftp, Gs, Gs, Gs^Ftp, Gs^Ftp, Rmo, Kdr, Rmo, Gs^Ftp, Gs^Ftp, Gs^Ftp, Gs^Ftp, Gs^Ftp, Gs^Ftp, Gs^Ftp, Gs, Gs^Ftp, Gs^Ftp, Gs^Ftp, Kdr, Rmo, Cdr, Gs^Ftp, Gs^Ftp, Dd^Ftd, Dd^Ftd, Dd^Ftd, Ds, Wwt, Wwt, Wwt, Wwt, Cdr, Wwt, Wwt, Wwt, Wwt, Wot, Wwrt, Wot, Wot, Wot, Wot, Wot, Wot, Wot
Gs^Ftp, Gs^Ftp, Gs^Ftp, Gs^Ftp, Gs^Ftp, Gs^Ftp, Gs^Ftp, Gs^Ftp, Gs^Ftp, Rmo, Gs^Ftp, Gs^Ftp, Gs^Ftp, Gs^Ftp, Gs^Ftp, Gs^Ftp, Gs, Gs, Gs, Gs^Ftp, Gs^Ftp, Gs^Ftp, Gs, Gs^Ftp, Cdr, Cdr, Cdr, Cdr, Cdr, Gs^Ftp, Gs^Ftp, Gs^Ftp, Gs^Ftp, Gs^Ftp, Gs^Ftp, Kdr, Rmo, Gs^Ftp, Gs^Ftp, Rmo, Gs^Ftp, Gs^Ftp, Gs^Ftp, Gs^Ftp, Ds, Dd^Ftd, Wwt, Wwt, Wwt, Wwt, Wwt, Wwt, Ds, Cdr, Kdr, Wwt, Wwt, Wot, Wwrt, Wot, Wot, Wot, Wot, Wwrt, Wot, Wot
Gs^Ftp, Gs^Ftp, Gs, Gs^Ftp, Gs^Ftp, Gs^Ftp, Gs^Ftp, Gs^Ftp, Gs^Ftp, Gs^Ftp, Gs^Ftp, Gs^Ftp, Gs^Ftp, Rmo, Gs^Ftp, Gs^Ftp, Gs^Ftp, Gs^Ftp, Gs, Gs, Gs^Ftp, Gs, Gs^Ftp, Gs^Ftp, Cdr, Rmp, Cdr, Rmp, Cdr, Gs^Ftp, Gs^Ftp, Gs^Ftp, Gs^Ftp, Gs^Ftp, Cdr, Kdr, Rmo, Gs^Ftp, Gs^Ftp, Gs^Ftp, Gs^Ftp, Gs^Ftp, Dd^Ftd, Dd^Ftd, Ds, Wwt, Ds, Ds, Ds, Wwt, Wwt, Wwt, Wwt, Ds, Cdr, Wwt, Wwt, Wot, Wot, Wwrt, Wwrt, Wot, Wot, Wwrt, Wot, Wot
Hh, Gs^Ftp, Gs^Ftp, Gs^Ftp, Gs, Gs^Ftp, Gs^Ftp, Gs^Ftp, Gs^Ftp, Gs^Ftp, Gs^Ftp, Gs^Ftp, Gs^Ftp, Gs^Ftp, Gs^Ftp, Gs^Ftp, Gs^Ftp, Gs^Ftp, Gs^Ftp, Gs^Ftp, Gs, Gs^Ftp, Gs, Gs, Gs^Ftp, Kdr, Rmo, Kdr, Gs^Ftp, Gs^Ftp, Gs^Ftp, Gs^Ftp, Gs^Ftp, Cdr, Gs^Ftp, Rmo, Gs^Ftp, Gs^Ftp, Gs^Ftp, Gs^Ftp, Gs^Ftp, Gs^Ftp, Kdr, Dd^Ftd, Dd^Ftd, Ds, Kdr, Rmo, Dd^Ftd, Ds, Ds, Wwt, Wwt, Ds, Cdr, Wwt, Wwt, Wot, Wot, Wot, Wot, Wot, Wot, Wot, Wot, Wot
Hh, Hh, Gs^Ftp, Gs^Ftp, Gs^Ftp, Gs^Ftp, Gs^Ftp, Gs^Ftp, Gs^Ftp, Gs^Ftp, Gs^Ftp, Gs^Ftp, Gs^Ftp, Gs^Ftp, Gs^Ftp, Rmo, Gs^Ftp, Rmo, Rmo, Gs^Ftp, Gs^Ftp, Gs, Gs, Gs^Ftp, Gs^Ftp, Gs^Ftp, Rmo, Gs^Ftp, Gs^Ftp, Gs^Ftp, Gs^Ftp, Gs^Ftp, Cdr, Cdr, Rmo, Gs^Ftp, Gs^Ftp, Rmo, Rmo, Rmo, Cdr, Cdr, Rmo, Rmo, Gs^Ftp, Rmo, Rmo, Cdr, Cdr, Rmo, Ds, Wwt, Wwt, Wwt, Cdr, Wwt, Wwt, Wot, Wot, Wot, Wot, Wwrt, Wot, Wwrt, Wot, Wot
Hh, Hh, Hh, Gs^Ftp, Gs^Ftp, Gs^Ftp, Gs^Ftp, Gs^Ftp, Gs^Ftp, Gs^Ftp, Gs^Ftp, Gs, Gs^Ftp, Gs^Ftp, Gs^Ftp, Gs^Ftp, Gs^Ftp, Gs^Ftp, Gs^Ftp, Rmo, Gs^Ftp, Gs^Ftp, Rmo, Gs^Ftp, Kdr, Rmo, Gs^Ftp, Gs^Ftp, Gs^Ftp, Gs^Ftp, Gs^Ftp, Gs^Ftp, Cdr, Rmo, Gs^Ftp, Gs^Ftp, Gs^Ftp, Gs^Ftp, Cdr, Cdr, Gs^Ftp, Gs^Ftp, Gs^Ftp, Gs^Ftp, Rmo, Gs^Ftp, Gs^Ftp, Rmo, Rmo, Cdr, Cdr, Ds, Ds, Wwt, Wwt, Wwt, Wot, Wwt, Wot, Wot, Wwrt, Wot, Wot, Wwrt, Wwrt, Wot
Hh, Hh, Hh, Hh, Gs^Ftp, Gs^Ftp, Gs, Gs^Ftp, Gs^Ftp, Gs^Ftp, Gs, Gs^Ftp, Gs, Gs^Ftp, Gs, Gs^Ftp, Gs^Ftp, Gs^Ftp, Gs^Ftp, Gs^Ftp, Rmo, Rmo, Kdr, Cdr, Gs^Ftp, Cdr, Kdr, Gs^Ftp, Gs^Ftp, Gs^Ftp, Gs^Ftp, Gs^Ftp, Cdr, Rmo, Rmo, Gs^Ftp, Gs^Ftp, Gs^Ftp, Cdr, Rmo, Gs^Ftp, Gs^Ftp, Rmo, Rmo, Kdr, Gs^Ftp, Gs^Ftp, Gs^Ftp, Gs^Ftp, Rmo, Cdr, Dd^Ftd, Ds, Wwt, Wwt, Wwt, Wwt, Wot, Wwt, Wwrt, Wot, Wot, Wot, Wot, Wwrt, Wot
Hd, Hh, Hh, Gs^Ftp, Gs^Ftp, Gs, Gs^Ftp, Gs^Ftp, Gs^Ftp, Gs^Ftp, Gs^Ftp, Gs^Ftp, Gs, Gs^Ftp, Gs^Ftp, Gs^Ftp, Gs^Ftp, Gs^Ftp, Gs^Ftp, Gs^Ftp, Gs^Ftp, Rmo, Cdr, Gs^Ftp, Kdr, Gs^Ftp, Cdr, Gs^Ftp, Gs^Ftp, Gs^Ftp, Gs^Ftp, Gs^Ftp, Gs^Ftp, Cdr, Gs^Ftp, Gs^Ftp, Gs^Ftp, Rmo, Cdr, Rmo, Gs^Ftp, Gs^Ftp, Kdr, Kdr, Rmo, Kdr, Kdr, Gs^Ftp, Gs^Ftp, Rmo, Kdr, Ds, Wwt, Wwt, Kdr, Wwt, Wwt, Wwt, Wwt, Wot, Wwrt, Wot, Wot, Wot, Wwrt, Wot
Hd, Hd, Gs^Ftp, Gs^Ftp, Gs^Ftp, Gs^Ftp, Gs^Ftp, Gs^Ftp, Gs^Ftp, Gs^Ftp, Gs^Ftp, Gs^Ftp, Gs, Gs^Ftp, Gs^Ftp, Gs^Ftp, Gs^Ftp, Gs, Gs, Gs^Ftp, Gs^Ftp, Gs^Ftp, Kdr, Gs^Ftp, Gs^Ftp, Cdr, Kdr, Gs^Ftp, Gs^Ftp, Gs^Ftp, Gs^Ftp, Gs^Ftp, Gs^Ftp, Kdr, Rmo, Gs^Ftp, Gs^Ftp, Rmo, Kdr, Rmo, Rmo, Rmo, Kdr, Cdr, Kdr, Cdr, Kdr, Rmo, Gs^Ftp, Gs^Ftp, Dd^Ftd, Ds, Wwt, Wwt, Ds, Kdr, Kdr, Wwt, Wwt, Wot, Wwrt, Wot, Wot, Wot, Wwrt, Wot
Dd^Ftd, Dd^Ftd, Dd^Ftd, Gs, Gs^Ftp, Gs^Ftp, Gs^Ftp, Gs^Ftp, Gs^Ftp, Gs^Ftp, Gs^Ftp, Gs^Ftp, Gs^Ftp, Gs^Ftp, Gs^Ftp, Gs^Ftp, Dd^Ftd, Gs^Ftp, Gs, Gs, Gs^Ftp, Gs, Gs^Ftp, Cdr, Kdr, Cdr, Dd^Ftd, Gs^Ftp, Gs^Ftp, Gs^Ftp, Gs^Ftp, Rmo, Gs^Ftp, Gs^Ftp, Rmo, Gs^Ftp, Gs^Ftp, Rmo, Gs^Ftp, Gs^Ftp, Gs^Ftp, Rmo, Kdr, Rmo, Cdr, Rmo, Kdr, Gs^Ftp, Gs^Ftp, Gs^Ftp, Dd^Ftd, Dd^Ftd, Wwt, Wwt, Ds, Dd^Ftd, Kdr, Wwt, Wwt, Wot, Wot, Wot, Wwrt, Wot, Wot, Wot
Ds, Ds, Ds, Dd^Ftd, Dd^Ftd, Gs^Ftp, Dd^Ftd, Gs^Ftp, Dd^Ftd, Gs^Ftp, Dd^Ftd, Gs^Ftp, Dd^Ftd, Dd^Ftd, Dd^Ftd, Dd^Ftd, Dd^Ftd, Dd^Ftd, Dd^Ftd, Gs, Gs^Ftp, Gs^Ftp, Gs^Ftp, Gs^Ftp, Dd^Ftd, Dd^Ftd, Dd^Ftd, Dd^Ftd, Rmo, Rmo, Gs^Ftp, Rmo, Gs^Ftp, Gs^Ftp, Gs^Ftp, Gs^Ftp, Gs^Ftp, Gs^Ftp, Gs^Ftp, Gs^Ftp, Gs^Ftp, Rmo, Rmo, Kdr, Kdr, Kdr, Rmo, Rmo, Gs^Ftp, Gs^Ftp, Kdr, Dd^Ftd, Ds, Wwt, Wwt, Ds, Kdr, Wwt, Wwt, Wot, Wwrt, Wot, Wot, Wot, Wot, Wot
Ds, Ds, Ds, Ds, Ds, Dd^Ftd, Ds, Dd^Ftd, Ds, Dd^Ftd, Ds, Dd^Ftd, Ds, Ds, Ds, Ds, Dd^Ftd, Dd^Ftd, Dd^Ftd, Dd^Ftd, Dd^Ftd, Gs^Ftp, Dd^Ftd, Dd^Ftd, Dd^Ftd, Ds, Ds, Dd^Ftd, Dd^Ftd, Gs^Ftp, Dd^Ftd, Gs^Ftp, Dd^Ftd, Rmo, Rmo, Gs^Ftp, Gs^Ftp, Rmo, Kdr, Rmo, Gs^Ftp, Gs^Ftp, Gs^Ftp, Rmo, Rmo, Rmo, Gs^Ftp, Rmo, Gs^Ftp, Gs^Ftp, Cdr, Dd^Ftd, Dd^Ftd, Ds, Cdr, Wwt, Wwt, Wwt, Wot, Wot, Wwrt, Wot, Wwrt, Wot, Wot, Wot
Wwt, Wwt, Wwt, Ds, Ds, Ds, Ds, Ds, Ds, Ds, Ds, Ds, Wwt, Wwt, Wwt, Ds, Ds, Ds, Ds, Ds, Dd^Ftd, Dd^Ftd, Dd^Ftd, Dd^Ftd, Ds, Ds, Wwt, Ds, Ds, Dd^Ftd, Ds, Dd^Ftd, Dd^Ftd, Kdr, Gs^Ftp, Gs^Ftp, Gs^Ftp, Rmo, Cdr, Gs^Ftp, Gs^Ftp, Gs^Ftp, Gs^Ftp, Gs^Ftp, Gs^Ftp, Gs^Ftp, Rmo, Gs^Ftp, Gs^Ftp, Rmo, Cdr, Gs^Ftp, Dd^Ftd, Cdr, Wwt, Wwt, Wwt, Wwt, Wot, Wot, Wot, Wot, Wwrt, Wot, Wot, Wot
Wot, Wwt, Wwt, Wwt, Wwt, Ds, Wwt, Wwt, Wwt, Ds, Wwt, Wwt, Wwt, Wwt, Wwt, Wwt, Wwt, Ds, Wwt, Ds, Ds, Ds, Ds, Ds, Wwt, Wwt, Wwt, Wwt, Wwt, Ds, Ds, Ds, Ds, Cdr, Rmo, Gs^Ftp, Gs^Ftp, Gs^Ftp, Cdr, Rmo, Gs^Ftp, Rmo, Gs^Ftp, Gs^Ftp, Gs^Ftp, Gs^Ftp, Gs^Ftp, Gs^Ftp, Gs^Ftp, Cdr, Gs^Ftp, Gs^Ftp, Cdr, Cdr, Wwt, Wwt, Wwt, Wwt, Wot, Wot, Wwrt, Wot, Wot, Wot, Wot, Wot
Wot, Wwt, Wwt, Wwt, Wwt, Wwt, Wwt, Wwt, Wot, Wwt, Wwt, Wwt, Wwt, Wwt, Wwt, Wwt, Wwt, Wwt, Wwt, Wwt, Wwt, Ds, Wwt, Wwt, Wwt, Wwt, Wwt, Wwt, Wwt, Wwt, Wwt, Ds, Wwt, Cdr, Cdr, Gs^Ftp, Gs^Ftp, Gs^Ftp, Rmo, Cdr, Gs^Ftp, Gs^Ftp, Gs^Ftp, Rmo, Ds, Gs^Ftp, Gs^Ftp, Gs^Ftp, Gs^Ftp, Cdr, Gs^Ftp, Gs^Ftp, Cdr, Wwt, Wwt, Wwt, Wwt, Wot, Wot, Wwrt, Wot, Wot, Wwrt, Wwrt, Wot, Wot
Wot, Wot, Wwt, Wot, Wwt, Wwt, Wot, Wwt, Wot, Wwt, Wwt, Wwt, Wwt, Wot, Wwt, Wwt, Wwt, Wwt, Wwt, Wwt, Wwt, Wwt, Wwt, Wwt, Wot, Wot, Wot, Wwt, Wwt, Wwt, Wwt, Wwt, Wwt, Ds, Kdr, Rmo, Gs^Ftp, Gs^Ftp, Cdr, Kdr, Cdr, Gs^Ftp, Cdr, Kdr, Wwt, Kdr, Cdr, Rmo, Cdr, Kdr, Gs^Ftp, Cdr, Wwt, Wwt, Wot, Wwt, Wwt, Wot, Wwrt, Wwrt, Wot, Wot, Wwrt, Wot, Wot, Wot
Wwt, Wwt, Wot, Wwt, Wot, Wwt, Wwt, Wot, Wwt, Wwt, Wwt, Wwt, Wot, Wot, Wwt, Wot, Wot, Wot, Wwt, Wwt, Wot, Wwt, Wot, Wwt, Wwt, Wwt, Wwt, Wot, Wot, Wwt, Wwt, Wwt, Wwt, Ds, Ds, Cdr, Kdr, Cdr, Ds, Ds, Ds, Cdr, Wwt, Wwt, Wwt, Wwt, Wwt, Kdr, Wwt, Cdr, Cdr, Cdr, Wwt, Wwt, Wwt, Wwt, Wot, Wot, Wot, Wot, Wot, Wot, Wot, Wot, Wwrt, Wot
Wot, Wwt, Wot, Wwt, Wot, Wot, Wot, Wwt, Wwt, Wot, Wwt, Wot, Wwt, Wot, Wwt, Wot, Wwt, Wwt, Wwt, Wwt, Wot, Wwt, Wot, Wot, Wwt, Wwt, Wot, Wot, Wwt, Wwt, Wwt, Wwt, Wwt, Wwt, Wwt, Wwt, Wwt, Wwt, Wwt, Wwt, Wwt, Wwt, Wwt, Wwt, Wwt, Wwt, Wwt, Wwt, Wwt, Wwt, Wwt, Wwt, Wwt, Wot, Wot, Wwt, Wwrt, Wwrt, Wot, Wot, Wwrt, Wwrt, Wot, Wot, Wwrt, Wwrt
Wot, Wot, Wot, Wot, Wot, Wot, Wot, Wot, Wot, Wwt, Wot, Wwt, Wot, Wwt, Wwt, Wwt, Wwt, Wwt, Wwt, Wot, Wot, Wot, Wot, Wot, Wwt, Wwt, Wwt, Wot, Wot, Wot, Wot, Wwt, Wot, Wwt, Wwt, Wwt, Wwt, Wwt, Wwt, Wwt, Wwt, Wwt, Dd^Ftd, Cdr, Dd^Ftd, Cdr, Wwt, Wwt, Wwt, Wwt, Wot, Wwt, Wot, Wot, Wwrt, Wot, Wot, Wot, Wot, Wot, Wot, Wot, Wot, Wwrt, Wot, Wot
Wot, Wwrt, Wot, Wwrt, Wot, Wot, Wwrt, Wot, Wot, Wot, Wot, Wot, Wot, Wot, Wot, Wot, Wot, Wot, Wot, Wot, Wot, Wot, Wot, Wot, Wot, Wwt, Wwrt, Wwt, Wwt, Wwt, Wwt, Wwt, Wot, Wwt, Wwt, Wwt, Wwt, Wwt, Wwt, Wwt, Wwt, Wwt, Wwt, Dd^Ftd, Cdr, Dd^Ftd, Wwt, Wwt, Wwt, Wwt, Wot, Wot, Wwrt, Wwrt, Wot, Wot, Wot, Wot, Wwrt, Wot, Wot, Wot, Wwrt, Wot, Wwrt, Wwrt
Wwrt, Wot, Wwrt, Wot, Wot, Wot, Wot, Wwrt, Wot, Wot, Wwrt, Wot, Wot, Wot, Wot, Wot, Wot, Wot, Wot, Wot, Wot, Wot, Wwrt, Wwrt, Wot, Wot, Wot, Wot, Wot, Wwrt, Wot, Wwrt, Wwrt, Wot, Wot, Wot, Wot, Wot, Wot, Wwt, Wwt, Wwt, Wwt, Kdr, Kdr, Cdr, Dd^Ftd, Wwt, Wwt, Wwt, Wot, Wot, Wwrt, Wot, Wot, Wot, Wwrt, Wot, Wot, Wot, Wot, Wwrt, Wot, Wot, Wwrt, Wwrt
Wot, Wot, Wot, Wot, Wot, Wwrt, Wot, Wot, Wot, Wot, Wot, Wwrt, Wot, Wot, Wot, Wot, Wot, Wot, Wot, Wot, Wot, Wot, Wot, Wot, Wot, Wot, Wot, Wot, Wot, Wot, Wot, Wot, Wot, Wot, Wot, Wot, Wot, Wot, Wot, Wot, Wwt, Wwt, Cdr, Kdr, Cdr, Cdr, Dd^Ftd, Dd^Ftd, Wwt, Wwt, Wot, Wot, Wot, Wwrt, Wot, Wot, Wot, Wot, Wot, Wot, Wot, Wwrt, Wot, Wwrt, Wot, Wot
Wot, Wot, Wot, Wot, Wot, Wwrt, Wot, Wwrt, Wot, Wot, Wot, Wwrt, Wwrt, Wwrt, Wwrt, Wwrt, Wot, Wot, Wot, Wwrt, Wot, Wwrt, Wwrt, Wot, Wot, Wwrt, Wwrt, Wot, Wot, Wot, Wot, Wot, Wot, Wot, Wot, Wot, Wwrt, Wot, Wot, Wot, Wwt, Wwt, Dd^Ftd, Cdr, Dd^Ftd, Dd^Ftd, Dd^Ftd, Wwt, Wot, Wot, Wwrt, Wot, Wwrt, Wot, Wwrt, Wwrt, Wot, Wot, Wot, Wot, Wot, Wot, Wot, Wwrt, Wot, Wot
Wot, Wot, Wwrt, Wwrt, Wot, Wwrt, Wwrt, Wot, Wwrt, Wot, Wot, Wot, Wot, Wot, Wot, Wwrt, Wot, Wwrt, Wwrt, Wot, Wwrt, Wot, Wwrt, Wwrt, Wot, Wot, Wot, Wot, Wot, Wwrt, Wot, Wwrt, Wot, Wot, Wot, Wot, Wot, Wwrt, Wot, Wot, Wwt, Wwt, Dd^Ftd, Dd^Ftd, Wwt, Dd^Ftd, Wwt, Wwt, Wot, Wwrt, Wot, Wot, Wot, Wot, Wot, Wot, Wot, Wot, Wwrt, Wot, Wot, Wot, Wot, Wwrt, Wot, Wot
Wot, Wwrt, Wot, Wot, Wot, Wot, Wot, Wwrt, Wot, Wot, Wot, Wot, Wwrt, Wwrt, Wot, Wwrt, Wwrt, Wwrt, Wot, Wot, Wot, Wot, Wwrt, Wwrt, Wwrt, Wot, Wot, Wot, Wwrt, Wot, Wot, Wwrt, Wot, Wot, Wot, Wwrt, Wwrt, Wot, Wwrt, Wot, Wot, Wwt, Wwt, Wwt, Wot, Wwt, Wot, Wot, Wot, Wwrt, Wot, Wot, Wot, Wwrt, Wot, Wot, Wot, Wwrt, Wot, Wot, Wot, Wot, Wot, Wwrt, Wot, Wot
Wot, Wot, Wwrt, Wot, Wwrt, Wot, Wot, Wot, Wot, Wot, Wot, Wwrt, Wot, Wot, Wot, Wot, Wot, Wot, Wot, Wot, Wot, Wot, Wot, Wot, Wwrt, Wwrt, Wot, Wot, Wwrt, Wot, Wot, Wot, Wot, Wot, Wot, Wot, Wwrt, Wwrt, Wot, Wot, Wwrt, Wot, Wot, Wot, Wot, Wot, Wot, Wot, Wot, Wwrt, Wot, Wot, Wwrt, Wwrt, Wot, Wot, Wwrt, Wwrt, Wot, Wot, Wwrt, Wwrt, Wot, Wot, Wwrt, Wwrt
Wot, Wwrt, Wot, Wot, Wot, Wwrt, Wot, Wot, Wot, Wot, Wot, Wwrt, Wot, Wot, Wot, Wwrt, Wot, Wot, Wwrt, Wot, Wwrt, Wot, Wwrt, Wot, Wot, Wot, Wot, Wot, Wot, Wwrt, Wot, Wot, Wot, Wot, Wot, Wot, Wot, Wwrt, Wwrt, Wot, Wot, Wot, Wwrt, Wot, Wot, Wot, Wot, Wot, Wot, Wwrt, Wwrt, Wot, Wot, Wot, Wot, Wwrt, Wot, Wwrt, Wot, Wwrt, Wot, Wot, Wot, Wot, Wwrt, Wot
Wot, Wwrt, Wot, Wot, Wot, Wot, Wot, Wwrt, Wot, Wot, Wwrt, Wot, Wwrt, Wot, Wot, Wot, Wot, Wot, Wwrt, Wot, Wwrt, Wot, Wot, Wot, Wwrt, Wot, Wwrt, Wot, Wot, Wwrt, Wot, Wot, Wot, Wwrt, Wwrt, Wwrt, Wot, Wot, Wot, Wot, Wot, Wot, Wot, Wot, Wwrt, Wwrt, Wwrt, Wot, Wot, Wwrt, Wwrt, Wot, Wot, Wot, Wot, Wot, Wot, Wwrt, Wot, Wot, Wot, Wot, Wot, Wot, Wwrt, Wot
Wot, Wwrt, Wot, Wot, Wot, Wot, Wot, Wot, Wwrt, Wot, Wwrt, Wot, Wot, Wot, Wwrt, Wot, Wot, Wot, Wot, Wot, Wot, Wot, Wot, Wot, Wot, Wot, Wot, Wot, Wot, Wot, Wwrt, Wot, Wot, Wot, Wot, Wot, Wwrt, Wot, Wot, Wot, Wot, Wwrt, Wot, Wot, Wot, Wot, Wot, Wwrt, Wot, Wot, Wot, Wwrt, Wot, Wot, Wot, Wwrt, Wot, Wwrt, Wot, Wot, Wot, Wot, Wot, Wwrt, Wot, Wot
Wot, Wot, Wwrt, Wwrt, Wwrt, Wwrt, Wot, Wot, Wot, Wot, Wot, Wot, Wot, Wot, Wwrt, Wwrt, Wot, Wot, Wwrt, Wot, Wot, Wot, Wot, Wot, Wwrt, Wot, Wot, Wot, Wot, Wot, Wot, Wot, Wot, Wot, Wot, Wot, Wot, Wot, Wot, Wot, Wot, Wot, Wot, Wot, Wot, Wot, Wot, Wot, Wot, Wot, Wot, Wwrt, Wot, Wot, Wot, Wwrt, Wwrt, Wot, Wot, Wot, Wot, Wot, Wwrt, Wwrt, Wot, Wot
Wwrt, Wot, Wwrt, Wwrt, Wot, Wot, Wot, Wwrt, Wot, Wwrt, Wot, Wwrt, Wwrt, Wwrt, Wot, Wot, Wot, Wot, Wot, Wot, Wot, Wot, Wot, Wot, Wwrt, Wot, Wot, Wot, Wwrt, Wwrt, Wot, Wot, Wwrt, Wwrt, Wwrt, Wot, Wot, Wot, Wot, Wwrt, Wwrt, Wwrt, Wot, Wot, Wot, Wot, Wot, Wot, Wwrt, Wwrt, Wot, Wot, Wot, Wot, Wot, Wwrt, Wwrt, Wot, Wot, Wwrt, Wwrt, Wot, Wot, Wot, Wot, Wot
