border_size=1
usage=map

Gll^Fmf, Gg, Gll^Fmf, Gll^Fmf, Gll^Fmf, Gll^Fmf, Gll^Fmf, Gll^Fmf, Gll^Fmf, Gll, Gll, Gd, Gd, Gd, Ds, Ds, Ww, Ww, Ww, Wo, Wo, Wo, Wo, Wo, Wo, Wo
Gll^Fmf, Gll^Fmf, Gll^Fmf, Gll^Fmf, Gll^Fmf, Gll^Fmf, Gll^Fmf, Gll^Fmf, Gll^Fmf, Gll^Fmf, Gll, Gd, Gd, Gd, Ds, Ds, Ds, Ww, Ww, Wo, Wo, Wo, Wo, Wo, Wo, Wo
Gll^Fmf, Gll^Fmf, Gll^Fmf, Gll^Fmf, Gll^Fmf, Gll^Fmf, Gll, Gll, Gll, Gll, Gll, Gd^Es, Gd, Gd, Gd, Ds, Ds, Ww, Ww, Ww, Wo, Wo, Wo, Wo, Wo, Wo
Gll^Fmf, Gll^Fmf, Gll^Fmf, Gll^Fmf, Gll, Gll, Gll, Gll, Gll, Gll, Gll^Fmf, Gll, Gd, Gd, Gd, Ds, Ds, Ds, Ww, Ww, Ww, Wo, Wo, Wo, Wo, Wo
Gll^Fmf, Gll^Fmf, Gll^Fmf, Gll, Gll, Gd^Es, Gd, Gd, Gd, Gll^Fmf, Gll^Efm, Gll^Fmf, Gd, Gd, Gd, Gd, Ds, Ds, Ww, Ww, Ww, Wo, Wo, Wo, Wo, Wo
Gll^Fmf, Gll^Fmf, Gll, Gll, Gll^Fmf, Gd, Gd, Gd, Gd, Gd, Gd^Efm, Gll^Fmf, Gd, Gd, Gd, Gd, Ds, Ds, Ds, Ww, Ww, Ww, Wo, Wo, Wo, Wo
Gll^Fmf, Gll, Gll, Gll, Gll^Fmf, Gd, Gd, Gd, Ce, Gd, Gd, Gd^Efm, Gd, Gd, Gd, Gd, Gd, Ds, Ds^Bw/, Ww^Bw/, Ww, Ww, Wo, Wo, Wo, Wo
Gll, Gll, Gll, Gll^Fmf, Gll, Gd, Gd, Ce, 1 Ke, Ce, Gd, Gd, Gd, Gd, Gd, Gd, Ket, Ket, Ds^Bw/, Ww^Bw/, Ww, Ww, Wo, Wo, Wo, Wo
Gd, Gd, Gll, Gll^Fmf, Gd, Gd, Gd, Ce, Ce, Ce, Gd, Gd, Gd, Gd, Gd, Gd, Ce, Ket, Ds, Ww, Ww, Ww, Wo, Wo, Wo, Wo
Gd, Gd, Gd, Gll, Gd^Efm, Gd, Gd, Gd, Gd, Gd, Gd, Gd, Gd, Gd, Gd, Gd, Gd, Ds, Ds, Ww, Ww, Wo, Wo, Wo, Wo, Wo
Gll, Gd, Gll, Gll, Gd^Es, Gd^Efm, Gd, Gd, Gll, Gd, Gd, Gd, Gd, Gd^Es, Gd, Gd, Ds, Ds, Ds, Ww, Ww, Wo, Wo, Wo, Wo, Wo
Gll^Fmf, Gll, Gll, Gd, Gd, Gd^Efm, Gd, Gd, Gll^Fmf, Gll, Gll^Fmf, Gd, Gd, Gd, Gd, Gd, Ds, Ds, Ww, Ww, Ww, Ww, Wo, Wo, Wo, Wo
Gll^Fmf, Gll^Fmf, Gll^Fmf, Gll, Gll, Gd, Gd, Gll^Fmf, Gll, Gll^Fmf, Gd, Gd, Gd, Gd, Ds, Ds, Ds, Ds, Ww, Ww, Ww, Ww, Wo, Wo, Wo, Wo
Gll^Fmf, Gll^Fmf, Gll^Fmf, Gll^Fmf, Gll, Gd, Gd, Gd, Gd^Es, Gll, Gd, Gd, Gd, Gd, Ds, Ds, Ww, Ww, Ww, Ww, Ww, Ww, Wo, Wo, Wo, Wo
Gll^Fmf, Gll^Fmf, Gll^Fmf, Gll^Fmf, Gll^Fmf, Gll, Gd, Gd, Gd, Gd, Gd, Gd, Ds, Ds, Ds, Ds, Ww, Ww, Ww, Ww, Wo, Wo, Wo, Wo, Wo, Wo
Gll^Fmf, Gll^Fmf, Gll^Fmf, Gll^Fmf, Gll^Fmf, Gll, Gd, Gd, Gd, Gd, Gd, Gd, Gd, Ds, Ww, Ww, Ww, Ww, Ww, Wo, Wo, Wo, Wo, Wo, Wo, Wo
