Rmo, Rmo, Rmo, Rmo, Rmo, Rmo, Rmo, Rmo, Rmo, Gg^Efm, Xoc, Xoc, Xoc, Xoc, Rmp, Rmp, Rmp, Rmp, Rmp, Rmp, Rmp, Rmp, Rmp, Rmp, Rmp, Rmp, Rmp, Xoc, Xoc, Xoc, Xoc, Gg^Efm, Rmo, Gg, Gg^Efm, Gg, Rmo, Rmo, Gg^Efm, Xoc, Xoc
Rmo, Rmo, Rmo, Rmo, Gg, Rmo, Rmo, Rmo, Rmo, Gg^Efm, Xoc, Xoc, Xoc, Xoc, Rmp, Rmp, Rmp, Rmp, Rmp, Rmp, Rmp, Rmp, Rmp, Rmp, Rmp, Rmp, Rmp, Xoc, Xoc, Xoc, Xoc, Gg^Efm, Rmo, Gg, Gg, Gg, Rmo, Rmo, Gg^Efm, Xoc, Xoc
Rmo, Rmo, Rmo, Gg, Gg^Efm, Gg, Rmo, Rmo, Rmo, Gg, Xoc, Xoc, Xoc, Xoc, Rmp, Rmp, Rmp, Rmp, Rmp, Rmp, Rmp, Rmp, Rmp, Rmp, Rmp, Rmp, Rmp, Xoc, Xoc, Xoc, Xoc, Gg^Efm, Rmo, Rmo, Rmo, Rmo, Rmo, Rmo, Gg, Xoc, Xoc
Rmo, Rmo, Rmo, Gg, Gg, Gg, Rmo, Rmo, Rmo, Gg^Efm, Xoc, Xoc, Xoc, Xoc, Xoc, Rmp, Rmp, Rmp, Rmp, Rmp, Rmp, Rmp, Rmp, Rmp, Rmp, Rmp, Xoc, Xoc, Xoc, Xoc, Xoc, Gg, Rmo, Rmo, Gg, Rmo, Rmo, Rmo, Gg, Xoc, Xoc
Gg^Efm, Rmo, Rmo, Rmo, Rmo, Rmo, Rmo, Rmo, Rmo, Gg^Efm, Xoc, Xoc, Xoc, Xoc, Xoc, Rmp, Rmp, Rmp, Rmp, Rmp, Rmp, Rmp, Rmp, Rmp, Rmp, Rmp, Xoc, Xoc, Xoc, Xoc, Xoc, Gg, Rmo, Gg, Gg^Efm, Gg, Rmo, Rmo, Gg^Efm, Xoc, Xoc
Xoc, Gg^Efm, Gg, Rmo, Rmo, Rmo, Rmo, Rmo, Rmo, Gg^Efm, Xoc, Xoc, Xoc, Xoc, Xoc, Rmp, Rmp, Rmp, Rmp, Rmp, Rmp, Rmp, Rmp, Rmp, Rmp, Rmp, Xoc, Xoc, Xoc, Xoc, Xoc, Gg^Efm, Rmo, Gg, Gg, Gg, Rmo, Rmo, Gg^Efm, Xoc, Xoc
Xoc, Xoc, Xoc, Gg^Efm, Gg^Efm, Rmo, Rmo, Rmo, Rmo, Gg, Gg^Efm, Xoc, Xoc, Xoc, Xoc, Xoc, Rmp, Rmp, Rmp, Rmp, Rmp, Rmp, Rmp, Rmp, Rmp, Xoc, Xoc, Xoc, Xoc, Xoc, Gg^Efm, Gg^Efm, Rmo, Rmo, Rmo, Rmo, Rmo, Rmo, Gg^Efm, Xoc, Xoc
Xoc, Xoc, Xoc, Xoc, Xoc, Gg^Efm, Gg, Rmo, Rmo, Rmo, Rmo, Gg^Efm, Xoc, Xoc, Xoc, Xoc, Rmp, Rmp, Rmp, Rmp, Rmp, Rmp, Rmp, Rmp, Rmp, Xoc, Xoc, Xoc, Xoc, Gg, Rmo, Rmo, Rmo, Rmo, Gg^Efm, Rmo, Rmo, Rmo, Gg, Xoc, Xoc
Xoc, Xoc, Xoc, Xoc, Xoc, Xoc, Xoc, Gg^Efm, Gg^Efm, Rmo, Rmo, Gg^Efm, Xoc, Xoc, Xoc, Xoc, Xoc, Rmp, Rmp, Rmp, Rmp, Rmp, Rmp, Rmp, Xoc, Xoc, Xoc, Xoc, Xoc, Gg^Efm, Rmo, Rmo, Rmo, Gg, Gg^Efm, Gg^Efm, Rmo, Rmo, Gg^Efm, Xoc, Xoc
Xoc, Xoc, Xoc, Xoc, Xoc, Xoc, Xoc, Xoc, Gg^Efm, Rmo, Rmo, Gg^Efm, Gg, Xoc, Xoc, Xoc, Xoc, Xoc, Rmp, Rmp, Rmp, Rmp, Rmp, Xoc, Xoc, Xoc, Xoc, Xoc, Gg^Efm, Gg^Efm, Rmo, Rmo, Rmo, Gg, Gg, Gg, Rmo, Rmo, Gg, Xoc, Xoc
Rmo, Xoc, Xoc, Xoc, Xoc, Xoc, Xoc, Xoc, Rmo, Rmo, Rmo, Rmo, Rmo, Gg^Efm, Xoc^Efs, Xoc, Xoc, Xoc, Rmp, Rmp, Gg, Rmp, Rmp, Xoc, Xoc, Xoc, Xoc^Efs, Gg^Efm, Rmo, Rmo, Rmo, Rmo, Rmo, Rmo, Rmo, Rmo, Rmo, Rmo, Gg^Efm, Xoc, Xoc
Rmo, Rmo, Rmo, Xoc, Xoc, Xoc, Rmo, Rmo, Rmo, Rmo, Rmo, Rmo, Rmo, Gg^Efm, Gg^Efm, Xoc, Xoc, Xoc, Gg^Efm, Gg, Gg, Gg, Gg^Efm, Xoc, Xoc, Xoc, Gg^Efm, Gg, Rmo, Rmo, Rmo, Rmo, Gg, Gg, Gg, Rmo, Rmo, Rmo, Rmo, Gg^Efm, Gg^Efm
Rmo, Rmo, Rmo, Rmo, Rmo, Rmo, Rmo, Rmo, Xoc, Rmo, Rmo, Rmo, Rmo, Rmo, Rmo, Gg^Efm, Gg^Efm, Xoc^Efs, Gg^Efm, Gg, Gg, Gg, Gg^Efm, Xoc^Efs, Gg^Efm, Gg^Efm, Rmo, Rmo, Rmo, Rmo, Rmo, Rmo, Gg^Efm, Gg^Efm, Gg, Rmo, Rmo, Rmo, Rmo, Rmo, Rmo
Xoc, Gg^Efm, Xoc, Rmo, Rmo, Rmo, Xoc, Xoc, Xoc, Rmo, Rmo, Rmo, Rmo, Rmo, Rmo, Rmo, Rmo, Gg^Efm, Rmo, Gg, Gg, Gg, Rmo, Gg^Efm, Rmo, Rmo, Rmo, Rmo, Rmo, Rmo, Rmo, Rmo, Rmo, Gg, Rmo, Rmo, Rmo, Rmo, Rmo, Rmo, Rmo
Xoc, Xoc, Xoc, Xoc, Rmo, Rmo, Xoc, Xoc, Xoc, Rmo, Rmo, Rmo, Rmo, Rmo, Rmo, Rmo, Rmo, Rmo, Rmo, Rmo, Rmo, Rmo, Rmo, Rmo, Rmo, Rmo, Rmo, Rmo, Rmo, Rmo, Rmo, Rmo, Rmo, Rmo, Rmo, Rmo, Rmo, Rmo, Rmo, Rmo, Rmo
Xoc, Xoc, Xoc, Xoc, Rmo, Rmo, Xoc, Xoc, Xoc, Rmo, Rmo, Rmo, Rmo, Rmo, Rmo, Rmo, Rmo, Rmo, Rmo, Rmo, Rmo, Rmo, Rmo, Rmo, Rmo, Rmo, Rmo, Rmo, Rmo, Rmo, Rmo, Rmo, Rmo, Rmo, Gg^Efm, Rmo, Rmo, Rmo, Rmo, Rmo, Rmo
Xoc, Xoc, Xoc, Xoc, Rmo, Rmo, Xoc, Xoc, Xoc, Rmo, Rmo, Rmo, Rmo, Rmo, Rmo, Rmo, Rmo, Rmo, Rmo, Rmo, Gg^Efm, Rmo, Rmo, Rmo, Rmo, Rmo, Rmo, Rmo, Rmo, Rmo, Rmo, Rmo, Gg, Gg^Efm, Xoc, Gg^Efm, Gg^Efm, Rmo, Rmo, Rmo, Rmo
Xoc, Xoc, Xoc^Efs, Xoc, Rmo, Rmo, Xoc, Xoc, Xoc, Rmo, Rmo, Rmo, Rmo, Rmo, Gg, Gg, Rmo, Rmo, Gg^Efm, Gg^Efm, Wwt^Bsb|, Gg^Efm, Gg^Efm, Rmo, Rmo, Gg, Gg, Rmo, Rmo, Rmo, Gg^Efm, Gg^Efm, Xoc, Xoc, Xoc, Xoc, Xoc, Gg, Gg^Efm, Rmo, Rmo
Gg^Efm, Gg^Efm, Gg^Efm, Rmo, Rmo, Rmo, Gg^Efm, Xoc, Xoc^Efs, Rmo, Rmo, Rmo, Rmo, Rmo, Gg, Gg, Gg^Efm, Gg^Efm, Wwt, Wwt, 1 Gg^Efm, Wwt, Wwt, Gg^Efm, Gg^Efm, Gg, Gg, Rmo, Rmo, Rmo, Gg^Efm, Xoc, Xoc, Xoc, Xoc, Xoc, Xoc, Xoc, Gg^Efm, Rmo, Rmo
Rmo, Rmo, Rmo, Rmo, Rmo, Rmo, Rmo, Gg^Efm, Gg^Efm, Gg^Efm, Rmo, Rmo, Rmo, Rmo, Gg, Wwt, Gg^Efm, Wwt^Bsb\, Gg^Efm, Gg^Efm, Ww^Ewf, Gg^Efm, Gg^Efm, Wwt^Bsb/, Gg^Efm, Wwt, Gg, Rmo, Rmo, Rmo, Gg, Xoc, Xoc, Xoc, Xoc, Xoc, Xoc, Xoc, Gg^Efm, Rmo, Rmo
Gg^Efm, Rmo, Rmo, Rmo, Rmo, Rmo, Rmo, Rmo, Rmo, Rmo, Rmo, Rmo, Rmo, Rmo, Gg, Wwt, Gg^Efm, Wwt, Gg^Efm, Ww^Ewf, Wwt^Rs, Ww^Ewf, Gg^Efm, Wwt, Gg^Efm, Wwt, Gg, Rmo, Rmo, Rmo, Gg^Efm, Xoc, Xoc, Xoc, Xoc, Xoc, Xoc, Xoc, Gg, Rmo, Rmo
Xoc, Gg, Gg^Efm, Rmo, Rmo, Rmo, Rmo, Rmo, Rmo, Rmo, Rmo, Rmo, Rmo, Rmo, Gg, Wwt, Gg^Efm, Wwt, Gg^Efm, Ww^Ewf, Ww^Ewf, Ww^Ewf, Gg^Efm, Wwt, Gg^Efm, Wwt, Gg, Rmo, Rmo, Rmo, Gg^Efm, Xoc, Xoc, Xoc, Xoc, Xoc, Xoc, Xoc, Gg^Efm, Rmo, Rmo
Xoc, Xoc, Xoc, Gg^Efm, Rmo, Rmo, Rmo, Rmo, Gg^Efm, Rmo, Rmo, Rmo, Rmo, Rmo, Gg, Wwt, Gg^Efm, Wwt^Bsb/, Wwt, Gg^Efm, Gg^Efm, Gg^Efm, Wwt, Wwt^Bsb\, Gg^Efm, Wwt, Gg, Rmo, Rmo, Rmo, Rmo, Gg^Efm, Gg, Xoc, Xoc^Efs, Xoc, Gg, Gg^Efm, Rmo, Rmo, Rmo
Xoc, Xoc, Xoc, Gg^Efm, Rmo, Rmo, Gg^Efm, Gg^Efm, Xoc, Gg^Efm, Rmo, Rmo, Rmo, Rmo, Gg, Gg, Wwt, Gg^Efm, Gg^Efm, Wwt, Wwt^Bsb|, Wwt, Gg^Efm, Gg^Efm, Wwt, Gg, Gg, Rmo, Rmo, Rmo, Rmo, Rmo, Rmo, Gg^Efm, Gg^Efm, Gg^Efm, Rmo, Rmo, Rmo, Rmo, Rmo
Xoc, Xoc, Xoc, Gg, Rmo, Gg^Efm, Xoc, Xoc, Xoc, Gg, Rmo, Rmo, Rmo, Rmo, Rmo, Gg, Gg, Wwt, Wwt, Gg^Efm, Gg^Efm, Gg^Efm, Wwt, Wwt, Gg, Gg, Rmo, Rmo, Rmo, Rmo, Rmo, Rmo, Rmo, Rmo, Rmo, Rmo, Rmo, Rmo, Rmo, Rmo, Rmo
Xoc, Xoc, Xoc, Gg^Efm, Rmo, Gg^Efm, Xoc, Xoc, Xoc, Gg^Efm, Rmo, Rmo, Rmo, Rmo, Rmo, Rmo, Rmo, Gg, Gg, Wwt, Gg, Wwt, Gg, Gg, Rmo, Rmo, Rmo, Rmo, Rmo, Rmo, Rmo, Rmo, Rmo, Rmo, Gg^Efm, Rmo, Rmo, Rmo, Rmo, Rmo, Rmo
Xoc, Xoc, Xoc, Gg^Efm, Rmo, Gg, Xoc, Xoc, Xoc, Gg^Efm, Rmo, Rmo, Rmo, Rmo, Rmo, Rmo, Rmo, Rmo, Rmo, Gg, Gg, Gg, Rmo, Rmo, Rmo, Rmo, Rmo, Rmo, Rmo, Rmo, Rmo, Rmo, Gg^Efm, Gg^Efm, Xoc, Gg^Efm, Gg^Efm, Rmo, Rmo, Rmo, Rmo
Xoc, Xoc, Xoc, Gg^Efm, Rmo, Gg^Efm, Xoc, Xoc, Xoc, Gg^Efm, Rmo, Rmo, Rmo, Rmo, Rmo, Rmo, Rmo, Rmo, Rmo, Rmo, Rmo, Rmo, Rmo, Rmo, Rmo, Rmo, Rmo, Rmo, Rmo, Rmo, Rmo, Rmo, Gg^Efm, Xoc, Xoc, Xoc, Gg^Efm, Rmo, Rmo, Rmo, Rmo
Xoc, Xoc, Xoc, Gg, Rmo, Gg^Efm, Xoc, Xoc, Xoc, Gg, Rmo, Rmo, Rmo, Rmo, Rmo, Rmo, Rmo, Rmo, Rmo, Rmo, Rmo, Rmo, Rmo, Rmo, Rmo, Rmo, Rmo, Rmo, Rmo, Rmo, Rmo, Rmo, Gg^Efm, Xoc, Xoc^Efs, Xoc, Gg^Efm, Rmo, Rmo, Rmo, Rmo
Xoc, Xoc, Xoc, Gg^Efm, Rmo, Gg, Gg, Xoc, Xoc^Efs, Gg^Efm, Rmo, Rmo, Rmo, Rmo, Rmo, Rmo, Rmo, Rmo, Gg^Efm, Rmo, Rmo, Rmo, Gg^Efm, Rmo, Rmo, Rmo, Rmo, Rmo, Rmo, Rmo, Rmo, Rmo, Rmo, Gg^Efm, Gg^Efm, Gg^Efm, Rmo, Rmo, Rmo, Rmo, Rmo
Xoc, Xoc, Gg^Efm, Gg^Efm, Rmo, Rmo, Rmo, Gg^Efm, Gg^Efm, Gg^Efm, Rmo, Rmo, Rmo, Rmo, Rmo, Rmo, Gg, Gg^Efm, Xoc, Gg^Efm, Rmo, Gg, Xoc, Gg^Efm, Gg^Efm, Rmo, Rmo, Rmo, Rmo, Rmo, Rmo, Rmo, Rmo, Rmo, Rmo, Rmo, Rmo, Rmo, Rmo, Rmo, Rmo
Gg^Efm, Gg, Rmo, Rmo, Gg, Rmo, Rmo, Rmo, Rmo, Rmo, Rmo, Rmo, Rmo, Rmo, Gg^Efm, Gg^Efm, Xoc, Xoc, Xoc, Gg, Rmo, Gg^Efm, Xoc, Xoc, Xoc, Gg, Gg^Efm, Rmo, Rmo, Rmo, Rmo, Rmo, Rmo, Rmo, Rmo, Rmo, Rmo, Rmo, Rmo, Rmo, Rmo
Rmo, Rmo, Rmo, Gg, Gg^Efm, Gg, Rmo, Rmo, Rmo, Rmo, Rmo, Rmo, Gg, Gg^Efm, Xoc, Xoc, Xoc, Xoc, Xoc, Gg^Efm, Rmo, Gg^Efm, Xoc, Xoc, Xoc, Xoc, Xoc, Gg^Efm, Gg, Rmo, Rmo, Rmo, Rmo, Rmo, Rmo, Rmo, Rmo, Rmo, Rmo, Rmo, Rmo
Rmo, Rmo, Rmo, Gg, Gg, Gg, Rmo, Rmo, Rmo, Rmo, Gg^Efm, Gg^Efm, Xoc, Xoc, Xoc, Xoc, Xoc, Xoc, Xoc, Gg^Efm, Rmo, Gg^Efm, Xoc, Xoc, Xoc, Xoc, Xoc, Xoc, Xoc, Gg^Efm, Gg^Efm, Rmo, Rmo, Rmo, Rmo, Rmo, Rmo, Rmo, Rmo, Rmo, Rmo
Rmo, Rmo, Rmo, Rmo, Rmo, Rmo, Rmo, Rmo, Rmo, Rmo, Gg^Efm, Xoc, Xoc, Xoc, Xoc, Xoc, Xoc, Xoc, Xoc, Gg^Efm, Rmo, Gg, Xoc, Xoc, Xoc, Xoc, Xoc, Xoc, Xoc, Xoc, Gg^Efm, Rmo, Rmo, Rmo, Rmo, Rmo, Rmo, Rmo, Rmo, Rmo, Rmo
