border_size=1
usage=map

Rmo, Rmo, Rmo, Rmo, Rmo, Rmo, Rmo, Rmo, Rmo, Gg^Efm, Xmw, Xmw, Xmw, Xmw, Rmp, Rmp, Rmp, Rmp, Rmp, Rmp, Rmp, Rmp, Rmp, Rmp, Rmp, Rmp, Rmp, Xmw, Xmw, Xmw, Xmw, Gg^Efm, Rmo, Gg, Gg^Efm, Gg, Rmo, Rmo, Gg^Efm, Xmw, Xmw
Rmo, Rmo, Rmo, Rmo, Gg, Rmo, Rmo, Rmo, Rmo, Gg^Efm, Xmw, Xmw, Xmw, Xmw, Rmp, Rmp, Rmp, Rmp, Rmp, Rmp, Rmp, Rmp, Rmp, Rmp, Rmp, Rmp, Rmp, Xmw, Xmw, Xmw, Xmw, Gg^Efm, Rmo, Gg, Gg, Gg, Rmo, Rmo, Gg^Efm, Xmw, Xmw
Rmo, Rmo, Rmo, Gg, Gg^Efm, Gg, Rmo, Rmo, Rmo, Gg, Xmw, Xmw, Xmw, Xmw, Rmp, Rmp, Rmp, Rmp, Rmp, Rmp, Rmp, Rmp, Rmp, Rmp, Rmp, Rmp, Rmp, Xmw, Xmw, Xmw, Xmw, Gg^Efm, Rmo, Rmo, Rmo, Rmo, Rmo, Rmo, Gg, Xmw, Xmw
Rmo, Rmo, Rmo, Gg, Gg, Gg, Rmo, Rmo, Rmo, Gg^Efm, Xmw, Xmw, Xmw, Xmw, Xmw, Rmp, Rmp, Rmp, Rmp, Rmp, Rmp, Rmp, Rmp, Rmp, Rmp, Rmp, Xmw, Xmw, Xmw, Xmw, Xmw, Gg, Rmo, Rmo, Gg, Rmo, Rmo, Rmo, Gg, Xmw, Xmw
Gg^Efm, Rmo, Rmo, Rmo, Rmo, Rmo, Rmo, Rmo, Rmo, Gg^Efm, Xmw, Xmw, Xmw, Xmw, Xmw, Rmp, Rmp, Rmp, Rmp, Rmp, Rmp, Rmp, Rmp, Rmp, Rmp, Rmp, Xmw, Xmw, Xmw, Xmw, Xmw, Gg, Rmo, Gg, Gg^Efm, Gg, Rmo, Rmo, Gg^Efm, Xmw, Xmw
Xmw, Gg^Efm, Gg, Rmo, Rmo, Rmo, Rmo, Rmo, Rmo, Gg^Efm, Xmw, Xmw, Xmw, Xmw, Xmw, Rmp, Rmp, Rmp, Rmp, Rmp, Rmp, Rmp, Rmp, Rmp, Rmp, Rmp, Xmw, Xmw, Xmw, Xmw, Xmw, Gg^Efm, Rmo, Gg, Gg, Gg, Rmo, Rmo, Gg^Efm, Xmw, Xmw
Xmw, Xmw, Xmw, Gg^Efm, Gg^Efm, Rmo, Rmo, Rmo, Rmo, Gg, Gg^Efm, Xmw, Xmw, Xmw, Xmw, Xmw, Rmp, Rmp, Rmp, Rmp, Rmp, Rmp, Rmp, Rmp, Rmp, Xmw, Xmw, Xmw, Xmw, Xmw, Gg^Efm, Gg^Efm, Rmo, Rmo, Rmo, Rmo, Rmo, Rmo, Gg^Efm, Xmw, Xmw
Xmw, Xmw, Xmw, Xmw, Xmw, Gg^Efm, Gg, Rmo, Rmo, Rmo, Rmo, Gg^Efm, Xmw, Xmw, Xmw, Xmw, Rmp, Rmp, Rmp, Rmp, Rmp, Rmp, Rmp, Rmp, Rmp, Xmw, Xmw, Xmw, Xmw, Gg, Rmo, Rmo, Rmo, Rmo, Gg^Efm, Rmo, Rmo, Rmo, Gg, Xmw, Xmw
Xmw, Xmw, Xmw, Xmw, Xmw, Xmw, Xmw, Gg^Efm, Gg^Efm, Rmo, Rmo, Gg^Efm, Xmw, Xmw, Xmw, Xmw, Xmw, Rmp, Rmp, Rmp, Rmp, Rmp, Rmp, Rmp, Xmw, Xmw, Xmw, Xmw, Xmw, Gg^Efm, Rmo, Rmo, Rmo, Gg, Gg^Efm, Gg^Efm, Rmo, Rmo, Gg^Efm, Xmw, Xmw
Xmw, Xmw, Xmw, Xmw, Xmw, Xmw, Xmw, Xmw, Gg^Efm, Rmo, Rmo, Gg^Efm, Gg, Xmw, Xmw, Xmw, Xmw, Xmw, Rmp, Rmp, Rmp, Rmp, Rmp, Xmw, Xmw, Xmw, Xmw, Xmw, Gg^Efm, Gg^Efm, Rmo, Rmo, Rmo, Gg, Gg, Gg, Rmo, Rmo, Gg, Xmw, Xmw
Rmo, Xmw, Xmw, Xmw, Xmw, Xmw, Xmw, Xmw, Rmo, Rmo, Rmo, Rmo, Rmo, Gg^Efm, Xmw, Xmw, Xmw, Xmw, Rmp, Rmp, Gg, Rmp, Rmp, Xmw, Xmw, Xmw, Xmw, Gg^Efm, Rmo, Rmo, Rmo, Rmo, Rmo, Rmo, Rmo, Rmo, Rmo, Rmo, Gg^Efm, Xmw, Xmw
Rmo, Rmo, Rmo, Xmw, Xmw, Xmw, Rmo, Rmo, Rmo, Rmo, Rmo, Rmo, Rmo, Gg^Efm, Gg^Efm, Xmw, Xmw, Xmw, Gg^Efm, Gg, Gg, Gg, Gg^Efm, Xmw, Xmw, Xmw, Gg^Efm, Gg, Rmo, Rmo, Rmo, Rmo, Gg, Gg, Gg, Rmo, Rmo, Rmo, Rmo, Gg^Efm, Gg^Efm
Rmo, Rmo, Rmo, Rmo, Rmo, Rmo, Rmo, Rmo, Xmw, Rmo, Rmo, Rmo, Rmo, Rmo, Rmo, Gg^Efm, Gg^Efm, Xmw, Gg^Efm, Gg, Gg, Gg, Gg^Efm, Xmw, Gg^Efm, Gg^Efm, Rmo, Rmo, Rmo, Rmo, Rmo, Rmo, Gg^Efm, Gg^Efm, Gg, Rmo, Rmo, Rmo, Rmo, Rmo, Rmo
Xmw, Gg^Efm, Xmw, Rmo, Rmo, Rmo, Xmw, Xmw, Xmw, Rmo, Rmo, Rmo, Rmo, Rmo, Rmo, Rmo, Rmo, Gg^Efm, Rmo, Gg, Gg, Gg, Rmo, Gg^Efm, Rmo, Rmo, Rmo, Rmo, Rmo, Rmo, Rmo, Rmo, Rmo, Gg, Rmo, Rmo, Rmo, Rmo, Rmo, Rmo, Rmo
Xmw, Xmw, Xmw, Xmw, Rmo, Rmo, Xmw, Xmw, Xmw, Rmo, Rmo, Rmo, Rmo, Rmo, Rmo, Rmo, Rmo, Rmo, Rmo, Rmo, Rmo, Rmo, Rmo, Rmo, Rmo, Rmo, Rmo, Rmo, Rmo, Rmo, Rmo, Rmo, Rmo, Rmo, Rmo, Rmo, Rmo, Rmo, Rmo, Rmo, Rmo
Xmw, Xmw, Xmw, Xmw, Rmo, Rmo, Xmw, Xmw, Xmw, Rmo, Rmo, Rmo, Rmo, Rmo, Rmo, Rmo, Rmo, Rmo, Rmo, Rmo, Rmo, Rmo, Rmo, Rmo, Rmo, Rmo, Rmo, Rmo, Rmo, Rmo, Rmo, Rmo, Rmo, Rmo, Gg^Efm, Rmo, Rmo, Rmo, Rmo, Rmo, Rmo
Xmw, Xmw, Xmw, Xmw, Rmo, Rmo, Xmw, Xmw, Xmw, Rmo, Rmo, Rmo, Rmo, Rmo, Rmo, Rmo, Rmo, Rmo, Rmo, Rmo, Gg^Efm, Rmo, Rmo, Rmo, Rmo, Rmo, Rmo, Rmo, Rmo, Rmo, Rmo, Rmo, Gg, Gg^Efm, Xmw, Gg^Efm, Gg^Efm, Rmo, Rmo, Rmo, Rmo
Xmw, Xmw, Xmw, Xmw, Rmo, Rmo, Xmw, Xmw, Xmw, Rmo, Rmo, Rmo, Rmo, Rmo, Gg, Gg, Rmo, Rmo, Gg^Efm, Gg^Efm, Wwt^Bsb|, Gg^Efm, Gg^Efm, Rmo, Rmo, Gg, Gg, Rmo, Rmo, Rmo, Gg^Efm, Gg^Efm, Xmw, Xmw, Xmw, Xmw, Xmw, Gg, Gg^Efm, Rmo, Rmo
Gg^Efm, Gg^Efm, Gg^Efm, Rmo, Rmo, Rmo, Gg^Efm, Xmw, Xmw, Rmo, Rmo, Rmo, Rmo, Rmo, Gg, Gg, Gg^Efm, Gg^Efm, Wwt, Wwt, 1 Gg^Efm, Wwt, Wwt, Gg^Efm, Gg^Efm, Gg, Gg, Rmo, Rmo, Rmo, Gg^Efm, Xmw, Xmw, Xmw, Xmw, Xmw, Xmw, Xmw, Gg^Efm, Rmo, Rmo
Rmo, Rmo, Rmo, Rmo, Rmo, Rmo, Rmo, Gg^Efm, Gg^Efm, Gg^Efm, Rmo, Rmo, Rmo, Rmo, Gg, Wwt, Gg^Efm, Wwt^Bsb\, Gg^Efm, Gg^Efm, Wwt, Gg^Efm, Gg^Efm, Wwt^Bsb/, Gg^Efm, Wwt, Gg, Rmo, Rmo, Rmo, Gg, Xmw, Xmw, Xmw, Xmw, Xmw, Xmw, Xmw, Gg^Efm, Rmo, Rmo
Gg^Efm, Rmo, Rmo, Rmo, Rmo, Rmo, Rmo, Rmo, Rmo, Rmo, Rmo, Rmo, Rmo, Rmo, Gg, Wwt, Gg^Efm, Wwt, Gg^Efm, Wwt, Wwt^Rs, Wwt, Gg^Efm, Wwt, Gg^Efm, Wwt, Gg, Rmo, Rmo, Rmo, Gg^Efm, Xmw, Xmw, Xmw, Xmw, Xmw, Xmw, Xmw, Gg, Rmo, Rmo
Xmw, Gg, Gg^Efm, Rmo, Rmo, Rmo, Rmo, Rmo, Rmo, Rmo, Rmo, Rmo, Rmo, Rmo, Gg, Wwt, Gg^Efm, Wwt, Gg^Efm, Wwt, Wwt, Wwt, Gg^Efm, Wwt, Gg^Efm, Wwt, Gg, Rmo, Rmo, Rmo, Gg^Efm, Xmw, Xmw, Xmw, Xmw, Xmw, Xmw, Xmw, Gg^Efm, Rmo, Rmo
Xmw, Xmw, Xmw, Gg^Efm, Rmo, Rmo, Rmo, Rmo, Gg^Efm, Rmo, Rmo, Rmo, Rmo, Rmo, Gg, Wwt, Gg^Efm, Wwt^Bsb/, Wwt, Gg^Efm, Gg^Efm, Gg^Efm, Wwt, Wwt^Bsb\, Gg^Efm, Wwt, Gg, Rmo, Rmo, Rmo, Rmo, Gg^Efm, Gg, Xmw, Xmw, Xmw, Gg, Gg^Efm, Rmo, Rmo, Rmo
Xmw, Xmw, Xmw, Gg^Efm, Rmo, Rmo, Gg^Efm, Gg^Efm, Xmw, Gg^Efm, Rmo, Rmo, Rmo, Rmo, Gg, Gg, Wwt, Gg^Efm, Gg^Efm, Wwt, Wwt^Bsb|, Wwt, Gg^Efm, Gg^Efm, Wwt, Gg, Gg, Rmo, Rmo, Rmo, Rmo, Rmo, Rmo, Gg^Efm, Gg^Efm, Gg^Efm, Rmo, Rmo, Rmo, Rmo, Rmo
Xmw, Xmw, Xmw, Gg, Rmo, Gg^Efm, Xmw, Xmw, Xmw, Gg, Rmo, Rmo, Rmo, Rmo, Rmo, Gg, Gg, Wwt, Wwt, Gg^Efm, Gg^Efm, Gg^Efm, Wwt, Wwt, Gg, Gg, Rmo, Rmo, Rmo, Rmo, Rmo, Rmo, Rmo, Rmo, Rmo, Rmo, Rmo, Rmo, Rmo, Rmo, Rmo
Xmw, Xmw, Xmw, Gg^Efm, Rmo, Gg^Efm, Xmw, Xmw, Xmw, Gg^Efm, Rmo, Rmo, Rmo, Rmo, Rmo, Rmo, Rmo, Gg, Gg, Wwt, Gg, Wwt, Gg, Gg, Rmo, Rmo, Rmo, Rmo, Rmo, Rmo, Rmo, Rmo, Rmo, Rmo, Gg^Efm, Rmo, Rmo, Rmo, Rmo, Rmo, Rmo
Xmw, Xmw, Xmw, Gg^Efm, Rmo, Gg, Xmw, Xmw, Xmw, Gg^Efm, Rmo, Rmo, Rmo, Rmo, Rmo, Rmo, Rmo, Rmo, Rmo, Gg, Gg, Gg, Rmo, Rmo, Rmo, Rmo, Rmo, Rmo, Rmo, Rmo, Rmo, Rmo, Gg^Efm, Gg^Efm, Xmw, Gg^Efm, Gg^Efm, Rmo, Rmo, Rmo, Rmo
Xmw, Xmw, Xmw, Gg^Efm, Rmo, Gg^Efm, Xmw, Xmw, Xmw, Gg^Efm, Rmo, Rmo, Rmo, Rmo, Rmo, Rmo, Rmo, Rmo, Rmo, Rmo, Rmo, Rmo, Rmo, Rmo, Rmo, Rmo, Rmo, Rmo, Rmo, Rmo, Rmo, Rmo, Gg^Efm, Xmw, Xmw, Xmw, Gg^Efm, Rmo, Rmo, Rmo, Rmo
Xmw, Xmw, Xmw, Gg, Rmo, Gg^Efm, Xmw, Xmw, Xmw, Gg, Rmo, Rmo, Rmo, Rmo, Rmo, Rmo, Rmo, Rmo, Rmo, Rmo, Rmo, Rmo, Rmo, Rmo, Rmo, Rmo, Rmo, Rmo, Rmo, Rmo, Rmo, Rmo, Gg^Efm, Xmw, Xmw, Xmw, Gg^Efm, Rmo, Rmo, Rmo, Rmo
Xmw, Xmw, Xmw, Gg^Efm, Rmo, Gg, Gg, Xmw, Xmw, Gg^Efm, Rmo, Rmo, Rmo, Rmo, Rmo, Rmo, Rmo, Rmo, Gg^Efm, Rmo, Rmo, Rmo, Gg^Efm, Rmo, Rmo, Rmo, Rmo, Rmo, Rmo, Rmo, Rmo, Rmo, Rmo, Gg^Efm, Gg^Efm, Gg^Efm, Rmo, Rmo, Rmo, Rmo, Rmo
Xmw, Xmw, Gg^Efm, Gg^Efm, Rmo, Rmo, Rmo, Gg^Efm, Gg^Efm, Gg^Efm, Rmo, Rmo, Rmo, Rmo, Rmo, Rmo, Gg, Gg^Efm, Xmw, Gg^Efm, Rmo, Gg, Xmw, Gg^Efm, Gg^Efm, Rmo, Rmo, Rmo, Rmo, Rmo, Rmo, Rmo, Rmo, Rmo, Rmo, Rmo, Rmo, Rmo, Rmo, Rmo, Rmo
Gg^Efm, Gg, Rmo, Rmo, Gg, Rmo, Rmo, Rmo, Rmo, Rmo, Rmo, Rmo, Rmo, Rmo, Gg^Efm, Gg^Efm, Xmw, Xmw, Xmw, Gg, Rmo, Gg^Efm, Xmw, Xmw, Xmw, Gg, Gg^Efm, Rmo, Rmo, Rmo, Rmo, Rmo, Rmo, Rmo, Rmo, Rmo, Rmo, Rmo, Rmo, Rmo, Rmo
Rmo, Rmo, Rmo, Gg, Gg^Efm, Gg, Rmo, Rmo, Rmo, Rmo, Rmo, Rmo, Gg, Gg^Efm, Xmw, Xmw, Xmw, Xmw, Xmw, Gg^Efm, Rmo, Gg^Efm, Xmw, Xmw, Xmw, Xmw, Xmw, Gg^Efm, Gg, Rmo, Rmo, Rmo, Rmo, Rmo, Rmo, Rmo, Rmo, Rmo, Rmo, Rmo, Rmo
Rmo, Rmo, Rmo, Gg, Gg, Gg, Rmo, Rmo, Rmo, Rmo, Gg^Efm, Gg^Efm, Xmw, Xmw, Xmw, Xmw, Xmw, Xmw, Xmw, Gg^Efm, Rmo, Gg^Efm, Xmw, Xmw, Xmw, Xmw, Xmw, Xmw, Xmw, Gg^Efm, Gg^Efm, Rmo, Rmo, Rmo, Rmo, Rmo, Rmo, Rmo, Rmo, Rmo, Rmo
Rmo, Rmo, Rmo, Rmo, Rmo, Rmo, Rmo, Rmo, Rmo, Rmo, Gg^Efm, Xmw, Xmw, Xmw, Xmw, Xmw, Xmw, Xmw, Xmw, Gg^Efm, Rmo, Gg, Xmw, Xmw, Xmw, Xmw, Xmw, Xmw, Xmw, Xmw, Gg^Efm, Rmo, Rmo, Rmo, Rmo, Rmo, Rmo, Rmo, Rmo, Rmo, Rmo
