border_size=1
usage=map

Md, Md, Md, Md, Md, Md, Hd, Hd, Hd, Dd, Hd, Dd, Hd, Dd, Dd, Dd, Dd, Dd, Dd, Dd, Dd, Dd, Dd, Dd, Dd, Dd, Dd, Dd, Dd, Dd, Dd, Dd, Dd, Dd, Dd, Dd, Dd, Dd, Dd, Dd, Dd, Dd, Dd, Hd, Hd, Hd, Hd, Hd, Hd, Hd, Hd, Hd, Hd, Hd, Hd, Dd, Hd, Hd, Hd, Dd, Dd, Dd^Ftd, Ss, Ss, Ww, Ww, Ss, Ss, Ss, Ss, Dd^Ftd, Ww, Ss, Ss, Ss, Ss, Ss, Ww, Dd^Ftd, Ss, Ss, Ss, Ss, Ww, Dd^Ftd, Ss, Ww, Ss, Dd^Ftd, Ss, Dd^Ftd, Ss, Ss
Md, Md, Md, Md, Md, Md, Md, Hd, Hd, Hd, Hd, Hd, Hd, Dd, Dd, Dd, Dd, Dd, Dd, Dd, Dd^Esd, Dd, Dd, Dd, Dd, Dd, Dd, Dd, Dd, Dd, Dd, Dd, Dd, Dd, Dd, Dd, Dd, Dd, Dd, Dd, Dd, Dd, Dd, Hd, Hd, Hd, Hd, Hd, Hd, Hd, Hd, Hd, Hd, Hd, Hd, Hd, Hd, Hd, Hd, Dd, Dd, Dd^Ftd, Dd^Ftd, Ss, Ww, Ww, Ss, Ss, Dd^Ftd, Ss, Ww, Ww, Dd^Ftd, Ss, Ss, Ss, Dd^Ftd, Ww, Dd^Ftd, Ss, Dd^Ftd, Ss, Ww, Ww, Ss, Ss, Ss, Ww, Ww, Dd^Ftd, Ss, Ss, Ss
Md, Md, Md, Md, Md, Md, Md, Hd, Hd, Hd, Hd, Hd, Hd, Dd, Hd, Dd, Dd, Dd^Edpp, Dd, Dd, Dd^Esd, Dd, Dd, Dd, Dd, Dd, Dd, Dd, Dd, Dd, Dd, Dd, Dd^Esd, Dd, Dd, Dd, Dd, Dd, Dd, Dd, Dd, Dd, Dd, Hd, Hd, Hd, Hd, Hd, Hd, Hd, Hd, Hd, Hd, Hd, Hd, Hd, Dd, Hd, Dd, Dd, Ss, Ss, Ss, Ss, Ww, Ss, Ss, Dd^Ftd, Ss, Ss^Vhs, Ww, Ss, Ss, Ss, Ww, Ss, Ss, Ww, Ww, Ss, Ss, Ww, Ww, Dd^Ftd, Dd^Ftd, Dd^Ftd, Dd^Ftd, Ss, Ss, Ss, Ss, Dd^Ftd, Ss
Md, Md, Md, Md, Md, Md, Md, Md, Md, Hd, Hd, Hd, Hd, Hd, Hd, Hd, Hd, Dd, Dd, Dd, Dd, Dd, Dd, Dd, Dd, Dd, Dd, Dd, Dd, Dd, Dd, Dd, Dd^Esd, Dd, Dd, Dd, Dd, Dd, Dd, Dd, Dd, Dd, Dd, Dd, Dd, Dd, Hd, Hd, Hd, Hd, Hd, Hd, Hd, Hd, Dd, Dd, Dd, Dd, Dd, Dd, Ss, Ss, Dd^Ftd, Ww, Ss, Dd^Ftd, Ss, Dd^Ftd, Ww, Ww, Dd^Ftd, Ww, Ss, Ss, Ww, Ww, Chs, Ss, Dd^Ftd, Ww, Ss, Ss, Ss, Ss, Ss, Ss, Ss, Dd^Ftd, Ww, Ww, Ww, Ss, Ss
Md, Md, Md, Md, Md, Md, Md, Md, Md, Md, Md, Hd, Hd, Hd, Hd, Hd, Hd, Hd, Hd, Dd^Esd, Dd, Dd, Dd, Dd, Dd, Dd, Dd, Dd, Dd, Dd, Dd, Dd, Hd, Dd, Hd, Hd, Hd, Dd, Dd, Dd, Dd, Dd, Dd, Dd, Dd, Dd, Dd, Hd, Hd, Hd, Hd, Hd, Hd, Hd, Dd, Dd, Dd, Dd, Dd, Dd, Ss, Ss, Ss, Ss, Dd^Ftd, Ww, Dd^Ftd, Dd^Ftd, Ww, Ww, Ss, Ww, Ww, Dd^Ftd, Dd^Ftd, Chs, 3 Khs, Chs, Ss, Dd^Ftd, Dd^Ftd, Ss, Ss^Vhs, Ww, Ww, Dd^Ftd, Ss, Ss^Vhs, Ss, Ss, Ww, Dd^Ftd, Ss
Md, Md, Md, Md, Md, Md, Md, Md, Md, Md, Md, Md, Hd, Hd, Mm, Hd, Hd, Hd, Hd, Dd^Esd, Dd, Dd, Dd, Dd, Dd, Dd, Dd, Dd, Dd, Dd, Hd, Hd, Hd, Hd, Hd, Hd, Hd, Hd, Hd, Dd, Dd, Dd, Dd, Dd, Dd, Dd, Dd, Hd, Hd, Hd, Dd, Dd, Dd, Dd, Dd, Dd, Dd, Dd, Dd, Dd, Dd, Ss, Ss, Ss, Dd^Ftd, Ww, Ww, Dd^Ftd, Ww, Ss, Dd^Ftd, Dd^Ftd, Ww, Ss, Dd^Ftd, Chs, Chs, Chs, Ww, Ss, Ss, Dd^Ftd, Ww, Ww, Ss, Dd^Ftd, Dd^Ftd, Dd^Ftd, Ss, Ss, Ss, Dd^Ftd, Ss
Md, Md, Md, Md, Md, Md, Md, Md, Md, Md, Md, Md, Md, Mm, Md, Hd, Hd, Hd, Hd, Dd^Esd, Dd, Dd, Dd, Dd, Dd, Dd, Dd, Dd, Dd, Dd, Hd, Hd, Hd, Hd, Hd, Hd, Hd, Hd, Hd, Dd, Dd, Dd, Dd, Dd, Dd, Dd^Edp, Dd, Dd, Dd, Dd, Dd, Dd, Dd, Dd, Dd, Dd^Edp, Dd, Dd, Dd, Dd, Dd, Ss, Ss, Dd^Ftd, Dd^Ftd, Ss, Dd^Ftd, Ww, Ww, Ss, Ss, Ss, Ss, Ww, Ww, Ww, Ss^Vhs, Ss, Ww, Ss, Ss, Ss, Ww, Ww, Ss, Ss, Dd^Ftd, Ss, Ss, Ss, Ss, Ss, Dd
Md, Md, Md, Md, Md, Md, Md, Md, Md, Md, Md, Md, Md, Md, Md, Hd, Hd, Hd, Hd, Dd, Dd, Dd, Dd, Dd, Dd, Dd, Dd, Dd, Dd, Dd, Hd, Hd, Hd, Hd, Hd, Hd, Hd, Hd, Hd, Hd, Hd, Dd, Dd, Dd, Dd, Dd, Dd, Dd, Dd, Dd, Dd, Dd, Hd, Dd, Dd, Dd, Dd, Dd, Dd, Dd, Dd, Dd, Ss, Ss, Ss, Ss, Ss^Vhs, Ss, Dd^Ftd, Ww, Dd^Ftd, Dd^Ftd, Ss^Vhs, Ww, Ww, Ss, Ss, Ss, Ww, Ss, Dd^Ftd, Ww, Dd, Ss, Ss, Dd^Ftd, Ss, Ss, Dd, Dd, Dd, Dd, Dd
Md, Md, Md, Md, Md, Md, Md, Md, Md, Md, Md, Md, Md, Md, Md, Md, Hd, Hd, Hd, Hd, Dd, Dd, Dd, Dd^Esd, Dd, Dd, Dd, Dd, Dd, Dd, Dd, Hd, Hd, Hd, Dd, Hd, Dd, Hd, Hd, Hd, Hd, Dd, Dd, Dd, Dd, Dd, Dd, Dd, Dd, Dd, Hd, Hd, Hd, Hd, Hd, Dd, Dd, Dd, Dd, Dd, Dd, Dd, Dd^Ftd, Ss, Dd^Ftd, Ss, Ss, Ss, Ss, Ww, Ww, Ss, Dd^Ftd, Ww, Ww, Dd^Ftd, Dd^Ftd, Dd^Ftd, Ww, Dd^Ftd, Ww, Ww, Dd, Dd, Dd, Dd, Dd, Dd, Dd, Dd, Dd, Dd, Dd
Md, Md, Md, Md, Md, Md, Md, Md, Md, Md, Md, Md, Md, Md, Md, Md, Hd, Hd, Dd, Dd, Dd, Dd, Dd^Esd, Dd^Esd, Dd, Dd, Dd, Dd, Dd, Dd, Dd, Dd, Dd, Dd, Dd, Dd, Dd, Hd, Hd, Hd, Hd, Hd, Hd, Dd, Dd, Dd, Dd, Dd, Dd, Dd, Hd, Hd, Hd, Hd, Hd, Dd, Hd, Dd, Dd, Dd, Dd, Dd, Dd^Ftd, Dd^Ftd, Dd^Ftd, Ss, Dd, Dd, Dd, Dd, Dd, Ww, Ww, Ww, Ww, Dd^Ftd, Ww, Ww, Dd^Ftd, Dd^Ftd, Ww, Dd, Dd, Dd, Dd, Dd, Dd, Dd, Dd, Dd, Dd, Dd, Dd
Md, Md, Md, Md, Md, Md, Md, Md, Md, Md, Md, Md, Md, Md, Md, Md, Hd, Hd, Hd, Dd, Dd, Dd, Dd^Esd, Dd, Dd, Dd, Hd, Dd, Dd, Dd, Dd, Dd, Dd, Dd, Dd, Dd, Dd, Dd, Dd, Hd, Hd, Hd, Hd, Dd, Dd, Dd, Dd, Dd, Dd, Hd, Hd, Hd, Hd, Hd, Hd, Hd, Hd, Hd, Dd, Dd, Dd, Dd^Edpp, Dd, Dd^Ftd, Dd^Ftd, Dd^Ftd, Dd, Dd, Dd, Dd, Dd, Dd, Dd, Dd, Ww, Ww, Ww, Ww, Ww, Ww, Ww, Dd, Dd^Edpp, Dd, Dd^Edpp, Dd, Dd, Dd, Dd, Dd, Dd, Dd, Dd
Md, Md, Md, Md, Md, Md, Md, Md, Md, Md, Md, Md, Md, Md, Hd, Hd, Hd, Hd, Hd, Hd, Dd, Dd, Dd, Dd, Dd^Esd, Hd, Hd, Hd, Dd, Dd, Dd, Dd, Dd, Dd, Dd, Dd, Dd, Dd, Dd, Dd, Hd, Hd, Hd, Hd, Dd, Dd, Dd, Dd^Edp, Dd, Hd, Hd, Hd, Hd, Hd, Hd, Hd, Hd, Hd, Dd, Dd, Dd, Dd, Dd^Edpp, Dd, Dd, Dd, Dd, Dd^Edpp, Dd, Dd, Dd, Dd^Edpp, Dd, Dd, Dd, Ww, Dd^Ftd, Dd^Ftd, Dd^Ftd, Dd^Ftd, Dd, Dd, Dd^Edpp, Dd, Dd, Dd, Dd, Dd, Dd, Dd, Dd, Dd, Dd
Md, Md, Md, Md, Md, Md, Md, Md, Md, Md, Md, Md, Hd, Hd, Hd, Hd, Hd, Hd, Hd, Hd, Dd, Dd, Dd^Esd, Dd^Esd, Dd, Hd, Hd, Hd, Hd, Dd, Hd, Dd, Dd, Dd, Dd, Dd, Dd^Edp, Dd, Dd, Dd, Dd, Hd, Hd, Hd, Dd, Dd, Dd, Dd, Dd, Hd, Hd, Hd, Hd, Hd, Hd, Hd, Hd, Hd, Dd, Dd, Dd, Dd, Dd, Dd, Dd^Edpp, Dd^Edpp, Dd, Dd, Dd^Edpp, Dd^Edpp, Dd, Dd, Dd, Dd, Ww, Ww, Dd^Ftd, Dd^Ftd, Dd^Edpp, Dd^Ftd, Dd, Dd, Dd, Dd, Dd, Dd, Dd, Dd, Dd, Dd, Dd, Dd, Dd
Md, Md, Md, Md, Md, Md, Md, Md, Md, Md, Md, Md, Hd, Hd, Hd, Hd, Hd, Hd, Hd, Dd, Dd^Esd, Dd^Esd, Dd, Dd, Dd, Dd, Dd, Hd, Hd, Hd, Hd, Hd, Dd, Dd, Dd, Dd, Dd, Dd, Dd, Dd, Dd, Hd, Hd, Hd, Dd, Dd, Dd, Dd, Dd, Hd, Hd, Hd, Hd, Hd, Hd, Hd, Hd, Hd, Dd, Dd, Dd, Dd, Dd, Dd, Dd, Dd, Dd, Dd^Edpp, Dd^Edpp, Dd, Dd, Dd, Ww, Ww, Dd, Dd, Dd^Edpp, Dd^Edpp, Dd, Dd, Dd, Dd, Dd, Dd, Dd, Dd, Dd, Dd, Dd, Dd, Dd, Dd, Dd
Md, Md, Md, Md, Md, Md, Md, Md, Md, Md, Hd, Hd, Hd, Hd, Hd, Hd, Hd, Hd, Hd, Hd, Dd, Dd, Dd, Dd, Dd, Dd, Hd, Hd, Hd, Hd, Hd, Hd, Dd, Dd, Dd, Dd, Dd, Dd, Dd, Dd, Dd, Dd, Dd, Dd, Dd, Dd, Dd, Dd, Dd, Hd, Hd, Hd, Hd, Hd, Hd, Hd, Hd, Hd, Hd^Ftd, Dd, Dd, Dd, Ww, Dd, Ww, Dd, Dd, Dd, Dd, Dd, Dd, Dd, Ww, Ww, Dd, Dd, Dd^Edpp, Dd, Dd, Dd, Dd, Dd, Dd, Dd, Dd, Dd, Dd, Dd, Dd, Dd, Dd, Dd, Hd
Md, Md, Md, Md, Md, Md, Md, Md, Md, Md, Hd, Hd, Hd, Hd, Hd, Hd, Dd, Hd, Hd, Hd, Dd, Dd, Dd^Edp, Dd, Hd, Hd, Hd, Hd, Hd, Hd, Hd, Hd, Dd, Dd, Dd, Dd, Hd, Dd, Dd, Dd, Dd, Dd, Dd, Dd, Dd, Dd, Dd, Dd, Dd, Hd, Hd, Hd, Hd, Hd, Dd, Hd, Hd, Hd, Hd^Ftd, Hd^Ftd, Ww, Ww, Ww, Ww, Ww, Dd, Dd^Ftd, Dd, Dd^Ftd, Dd, Ww, Ww, Dd, Dd, Dd^Edpp, Dd, Dd, Dd, Dd, Dd, Dd, Dd, Dd, Dd, Dd, Dd, Dd, Dd, Dd, Dd, Hd, Hd, Hd
Md, Md, Md, Md, Md, Md, Md, Md, Hd, Hd, Hd, Hd, Hd, Hd, Dd, Dd, Dd, Dd, Dd, Dd, Dd, Dd, Dd, Dd, Hd, Hd, Hd, Hd, Hd, Hd, Hd, Hd, Dd, Dd, Dd, Hd, Hd, Hd, Dd, Dd, Dd, Dd, Dd, Dd, Dd, Dd, Dd, Dd, Dd^Esd, Dd, Dd, Dd, Dd, Dd, Dd, Dd, Dd, Hd^Ftd, Hd^Ftd, Ww, Ww, Ww, Ww, Ww, Ww, Ww, Ww, Dd^Ftd, Ww, Ww, Dd, Dd, Dd, Dd, Dd, Dd^Edpp, Dd, Dd, Dd, Dd, Dd, Dd, Dd, Dd, Dd, Dd, Dd, Dd, Hd, Hd, Hd, Hd, Hd
Md, Md, Hd, Hd, Hd, Hd, Hd, Hd, Hd, Hd, Hd, Hd, Hd, Hd, Hd, Dd, Dd, Dd, Dd, Dd, Dd, Dd, Dd, Dd, Dd, Hd, Dd, Dd, Dd, Dd, Dd, Dd, Dd, Dd, Hd, Hd, Hd, Hd, Hd, Hd, Hd, Hd, Hd, Dd, Dd, Dd^Edp, Dd, Dd, Dd^Esd, Dd^Esd, Dd, Dd, Dd, Dd, Dd, Dd, Dd^Edpp, Dd, Ww, Ww, Ww, Ww, Dd^Vda, Ww, Ww, Ww, Ww, Ww, Dd^Ftd, Ww, Dd, Dd, Dd^Edpp, Dd^Edpp, Dd, Dd, Dd, Dd, Dd, Dd, Dd, Dd, Dd, Dd, Dd, Dd, Dd, Hd, Hd, Hd, Hd, Hd, Hd
Hd, Hd, Hd, Hd, Hd, Hd, Hd, Hd, Hd, Hd, Hd, Hd, Hd, Hd, Hd, Hd, Dd, Dd, Dd^Esd, Dd, Hd, Dd, Dd, Dd^Esd, Dd, Dd, Dd, Dd, Hd, Dd, Dd, Dd, Dd, Hd, Hd, Hd, Hd, Hd, Hd, Hd, Hd, Hd, Hd, Hd, Dd, Dd, Dd, Dd, Dd, Dd, Dd, Dd, Dd^Edp, Dd, Dd^Edpp, Dd, Dd, Dd, Dd, Ww, Ww, Ww, Ww, Ww, Ww, Ww, Dd^Ftd, Dd^Ftd, Dd, Dd, Dd, Dd^Edpp, Dd, Dd^Edpp, Dd, Dd, Dd, Dd, Dd, Dd, Dd, Dd, Dd, Dd, Dd, Dd, Dd, Hd, Hd, Hd, Hd, Hd, Hd
Hd, Hd, Hd, Hd, Hd, Hd, Hd, Hd, Hd, Hd, Hd, Hd, Hd, Hd, Hd, Hd, Dd, Dd, Hd, Hd, Hd, Hd, Dd, Dd, Dd, Dd, Dd, Dd, Hd, Hd, Dd, Dd, Dd, Hd, Hd, Hd, Hd, Hd, Hd, Hd, Hd, Hd, Hd, Hd, Dd, Dd, Dd, Dd, Dd, Dd^Edp, Dd, Dd, Dd^Edp, Dd, Dd, Dd^Edpp, Dd^Edpp, Dd^Edpp, Dd, Ww, Ww, Ww, Ww, Ww, Ww, Ww, Dd, Dd^Ftd, Dd, Dd, Dd, Dd, Dd, Dd, Dd, Dd, Dd, Dd, Hd, Dd, Dd, Dd, Dd, Dd, Dd, Dd, Dd, Hd, Hd, Hd, Hd, Hd, Hd
Hd, Hd, Hd, Hd, Dd, Hd, Hd, Hd, Hd, Hd, Hd, Hd, Dd, Dd, Dd, Dd, Dd, Hd, Hd, Hd, Hd, Hd, Dd, Dd, Dd, Dd^Edp, Hd, Hd, Hd, Hd, Dd, Dd, Dd, Dd, Dd, Hd, Hd, Hd, Dd, Hd, Dd, Hd, Hd, Hd, Dd, Dd, Dd, Dd, Dd, Dd^Edp, Dd, Dd, Dd^Edpp, Dd, Dd, Dd, Dd, Dd, Ww, Ww, Dd^Ftd, Dd^Ftd, Dd, Dd, Dd, Dd, Dd, Dd, Dd, Dd, Dd, Dd, Dd, Dd, Dd, Dd, Dd, Hd, Hd, Hd, Dd, Dd, Dd, Dd, Dd, Dd, Dd, Hd, Hd, Hd, Hd, Hd, Hd
Dd, Hd, Hd, Dd, Dd, Dd, Dd, Dd, Dd, Dd, Dd, Dd, Dd, Dd, Dd, Dd, Dd, Hd, Hd, Hd, Hd, Dd, Dd, Dd, Dd, Dd, Hd, Hd, Hd, Hd, Hd, Dd, Dd, Dd, Dd, Dd, Dd, Dd, Dd, Dd, Dd, Hd, Hd, Hd, Dd, Dd, Dd, Dd, Dd, Dd, Dd^Edpp, Dd, Dd, Dd, Dd^Ftd, Dd^Edpp, Dd^Ftd, Dd^Ftd, Ww, Dd^Ftd, Dd^Ftd, Dd^Ftd, Dd, Dd, Hd, Hd, Hd, Dd, Dd, Dd, Dd, Dd, Dd, Dd, Dd, Dd, Dd, Hd, Hd, Hd, Hd, Dd, Dd, Dd, Dd, Dd, Dd, Dd, Hd, Hd, Hd, Hd, Hd
Dd, Dd, Dd, Dd, Dd, Dd, Dd, Dd, Dd, Dd, Dd, Dd^Esd, Dd, Dd, Dd, Dd, Dd, Dd, Hd, Hd, Hd, Dd, Dd, Dd, Dd, Hd, Hd, Hd, Qxua, Hd, Qxua, Dd, Dd, Dd, Dd, Dd, Dd, Dd, Dd^Vdt, Dd, Dd, Dd, Dd, Dd, Dd, Dd, Dd, Dd, Dd, Dd, Dd^Edpp, Dd, Dd^Ftd, Dd^Ftd, Ww, Dd^Ftd, Ww, Dd^Ftd, Ww, Dd^Ftd, Dd^Ftd, Dd^Ftd, Hd, Hd, Hd^Ftd, Hd, Hd, Hd, Hd, Dd, Dd, Dd^Esd, Dd, Dd, Dd^Esd, Dd, Dd, Dd, Hd, Hd, Hd, Dd, Dd, Dd, Dd, Dd, Dd, Dd, Dd, Hd, Hd, Hd, Hd
Hd, Dd, Dd, Dd, Dd, Dd, Dd, Dd, Dd, Dd, Dd, Dd, Dd, Dd^Edp, Dd, Dd, Dd, Dd, Dd, Hd, Dd, Dd, Dd, Dd, Dd, Dd, Qxua, Qxua, Qxua, Qxua, Qxua, Qxua, Qxua, Dd, Dd, Dd, Dd, Dd, Dd, Dd, Dd, Dd, Dd, Dd, Dd, Dd, Hd, Hd, Hd, Dd, Dd, Dd, Dd^Ftd, Ww, Ww, Ww, Dd, Ww, Ww, Dd^Ftd, Hd^Ftd, Hd^Ftd, Hd, Hd^Ftd, Hd^Ftd, Hd^Ftd, Hd^Ftd, Hd, Hd, Dd, Dd, Dd, Dd^Esd, Dd^Esd, Dd^Esd, Dd, Dd, Dd, Hd, Hd, Hd, Hd, Dd, Dd, Dd, Dd, Dd, Dd, Dd, Dd, Dd, Hd, Dd
Dd, Dd, Dd, Dd, Dd, Dd, Dd, Dd, Dd, Dd, Dd, Dd, Dd, Dd, Dd, Dd, Dd, Dd^Edp, Dd, Dd, Dd, Dd, Hd, Dd, Qxua, Qxua, Qxua, Qxua, Qxua, Qxua, Qxua, Qxua, Qxua, Qxua, Qxua, Dd, Dd, Dd, Dd, Dd, Hd, Hd, Hd, Hd, Hd, Hd, Hd, Hd, Hd, Dd, Dd, Dd^Ftd, Ww, Ww, Dd, Dd, Dd^Ftd, Dd, Ww, Hd^Ftd, Hd^Ftd, Hd, Hd^Ftd, Hd^Ftd, Hd^Ftd, Hd^Ftd, Hd^Ftd, Hd^Ftd, Hd, Dd, Dd, Dd, Dd, Dd^Esd, Dd^Esd, Dd, Dd, Dd, Hd, Hd, Hd, Hd, Dd, Dd, Dd, Dd, Dd, Dd, Dd, Dd, Dd, Dd, Dd
Dd, Dd, Dd, Dd, Dd, Dd, Dd, Dd, Dd, Dd, Dd, Dd, Dd, Dd, Dd, Dd, Dd, Dd, Dd, Dd, Hd, Hd, Hd, Hd, Qxua, Qxua, Qxua, Qxua, Qxua, Qxua, Qxua, Qxua, Qxua, Qxua, Qxua, Qxua, Qxua, Dd, Dd, Dd, Hd, Hd, Hd, Hd, Hd, Hd, Hd, Hd, Hd, Dd, Dd, Dd^Ftd, Ww, Ww, Dd, Dd^Ftd, Dd^Ftd, Dd, Ww, Hd^Ftd, Hd^Ftd, Hd^Ftd, Hd^Ftd, Hd^Ftd, Hd^Ftd, Hd^Ftd, Hd^Ftd, Hd^Ftd, Hd, Hd, Hd, Dd, Dd, Dd, Dd, Dd, Dd, Dd, Hd, Hd, Hd, Dd, Dd, Dd, Dd, Dd, Dd, Dd, Dd, Dd, Dd, Dd, Dd
Dd, Dd, Dd^Esd, Dd, Dd, Dd, Dd, Dd, Dd, Dd, Hd, Dd, Dd, Dd, Dd^Esd, Dd^Esd, Dd^Esd, Dd^Esd, Dd^Esd, Hd, Hd, Hd, Qxua, Qxua, Qxua, Qxua, Qxua, Qxua, Qxua, Qxua, Qxua, Qxua, Qxua, Qxua, Qxua, Qxua, Qxua, Dd, Dd, Dd, Hd, Hd, Hd, Hd, Hd, Hd, Dd, Hd, Dd, Dd, Dd^Ftd, Dd, Dd^Ftd, Ww, Ww, Dd, Dd, Dd, Ww, Hd^Ftd, Hd^Ftd, Hd^Ftd, Hd^Ftd, Hd^Ftd, Hd^Ftd, Hd, Hd, Hd, Hd, Hd, Hd, Dd, Dd, Dd, Dd, Dd, Dd, Dd, Dd, Hd, Dd, Dd, Dd, Dd, Dd, Dd, Dd, Dd, Dd, Dd, Dd, Dd, Dd
Dd, Dd, Dd^Esd, Dd, Dd, Dd, Dd, Dd, Hd, Hd, Hd, Hd, Dd, Dd, Dd^Esd, Dd, Dd, Dd, Hd, Hd, Hd, Qxua, Qxua, Qxua, Qxua, Qxua, Qxua, Qxua, Qxua, Qxua, Qxua, Qxua, Qxua, Qxua, Qxua, Qxua, Qxua, Dd, Dd, Dd, Dd, Hd, Dd, Hd, Dd, Dd, Dd, Dd, Dd, Dd^Edpp, Dd^Edpp, Dd, Dd^Ftd, Ww, Ww, Ww, Ww, Ww, Dd^Ftd, Hd^Ftd, Hd, Hd, Hd, Hd^Ftd, Hd, Hd, Hd, Dd, Dd, Hd, Dd, Dd, Dd, Dd, Dd, Dd, Dd, Dd, Dd, Dd, Dd, Dd, Dd, Dd, Dd, Dd, Dd, Dd, Dd, Dd, Dd, Dd, Dd
Dd, Dd, Dd, Dd^Esd, Dd, Dd^Esd, Hd, Hd, Hd, Hd, Hd, Hd, Dd, Dd, Dd, Dd^Esd, Dd^Esd, Dd^Esd, Hd, Hd, Hd, Qxua, Qxua, Qxua, Qxua, Qxua, Qxua, Qxua, Qxua, Qxua, Qxua, Qxua, Qxua, Qxua, Qxua, Qxua, Qxua, Dd, Dd, Dd, Dd, Dd, Dd, Dd, Dd, Dd, Dd, Dd^Vdt, Dd, Dd, Dd, Dd^Edpp, Dd^Edpp, Dd^Ftd, Dd^Ftd, Ww, Dd^Ftd, Dd^Ftd, Dd^Ftd, Dd^Ftd, Dd, Hd, Hd, Hd, Dd, Hd, Dd, Dd, Dd, Dd, Dd, Dd, Dd, Dd, Dd, Dd, Dd, Dd, Dd, Dd, Dd, Dd, Dd, Dd, Dd, Dd, Dd, Dd, Dd, Dd, Dd, Dd, Dd
Dd, Dd, Dd, Dd, Dd, Dd, Hd, Hd, Hd, Hd, Dd, Dd, Dd, Dd, Dd, Dd, Dd, Hd, Hd, Hd, Qxua, Qxua, Qxua, Qxua, Qxua, Qxua, Qxua, Qxua, Qxua, Qxua, Qxua, Qxua, Qxua, Qxua, Qxua, Qxua, Qxua, Qxua, Dd, Dd, Dd, Dd, Dd, Dd, Dd, Dd, Dd, Dd, Dd, Dd, Hd, Hd, Hd, Dd, Dd^Ftd, Dd^Edpp, Dd, Dd^Edpp, Dd^Ftd, Dd^Ftd, Dd, Dd, Dd, Dd, Dd, Dd, Dd, Dd, Dd, Dd, Hd, Hd, Hd, Dd, Hd, Dd, Dd, Dd, Hd, Dd, Dd, Dd, Dd, Dd, Dd, Dd, Dd, Dd, Dd, Dd, Dd, Dd, Dd
Dd, Dd, Dd, Dd, Dd, Hd, Hd, Hd, Hd, Dd, Dd, Dd, Dd, Dd, Dd, Dd, Dd, Hd, Hd, Hd, Qxua, Qxua, Qxua, Qxua, Qxua, Qxua, Qxua, Qxua, Qxua, Qxua, Qxua, Qxua, Qxua, Qxua, Qxua, Qxua, Qxua, Qxua, Dd, Dd, Dd, Dd^Vdt, Dd, Dd, Dd^Edpp, Dd^Edpp, Dd^Edpp, Dd, Dd, Hd, Hd, Hd, Hd, Dd, Dd, Dd, Md, Dd, Dd^Ftd, Dd^Ftd, Dd, Dd, Dd, Dd, Dd, Dd, Dd, Dd, Dd, Dd, Hd, Hd, Hd, Hd, Hd, Hd, Hd, Hd, Hd, Hd, Dd, Dd, Dd, Dd, Dd, Dd, Dd, Dd, Dd, Dd, Dd, Dd, Dd
Dd, Dd, Dd, Dd, Dd, Hd, Hd, Hd, Hd, Hd, Hd, Dd, Dd, Dd, Dd, Dd^Edp, Dd, Hd, Hd, Qxua, Qxua, Qxua, Qxua, Qxua, Qxua, Qxua, Qxua, Qxua, Qxua, Qxua, Qxua, Qxua, Qxua, Qxua, Qxua, Qxua, Qxua, Qxua, Dd, Dd, Dd^Edpp, Dd, Dd, Dd^Edpp, Dd^Edpp, Dd^Edpp, Dd, Dd, Hd, Hd, Hd, Hd, Dd, Dd, Hd, Md, Md^Xm, Md, Md, Dd, Hd, Hd, Hd, Dd, Dd, Dd^Esd, Dd^Esd, Dd^Esd, Dd, Dd, Dd, Hd, Hd, Hd, Hd, Hd, Hd, Hd, Hd, Hd, Dd, Dd, Dd, Dd, Dd, Dd, Dd, Dd, Dd, Dd, Dd^Vdt, Dd, Dd
Dd, Dd, Dd, Dd, Dd, Hd, Hd, Hd, Hd, Hd, Hd, Dd, Dd, Dd, Dd, Dd, Dd, Hd, Hd, Qxua, Qxua, Qxua, Qxua, Qxua, Qxua, Qxua, Qxua, Qxua, Qxua, Qxua, Qxua, Qxua, Qxua, Qxua, Qxua, Qxua, Qxua, Qxua, Dd, Dd, Dd, Dd, Dd, Dd^Do, Dd^Edpp, Dd^Edpp, Dd, Dd, Hd, Hd, Hd, Hd, Hd, Hd, Hd, Md, Md, Md^Xm, Md, Md, Hd, Hd, Hd, Dd, Dd, Dd, Dd^Esd, Dd, Dd^Esd, Dd, Dd, Hd, Hd, Hd, Hd, Hd, Hd, Hd, Hd, Hd, Hd, Dd, Dd, Dd, Dd, Dd^Vdt, Dd, Dd, Dd, Dd, Dd, Dd, Dd
Dd, Dd, Dd, Dd, Dd, Dd, Dd, Hd, Hd, Hd, Hd, Dd^Esd, Hd, Dd, Dd, Dd, Dd, Dd, Dd, Hd, Qxua, Qxua, Qxua, Qxua, Qxua, Qxua, Qxua, Qxua, Qxua, Qxua, Qxua, Qxua, Qxua, Qxua, Qxua, Qxua, Qxua, Dd, Dd, Dd, Cd, Dd, Dd, Dd^Edpp, Dd, Dd, Dd^Vdt, Dd, Dd, Hd, Hd, Hd, Hd, Hd, Hd, Hd, Md, Md^Xm, Md^Xm, Md, Hd, Hd, Hd, Hd, Hd, Dd, Dd, Dd^Esd, Dd, Dd, Dd, Hd, Hd, Hd, Hd, Hd, Hd, Hd, Hd, Hd, Hd, Dd, Dd, Dd, Dd, Dd, Dd, Dd, Ce, Dd, Dd, Dd, Dd
Dd, Dd, Dd, Dd, Dd, Dd, Dd, Hd, Hd, Hd, Hd, Hd, Hd, Hd, Dd, Dd, Dd, Dd, Dd, Dd, Dd, Qxua, Qxua, Qxua, Qxua, Qxua, Qxua, Qxua, Qxua, Qxua, Qxua, Qxua, Qxua, Qxua, Qxua, Qxua, Dd, Dd, Cd, Dd, Cd, Dd, Cd, Dd, Dd, Dd, Dd, Dd, Dd^Edpp, Hd, Hd, Hd, Hd, Hd, Hd, Hd, Hd, Md, Md^Xm, Md, Hd, Hd, Hd, Hd, Hd, Dd, Dd, Dd, Dd, Dd, Dd, Hd, Hd, Hd, Hd, Hd, Hd, Hd, Hd, Hd, Hd, Dd, Dd, Dd, Dd, Dd, Dd, Ce, 1 Ke, Ce, Dd, Dd, Dd
Dd, Dd, Dd, Dd, Dd, Dd, Dd, Dd, Hd, Hd, Hd, Hd, Hd, Hd, Dd, Dd, Dd, Dd, Dd, Dd, Dd, Qxua, Qxua, Qxua, Qxua, Qxua, Qxua, Qxua, Qxua, Qxua, Qxua, Qxua, Qxua, Qxua, Qxua, Qxua, Dd, Dd, Dd, Cd, 2 Kd, Cd, Dd^Esd, Dd, Dd, Dd, Dd, Dd^Edpp, Dd^Edpp, Dd^Edpp, Dd, Dd, Dd, Hd, Hd, Hd, Hd, Md, Md^Xm, Md, Md, Hd, Hd, Hd, Hd, Dd, Dd, Dd, Dd, Dd, Dd, Hd, Hd, Hd, Hd, Dd, Dd, Dd, Dd, Hd, Dd, Dd, Dd, Dd, Dd, Dd, Dd, Ce, Ce, Ce, Dd, Dd, Dd
Dd, Dd, Dd, Dd, Dd, Dd, Dd, Dd, Hd, Hd, Hd, Hd, Hd, Hd, Dd, Dd, Dd, Dd, Dd, Dd, Hd, Hd, Hd, Qxua, Qxua, Qxua, Qxua, Qxua, Qxua, Qxua, Qxua, Qxua, Qxua, Qxua, Qxua, Qxua, Dd, Dd, Cd, Cd, Cd, Cd, Cd, Dd, Dd, Dd, Dd, Dd^Do, Dd^Edpp, Dd^Edpp, Dd, Dd, Hd, Hd, Hd, Hd, Hd, Md, Md^Xm, Md, Md, Hd, Hd, Hd, Hd, Hd, Hd, Dd, Dd, Dd, Dd, Dd, Dd, Hd, Dd, Dd, Dd, Dd, Dd, Dd, Dd, Dd, Dd, Dd, Dd^Vdt, Dd, Dd, Dd, Dd, Dd, Dd, Dd, Dd
Dd, Dd, Dd, Dd, Dd, Dd^Edp, Dd, Dd, Dd, Hd, Dd, Dd, Dd, Dd, Dd, Dd, Dd, Dd, Dd, Dd, Dd, Hd, Hd, Qxua, Qxua, Qxua, Qxua, Qxua, Qxua, Qxua, Qxua, Qxua, Qxua, Qxua, Dd, Dd, Dd, Dd, Dd, Dd, Cd, Dd, Dd, Dd, Dd, Dd, Dd^Edpp, Dd^Edpp, Dd, Dd^Edpp, Dd, Hd, Hd, Hd, Hd, Hd, Md, Md, Md^Xm, Md, Md, Hd, Hd, Hd, Hd, Hd, Hd, Dd, Dd, Dd, Dd, Dd, Dd, Dd, Dd, Dd, Dd, Dd, Dd, Dd, Dd, Dd, Dd, Dd, Dd, Dd, Dd, Dd, Dd, Dd, Dd, Dd, Dd
Hd, Dd, Hd, Dd, Dd, Dd, Dd, Dd, Dd^Esd, Dd^Esd, Dd, Dd, Dd, Dd, Dd, Dd, Dd, Dd, Dd, Dd, Dd, Hd, Hd, Qxua, Qxua, Qxua, Qxua, Qxua, Qxua, Qxua, Qxua, Qxua, Qxua, Dd, Dd, Dd, Dd, Dd, Dd, Dd, Dd, Dd, Dd, Dd, Dd, Dd^Edpp, Dd^Vdt, Dd, Dd, Dd, Dd, Hd, Hd, Hd, Hd, Md, Md^Xm, Md^Xm, Md, Md, Md, Md, Hd, Hd, Hd, Hd, Hd, Hd, Hd, Dd, Dd, Dd, Dd, Dd, Dd, Dd, Dd, Dd, Dd, Dd, Dd, Dd, Dd, Dd, Dd, Dd, Dd, Dd^Vdt, Dd, Dd, Dd^Vdt, Dd, Dd
Hd, Hd, Hd, Hd, Dd, Dd, Dd, Dd, Dd, Dd, Dd, Dd, Dd, Dd, Hd, Dd, Hd, Hd, Hd, Dd, Dd, Hd, Hd, Hd, Hd, Qxua, Qxua, Qxua, Qxua, Qxua, Qxua, Qxua, Dd, Dd, Dd, Dd, Dd^Vdt, Dd, Dd, Dd, Dd, Dd, Dd, Dd^Vdt, Dd, Dd^Edpp, Dd^Edpp, Dd, Dd, Dd, Hd, Hd, Hd, Hd, Hd, Md, Md, Md^Xm, Md, Md, Md, Md, Hd, Hd, Hd, Hd, Hd, Hd, Hd, Dd, Dd, Dd, Dd, Dd, Dd, Dd, Dd, Dd, Dd, Dd, Dd, Dd^Esd, Dd, Dd, Dd, Dd, Dd, Dd, Dd, Dd, Dd, Dd, Dd
Hd, Hd, Hd, Hd, Dd, Dd, Dd, Dd, Dd, Dd, Dd, Dd, Dd, Hd, Hd, Hd, Hd, Hd, Hd, Dd, Dd, Dd, Dd, Hd, Hd, Qxua, Qxua, Qxua, Qxua, Qxua, Dd, Dd, Dd, Dd^Edpp, Dd^Edpp, Dd, Dd, Dd, Dd, Dd, Hd, Dd, Dd, Dd, Dd^Do, Dd^Edpp, Dd^Edpp, Dd, Hd, Hd, Hd, Hd, Hd, Md, Md, Md, Md^Xm, Md^Xm, Md, Md, Md, Hd, Hd, Hd, Hd, Hd, Dd, Hd, Dd, Dd, Dd, Dd, Dd, Dd, Dd, Dd, Dd, Dd, Dd, Dd, Dd, Dd, Dd, Dd, Dd, Dd, Dd, Dd, Dd, Dd, Dd, Dd, Dd
Hd, Hd, Hd, Hd, Dd, Dd, Dd, Dd, Dd, Dd, Dd, Dd, Hd, Hd, Hd, Hd, Hd, Hd, Hd, Dd, Hd, Dd, Dd, Dd, Dd, Qxua, Qxua, Qxua, Qxua, Dd, Dd, Dd, Dd^Edpp, Dd^Do, Dd^Edpp, Dd, Dd, Dd, Hd, Dd, Hd, Dd, Hd, Dd, Dd^Edpp, Dd, Dd, Dd, Hd, Hd, Hd, Hd, Md, Md, Md, Md^Xm, Md, Md^Xm, Md, Md, Md, Hd, Hd, Hd, Hd, Dd, Dd, Dd, Dd, Dd, Dd, Dd, Dd, Dd, Dd^Esd, Dd, Dd, Dd, Dd, Dd^Edp, Dd, Dd, Dd, Dd^Esd, Dd^Esd, Dd, Dd, Dd, Dd, Dd, Dd, Dd, Dd
Dd, Hd, Dd, Dd, Dd, Dd, Dd, Dd, Dd, Dd, Dd, Dd, Hd, Hd, Hd, Hd, Hd, Hd, Hd, Hd, Hd, Hd, Dd, Dd, Dd, Dd, Dd, Qxua, Dd, Dd, Dd, Dd^Edpp, Dd, Dd^Edpp, Dd, Dd, Dd, Dd, Hd, Dd, Dd, Dd, Hd, Dd, Dd, Dd, Hd, Hd, Md, Md, Md, Md, Md, Md, Md^Xm, Md, Md^Xm, Md, Md, Md, Md, Hd, Hd, Hd, Dd, Dd, Dd, Dd, Dd, Dd, Dd, Dd, Dd, Dd, Dd, Dd^Esd, Dd, Dd, Dd, Dd, Dd, Dd^Esd, Dd, Dd, Dd, Dd^Esd, Dd^Esd, Dd, Dd, Dd, Dd, Dd, Dd
Dd, Dd, Dd, Dd, Dd, Dd^Edp, Dd, Dd, Dd, Dd, Dd, Dd, Dd, Hd, Hd, Hd, Hd, Hd, Hd, Hd, Hd, Hd, Dd, Dd, Dd, Dd, Dd, Dd, Dd, Dd, Dd^Edpp, Dd, Dd^Vdt, Dd, Dd, Dd, Dd, Dd, Hd, Dd, Hd, Hd, Hd, Dd, Hd, Hd, Hd, Hd, Md, Md, Md, Md, Md^Xm, Md, Md, Md^Xm, Md, Md, Md, Md, Hd, Hd, Hd, Hd, Dd, Dd, Dd, Dd, Dd, Dd, Dd, Dd, Dd, Dd, Dd, Dd, Dd, Dd, Dd, Dd, Dd^Esd, Dd, Dd^Esd, Dd, Dd, Dd, Dd^Esd, Dd, Dd, Dd, Dd, Dd, Dd
Dd, Dd, Dd, Dd, Dd, Dd, Dd, Dd, Dd, Dd, Dd, Dd, Dd, Dd, Dd, Hd, Dd, Hd, Hd, Hd, Hd, Hd, Dd, Dd, Dd, Dd, Dd, Dd, Dd, Dd, Dd^Do, Dd^Edpp, Dd, Dd, Dd, Dd, Dd, Dd, Hd, Hd, Hd, Hd, Hd, Hd, Hd, Hd, Md, Md, Md^Xm, Md, Md^Xm, Md^Xm, Md, Md, Md^Xm, Md^Xm, Md, Md, Hd, Hd, Hd, Hd, Hd, Hd, Dd, Dd, Dd, Dd, Dd, Dd, Dd, Dd, Dd, Dd^Esd, Dd, Dd, Dd, Dd, Dd, Dd, Dd^Esd, Dd, Dd, Dd, Dd, Dd, Dd^Esd, Dd, Dd, Dd, Dd, Dd, Dd
Hd, Dd, Dd, Dd, Dd, Dd, Dd, Dd, Dd, Dd, Dd, Dd, Dd, Dd, Dd, Dd, Dd, Hd, Hd, Hd, Dd, Dd, Dd, Dd, Dd, Dd, Dd, Dd, Dd, Dd, Dd^Edpp, Dd^Edpp, Dd, Dd, Hd, Hd, Hd, Hd, Hd, Hd, Hd, Hd, Hd, Hd, Hd, Hd, Md, Md, Md^Xm, Md^Xm, Md, Md, Md, Md, Md, Md, Md, Hd, Hd, Hd, Hd, Hd, Hd, Hd, Dd, Dd, Dd, Dd, Dd, Dd, Dd, Dd, Dd, Dd, Dd, Dd, Dd, Dd, Dd, Dd, Dd, Dd, Dd, Dd, Dd^Edp, Dd, Dd, Dd, Dd, Dd, Dd, Dd, Hd
Hd, Hd, Hd, Hd, Hd, Hd, Hd, Dd, Dd, Dd, Dd, Dd, Dd^Edp, Dd, Dd, Dd, Dd, Dd, Dd, Dd, Dd, Dd, Dd, Dd, Dd, Dd, Dd, Dd, Dd, Dd, Dd, Dd, Dd, Dd, Dd, Hd, Hd, Hd, Hd, Hd, Hd, Hd, Hd, Hd, Hd, Hd, Md, Md^Xm, Md^Xm, Md, Md, Md, Md, Md, Hd, Md, Hd, Hd, Hd, Hd, Hd, Hd, Dd, Hd, Dd, Dd, Dd, Dd, Dd, Dd, Dd, Dd, Dd, Dd, Dd, Dd, Dd, Dd^Edp, Dd, Dd, Dd, Dd, Dd, Dd, Dd, Dd, Dd, Dd, Dd, Dd, Dd, Hd, Hd
Hd, Hd, Hd, Hd, Hd, Hd, Hd, Hd, Hd, Dd, Dd, Dd, Dd, Dd, Dd, Dd, Dd, Dd, Dd, Dd, Dd, Dd, Dd, Dd, Hd, Dd, Hd, Hd, Hd, Dd, Dd, Dd, Dd, Dd, Dd, Dd, Hd, Hd, Dd, Hd, Dd, Hd, Hd, Hd, Md, Md, Md^Xm, Md^Xm, Md, Md, Md, Md, Hd, Hd, Hd, Hd, Dd, Hd, Hd, Hd, Dd, Dd, Dd, Dd, Dd, Dd, Dd, Dd, Dd, Dd, Dd, Dd, Dd, Dd, Dd, Dd, Dd, Dd, Dd, Dd, Dd, Dd, Dd, Dd, Dd, Dd, Dd, Dd, Dd, Dd, Hd, Hd, Hd
Hd, Hd, Hd, Hd, Hd, Hd, Hd, Hd, Hd, Hd, Hd, Dd, Dd, Dd, Dd, Dd, Dd, Dd, Dd, Dd, Dd, Dd, Hd, Hd, Hd, Hd, Hd, Hd, Hd, Dd, Dd, Dd, Dd, Dd^Vdt, Dd, Dd, Dd, Dd, Dd, Dd, Dd, Hd, Hd, Md, Md, Md, Md^Xm, Md^Xm, Md, Md, Md, Hd, Hd, Hd, Hd, Dd, Dd, Hd, Dd, Dd, Dd, Dd, Dd, Dd, Dd, Dd, Dd, Dd, Dd, Dd, Dd, Dd, Dd, Dd, Dd, Dd, Dd, Dd, Dd, Dd, Dd, Dd, Dd^Edp, Dd, Dd, Dd, Dd, Dd, Dd, Hd, Hd, Hd, Hd
Hd, Hd, Hd, Hd, Md, Hd, Hd, Hd, Hd, Hd, Hd, Hd, Dd, Dd, Dd, Dd, Dd, Dd, Dd, Dd, Hd, Hd, Hd, Hd, Hd, Hd, Hd, Hd, Dd, Dd, Dd, Dd, Dd, Dd, Dd, Dd, Dd, Dd, Dd, Dd, Dd, Hd, Hd, Md, Md, Md^Xm, Md^Xm, Md, Md, Md, Md, Hd, Hd, Hd, Dd, Dd, Dd, Dd, Dd, Dd, Dd, Dd, Dd, Dd, Dd, Dd, Dd, Dd, Dd^Vdt, Dd, Dd, Dd, Hd, Dd, Hd, Hd, Hd, Dd, Dd, Dd, Dd, Dd, Dd, Dd, Dd, Dd, Dd, Dd, Dd, Hd, Hd, Hd, Dd
Md, Md, Md, Md, Md, Md, Md, Hd, Hd, Hd, Hd, Hd, Hd, Dd, Dd, Dd, Dd^Edp, Dd, Dd, Hd, Hd, Hd, Hd, Hd, Hd, Hd, Hd, Hd, Hd, Dd, Dd, Dd, Dd, Dd, Dd, Dd, Dd, Dd, Dd, Dd, Dd, Hd, Hd, Md, Md, Md^Xm, Md, Md, Md, Md, Md, Hd, Hd, Hd, Dd, Dd, Dd, Dd, Dd, Dd, Dd, Dd, Dd, Dd, Dd, Dd, Dd, Dd, Dd, Dd, Hd, Hd, Hd, Hd, Hd, Hd, Hd, Dd, Dd, Dd, Dd, Dd, Dd, Dd, Dd, Dd, Dd, Dd, Dd, Hd, Hd, Hd, Hd
Md, Md, Md, Md, Md, Md, Md, Hd, Hd, Hd, Hd, Hd, Hd, Hd, Dd, Dd, Dd, Dd, Dd, Hd, Hd, Hd, Hd, Hd, Hd, Hd, Hd, Hd, Hd, Dd, Dd, Dd, Dd, Dd, Dd, Dd, Hd, Dd, Hd, Hd, Hd, Hd, Hd, Md, Md, Md, Md, Md, Md, Md, Hd, Hd, Hd, Hd, Dd, Dd, Dd, Dd, Dd, Dd, Dd, Dd, Dd, Dd, Dd, Dd, Dd, Dd, Dd, Dd, Hd, Hd, Hd, Hd, Hd, Hd, Dd, Dd, Dd, Dd, Dd, Dd, Dd, Dd, Dd, Dd, Hd, Dd, Hd, Hd, Hd, Hd, Hd
Md, Md, Md, Md, Md, Md, Md, Hd, Hd, Hd, Hd, Hd, Dd, Dd, Dd, Dd, Dd, Dd, Dd, Dd, Dd, Hd, Dd, Hd, Dd, Hd, Hd, Hd, Hd, Dd, Dd, Dd, Dd, Dd, Hd, Hd, Hd, Hd, Hd, Hd, Hd, Hd, Hd, Hd, Hd, Md, Md, Md, Md, Md, Md, Hd, Hd, Hd, Dd, Dd, Dd, Dd, Dd, Dd, Dd, Dd, Dd^Vdt, Dd, Dd, Dd, Dd, Dd, Dd, Dd, Hd, Hd, Hd, Hd, Hd, Hd, Hd, Dd, Dd, Dd, Dd, Dd, Dd, Dd, Hd, Hd, Hd, Hd, Hd, Hd, Hd, Hd, Dd
Md, Md, Md, Md, Md, Md, Md, Hd, Hd, Hd, Dd, Dd, Rd, Dd, Hd, Hd, Hd, Dd, Dd, Dd, Dd, Dd, Dd, Dd, Dd, Dd, Dd, Hd, Dd, Dd, Dd, Dd, Dd, Dd, Hd, Hd, Hd, Hd, Hd, Hd, Hd, Hd, Hd, Hd, Hd, Md, Md, Md, Md, Md, Hd, Hd, Hd, Dd, Dd, Dd, Dd, Dd, Dd, Dd, Dd, Dd, Dd, Dd, Dd, Dd, Dd, Dd, Dd, Dd, Hd, Hd, Hd, Hd, Hd, Hd, Hd, Dd, Dd, Dd, Dd, Dd, Dd, Hd, Hd, Hd, Hd, Hd, Dd, Hd, Dd, Dd, Dd
Md, Md, Md, Md, Md, Md, Md, Md, Md, Dd, Dd, Rd, Dd, Dd, Hd, Hd, Hd, Dd, Dd, Dd, Dd, Dd, Dd, Dd, Dd, Dd, Dd, Dd, Dd, Dd, Dd, Dd, Dd, Hd, Hd, Hd, Hd, Hd, Hd, Hd, Hd, Hd, Hd, Hd, Hd, Md, Md, Md^Xm, Md, Md, Md, Md, Hd, Hd, Hd, Dd, Dd, Dd, Dd, Dd, Dd, Dd, Dd, Dd, Dd, Dd, Dd, Dd, Dd, Dd, Hd, Hd, Hd, Hd, Hd, Hd, Dd, Dd, Dd, Dd, Hd, Dd, Hd, Hd, Hd, Hd, Dd, Dd, Dd, Dd, Dd, Dd, Dd
Md, Md, Md, Md, Md, Md, Md, Md, Md, Dd, Rd, Rd, Hd, Hd, Hd, Hd, Dd, Dd, Dd, Dd, Dd, Dd, Dd, Dd, Dd, Dd, Dd^Edp, Dd, Dd, Dd, Hd, Hd, Hd, Hd, Hd, Hd, Hd, Hd, Hd, Hd, Hd, Hd, Hd, Hd, Hd, Md, Md, Md^Xm, Md^Xm, Md, Md, Md, Md, Hd, Hd, Hd, Hd, Dd, Dd, Dd, Dd, Dd, Dd, Dd, Dd, Dd, Dd, Dd, Dd, Hd, Hd, Hd, Hd, Hd, Dd, Dd, Dd, Dd, Hd, Hd, Hd, Hd, Hd, Hd, Hd, Dd, Dd, Dd, Dd, Dd, Hd, Hd, Hd
Md, Md, Md, Md, Md, Md, Md, Md, Dd, Dd, Dd, Dd, Hd, Hd, Hd, Hd, Hd, Dd, Dd, Dd, Dd, Dd^Edp, Dd, Dd, Dd, Dd, Dd, Dd, Dd, Dd, Hd, Hd, Hd, Hd, Hd, Hd, Dd, Dd, Hd, Hd, Hd, Hd, Hd, Hd, Hd, Md, Md, Md, Md^Xm, Md, Md, Md, Md, Md, Hd, Hd, Hd, Dd, Dd, Dd, Dd, Dd, Dd, Dd, Dd, Dd, Dd, Dd, Dd, Hd, Hd, Hd, Dd, Dd, Dd, Dd, Dd, Dd, Hd, Hd, Hd, Hd, Dd, Hd, Dd, Dd, Dd, Dd, Dd, Hd, Hd, Hd, Hd
Md, Md, Md, Md, Dd, Dd, Dd, Dd, Rd, Dd, Md, Md, Md, Hd, Hd, Hd, Hd, Dd, Dd, Dd, Dd, Dd, Dd, Dd, Dd, Dd, Dd, Dd, Dd, Dd, Hd, Hd, Hd, Hd, Dd, Dd, Dd, Dd, Dd, Hd, Hd, Hd, Hd, Hd, Dd, Hd, Md, Md, Md, Md^Xm, Md^Xm, Md^Xm, Md, Md, Md, Hd, Hd, Hd, Dd, Dd, Dd, Dd, Dd, Dd, Dd, Dd, Dd, Dd, Dd, Hd, Hd, Hd, Dd, Dd, Dd, Dd, Dd, Dd, Hd, Hd, Hd, Dd, Dd, Dd, Dd, Dd, Hd, Hd, Hd, Hd, Hd, Hd, Dd
Md, Md, Dd, Dd, Dd, Dd, Rd, Rd, Dd, Dd, Md, Md, Md, Hd, Hd, Hd, Hd, Dd, Dd, Dd, Dd, Dd, Dd, Dd, Dd, Dd, Dd, Dd, Dd, Dd, Dd, Hd, Dd, Dd, Dd, Dd, Dd, Dd, Dd, Dd, Dd, Hd, Dd, Dd, Dd, Hd, Hd, Md, Md, Md, Md, Md^Xm, Md^Xm, Md, Md, Md, Hd, Hd, Dd, Dd, Dd, Dd^Vdt, Dd, Dd, Dd, Dd, Dd, Dd, Dd, Dd, Dd, Dd, Dd, Dd^Edp, Dd, Dd, Dd, Dd, Hd, Hd, Hd, Dd, Dd, Dd, Hd, Hd, Hd, Hd, Hd, Hd, Hd, Dd, Dd
Dd, Dd, Rd, Dd, Rd, Dd, Rd, Rd, Dd, Dd, Md, Md, Md, Hd, Hd, Hd, Hd, Hd, Hd, Dd, Dd, Dd, Dd, Dd, Dd, Dd^Edp, Dd, Dd, Dd, Dd, Dd, Dd, Dd, Dd, Dd, Dd, Dd, Dd^Edp, Dd, Dd, Dd, Dd, Dd, Dd, Dd, Dd, Hd, Hd, Md, Md, Md, Md, Md^Xm, Md, Md, Md, Hd, Hd, Dd, Dd, Dd, Dd, Dd, Dd, Dd, Dd, Dd, Dd, Dd, Dd, Dd, Dd, Dd, Dd, Dd, Dd, Dd, Hd, Hd, Hd, Dd, Dd^Edp, Dd, Dd, Hd, Hd, Hd, Hd, Dd, Hd, Dd, Dd, Dd
Rd, Rd, Rd, Rd, Dd, Rd, Dd, Dd, Md, Md, Md, Md, Md, Hd, Hd, Hd, Hd, Hd, Hd, Dd, Hd, Dd, Dd, Dd, Dd, Dd, Dd, Dd, Dd, Dd, Dd, Dd, Dd, Dd, Dd, Dd, Dd, Dd, Dd, Dd, Dd, Dd, Dd^Edp, Dd, Dd, Hd, Hd, Md, Md, Md, Md, Md, Md^Xm, Md, Md, Md, Hd, Hd, Dd, Dd, Dd^Edp, Dd, Dd, Dd, Dd, Dd, Dd, Dd, Dd^Vdt, Dd, Dd, Dd, Dd, Dd, Dd, Dd, Dd, Hd, Hd, Hd, Hd, Dd, Dd, Dd, Dd, Hd, Hd, Hd, Hd, Dd, Hd, Dd, Dd
Dd, Dd, Dd, Dd, Md, Md, Md, Md, Md, Md, Md, Md, Md, Md, Hd, Hd, Hd, Hd, Hd, Hd, Hd, Hd, Hd, Dd, Dd, Dd, Dd, Dd, Dd, Dd, Dd, Dd, Dd, Dd, Dd, Dd, Hd, Hd, Hd, Dd, Dd, Dd, Dd, Dd, Dd, Hd, Hd, Md, Md, Md, Md, Md^Xm, Md, Md, Md, Hd, Hd, Hd, Dd, Dd, Dd, Dd, Dd, Dd, Dd, Dd, Dd, Dd, Dd, Dd, Dd, Dd, Dd, Dd, Dd, Dd, Dd, Dd, Hd, Hd, Hd, Hd, Hd, Dd, Dd, Dd, Hd, Hd, Hd, Hd, Hd, Hd, Dd
Md, Md, Md, Md, Md, Md, Md, Md, Md, Md, Md, Md, Md, Md, Hd, Hd, Hd, Hd, Hd, Hd, Hd, Hd, Hd, Hd, Hd, Dd, Dd, Dd, Dd, Dd, Dd, Dd, Hd, Hd, Hd, Hd, Hd, Hd, Hd, Hd, Dd, Dd, Dd, Dd, Dd, Dd, Hd, Hd, Md, Md, Md, Md, Md, Md, Hd, Hd, Hd, Hd, Dd, Dd, Dd, Dd, Ce, Dd, Dd, Dd, Dd, Dd, Dd, Dd, Dd, Dd, Dd, Dd, Dd, Dd, Dd, Hd, Hd, Hd, Hd, Hd, Hd, Dd, Dd, Dd, Dd, Hd, Dd, Hd, Hd, Hd, Dd
Md, Md, Md, Md, Md, Md, Md, Md, Md, Md, Md, Md, Md, Md, Md, Hd, Hd, Hd, Hd, Hd, Hd, Hd, Hd, Hd, Hd, Dd, Dd, Dd, Dd, Dd, Dd, Hd, Hd, Hd, Hd, Hd, Hd, Hd, Hd, Hd, Hd, Dd, Dd, Dd, Dd, Dd, Hd, Hd, Hd, Md, Hd, Md, Hd, Hd, Hd, Hd, Dd, Dd, Dd, Dd, Dd, Ce, 4 Ket, Ce, Dd, Dd, Dd, Dd, Dd, Dd, Dd, Dd^Edp, Dd, Dd, Dd, Dd, Hd, Hd, Hd, Hd, Dd, Hd, Hd, Hd, Dd, Dd, Dd, Dd, Dd, Hd, Hd, Hd, Dd
Md, Md, Md, Md, Md, Md, Md, Md, Md, Md, Md, Md, Md, Md, Md, Md, Md, Hd, Hd, Hd, Hd, Hd, Hd, Hd, Hd, Hd, Dd, Dd, Dd, Dd, Dd, Hd, Hd, Hd, Hd, Hd, Hd, Hd, Hd, Hd, Hd, Dd, Dd, Dd, Dd, Dd, Dd, Hd, Hd, Hd, Hd, Hd, Hd, Hd, Hd, Dd, Dd, Dd, Dd, Dd, Dd, Ce, Ce, Ce, Dd, Dd, Dd, Dd, Dd, Dd, Dd, Dd, Dd, Dd, Dd, Dd, Hd, Hd, Hd, Dd, Dd, Hd, Hd, Hd, Hd, Dd, Dd, Dd, Dd, Dd, Dd, Dd, Dd
Md, Md, Md, Md, Md, Md, Md, Md, Md, Md, Md, Md, Md, Md, Md, Md, Md, Hd, Hd, Hd, Hd, Hd, Hd, Hd, Hd, Hd, Dd, Dd, Dd, Dd^Edp, Dd, Dd, Hd, Hd, Hd, Hd, Hd, Hd, Hd, Hd, Hd, Hd, Dd, Dd, Dd, Dd, Dd, Dd, Dd, Dd, Dd, Dd, Dd, Dd, Dd, Dd, Dd, Dd, Dd, Dd, Dd, Dd, Dd, Dd, Dd, Dd, Dd, Dd^Vdt, Dd, Dd, Dd, Dd, Dd, Dd, Hd, Hd, Hd, Hd, Dd, Dd, Dd, Dd, Hd, Hd, Hd, Dd, Dd, Dd, Hd, Dd, Dd, Dd, Dd
Md, Md, Md, Md, Md, Md, Md, Md, Md, Md, Md, Md, Md, Md, Md, Md, Md, Md, Md, Md, Md, Hd, Md, Hd, Hd, Hd, Hd, Dd, Dd, Dd, Dd, Dd, Dd, Hd, Hd, Hd, Hd, Hd, Hd, Hd, Hd, Hd, Hd, Dd, Dd, Dd, Dd^Edp, Dd, Dd, Dd, Dd, Dd, Dd, Dd, Dd, Dd, Dd, Dd^Vdt, Dd, Dd, Dd, Dd, Dd, Dd, Dd, Dd, Dd, Dd, Dd, Dd, Dd, Dd, Hd, Hd, Hd, Hd, Hd, Dd, Hd, Dd, Hd, Hd, Hd, Hd, Hd, Dd, Dd, Hd, Hd, Hd, Hd, Dd, Dd
Md, Md, Md, Md, Md, Md, Md, Md, Md, Md, Md, Md, Md, Md, Md, Md, Md, Md, Md, Md, Md, Md, Md, Hd, Hd, Hd, Hd, Dd, Dd, Dd, Dd, Dd, Dd, Hd, Hd, Hd, Hd, Hd, Hd, Hd, Hd, Hd, Hd, Dd, Dd, Dd, Dd, Dd, Dd, Dd, Dd, Dd, Dd, Dd, Dd, Dd, Dd, Dd, Dd, Dd, Dd, Dd, Dd, Dd, Dd, Dd, Dd, Dd, Dd, Dd, Dd, Dd, Hd, Hd, Hd, Hd, Hd, Hd, Hd, Hd, Hd, Hd, Hd, Hd, Dd, Dd, Dd, Hd, Hd, Hd, Hd, Hd, Hd
Md, Md, Md, Md, Md, Md, Md, Md, Md, Md, Md, Md, Md, Md, Md, Md, Md, Md, Md, Md, Dd, Md, Dd, Hd, Hd, Hd, Hd, Dd, Dd, Dd, Dd, Dd, Dd, Dd, Dd, Hd, Dd, Hd, Dd, Hd, Hd, Hd, Dd, Dd, Dd, Dd, Dd, Dd, Dd, Dd, Dd, Dd, Dd, Dd, Dd, Dd, Dd, Dd, Dd, Dd, Dd, Dd, Dd, Dd, Dd, Dd, Dd, Dd, Dd, Dd, Dd, Dd, Dd, Hd, Dd, Hd, Hd, Hd, Hd, Hd, Dd, Hd, Dd, Dd, Dd, Dd, Dd, Hd, Hd, Hd, Hd, Hd, Hd
