border_size=1
usage=map

Xue, Xue, Xue, Xue, Xue, Xue, Xue, Xue, Xue, Xue, Xue, Xue, Xue, Xue, Xue, Xue, Xue, Xue, Xue, Xue, Xue, Xue, Xue, Xue, Xue, Xue, Xue, Xue, Xue, Xue, Xue, Xue, Xue, Xue, Xue, Xue, Xue, Xue, Xue, Xue, Xue, Xue
Xue, Xue, Xue, Xue, Xue, Xue, Xue, Xue, Xue, Xue, Xue, Xue, Xue, Xue, Xue, Xue, Xue, Xue, Xue, Xue, Xue, Xue, Xue, Xue, Xue, Xue, Xue, Xue, Xue, Xue, Xue, Xue, Xue, Xue, Xue, Xue, Xue, Xue, Xue, Xue, Xue, Xue
Xue, Xue, Xue, Xue, Xue, Xue, Xue, Xue, Xue, Xue, Xue, Xue, Xue, Xue, Xue, Xue, Xue, Xue, Xue, Xue, Hd^Ii, Hd^Ii, Hd^Ii, Xue, Xue, Xue, Xue, Xue, Xue, Xue, Xue, Xue, Xue, Xue, Xue, Xue, Xue, Xue, Xue, Xue, Xue, Xue
Xue, Xue, Xue, Xue, Xue, Xue, Xue, Xue, Xue, Xue, Xue, Xue, Xue, Xue, Xue, Xue, Xue, Xue, Hd, Hd^Ii, Dd^Ii, Hd^Ii, Dd^Ii, Hd^Ii, Hd^Ii, Xue, Xue, Xue, Xue, Xue, Xue, Xue, Xue, Xue, Xue, Xue, Xue, Xue, Xue, Xue, Xue, Xue
Xue, Xue, Xue, Xue, Xue, Xue, Xue, Xue, Xue, Xue, Xue, Xue, Xue, Xue, Xue, Xue, Hd, Hd, Hd, Hd^Ii, Xue^Ii, Dd^Ii, Dd^Ii, Hd^Ii, Hd^Ii, Hd^Ii, Hd^Ii, Xue, Xue, Xue, Xue, Xue, Xue, Xue, Xue, Xue, Xue, Xue, Xue, Xue, Xue, Xue
Xue, Xue, Xue, Xue, Xue, Xue, Xue, Xue, Xue, Xue, Xue, Xue, Xue, Xue, Hd, Hd, Hd, Hd, Dd, Dd^Ii, Uh^Ii, Xue^Ii, Dd^Ii, Dd^Ii, Dd^Ii, Hd^Ii, Hd^Ii, Hd^Ii, Hd^Ii, Xue, Xue, Xue, Xue, Xue, Xue, Xue, Xue, Xue, Xue, Xue, Xue, Xue
Xue, Xue, Xue, Xue, Xue, Xue, Xue, Xue, Xue, Xue, Xue, Xue, Hd, Hd, Hd, Hd, Dd, Dd, Xue, Dd^Ii, Uue^Ii, Uh^Ii, Dd^Ii, Xue^Ii, Uh, Dd^Ii, Dd^Ii, Dd^Ii, Dd, Hd^Ii, Hd^Ii, Xue, Xue, Xue, Xue, Xue, Xue, Xue, Xue, Xue, Xue, Xue
Xue, Xue, Xue, Xue, Xue, Xue, Xue, Xue, Xue, Xue, Hd, Hd, Hd, Hd, Xue, Dd, Uh, Dd, Uh, Xue, Uue, Xue^Ii, Uue, Uue^Ii, Uue^Ii, Xue^Ii, Dd^Ii, Xue^Ii, Dd, Hd^Ii, Hd, Hd^Ii, Hd^Ii, Xue, Xue, Xue, Xue, Xue, Xue, Xue, Xue, Xue
Xue, Xue, Xue, Xue, Xue, Xue, Xue, Xue, Xue, Xue, Hd, Hd, Dd, Dd, Dd, Xue, Uue, Uh, Xue, Xue, Xue, Dd, Dd, Uue^Ii, Xue^Ii, Xue^Ii, Uue, Dd^Ii, Dd^Ii, Xue^Ii, Dd, Hd^Ii, Hd, Hd^Ii, Hd^Ii, Xue, Xue, Xue, Xue, Xue, Xue, Xue
Xue, Xue, Xue, Xue, Xue, Xue, Xue, Xue, Hd, Hd, Dd, Dd, Uh, Uh, Xue, Xue, Uue, Uue, Xue, Uh, Uh, Dd, Xue, Xue^Ii, Dd^Ii, Uue, Uue^Ii, Uue^Ii, Xue^Ii, Dd^Ii, Dd^Ii, Xue^Ii, Hd, Hd^Ii, Xue^Ii, Hd, Hd^Ii, Xue, Xue, Xue, Xue, Xue
Xue, Xue, Xue, Xue, Xue, Xue, Xue, Xue, Hd, Hd, Dd, Dd, Uh, Xue, Uue, Uue, Dd, Uue, Uue, Dd, Dd, Dd, Dd, Dd^Ii, Uh^Ii, Xue^Ii, Dd, Xue^Ii, Xue^Ii, Uh, Uue, Dd^Ii, Dd^Ii, Dd^Ii, Dd^Ii, Dd, Dd^Ii, Hd^Ii, Xue, Xue, Xue, Xue
Xue, Xue, Xue, Xue, Xue, Xue, Hd, Hd, Hd, Xue, Dd, Dd, Uue, Xue, Uue, Uue, Dd, Dd, Xue, Uue, Xue^Ii, Uh^Ii, Xue^Ii, Uh, Xue^Ii, Uh, Dd^Ii, Uue^Ii, Uue^Ii, Xue^Ii, Xue^Ii, Uue, Xue^Ii, Dd^Ii, Xue^Ii, Dd^Ii, Dd^Ii, Hd^Ii, Xue, Xue, Xue, Xue
Xue, Xue, Xue, Xue, Xue, Xue, Hd, Hd, Dd, Xue, Uue, Uue, Dd, Uue, Dd, Xue, Dd, Dd, Uh, Uh, Qlf^Ii, Dd^Ii, Dd^Ii, Uh, Dd^Ii, Qlf^Ii, Xue^Ii, Uue^Ii, Dd, Uue^Ii, Dd^Ii, Uue, Uh^Ii, Xue^Ii, Xue^Ii, Dd, Xue^Ii, Hd, Xue, Xue, Xue, Xue
Xue, Xue, Xue, Xue, Xue, Xue, Hd, Dd, Xue, Xue, Uue, Dd, Uue, Uue, Dd, Uh, Uh, Dd, Uh, Xue, Xue, Dd^Ii, Uh, Dd^Ii, Xue^Ii, Qlf^Ii, Uh^Ii, Xue^Ii, Xue^Ii, Dd, Uue, Dd^Ii, Uue, Uh^Ii, Xue^Ii, Dd, Dd^Ii, Hd^Ii, Xue, Xue, Xue, Xue
Xue, Xue, Xue, Xue, Xue, Hd, Hd, Dd, Xue, Uh, Uue, Xue, Xue, Dd, Uue, Xue, Xue, Dd, Dd, Xue, Xue, Xue, Uh, Uh^Ii, Uh^Ii, Qlf^Ii, Xue^Ii, Qlf^Ii, Qlf^Ii, Xue^Ii, Uue, Xue^Ii, Xue^Ii, Uue, Xue^Ii, Dd, Xue^Ii, Hd, Xue, Xue, Xue, Xue
Xue, Xue, Xue, Xue, Xue, Hd, Hd, Dd, Dd, Uh, Uue, Xue, Xue, Uue, Uue, Uue, Xue, Uh, Dd, Xue, Uue, Qlf^Ii, Xue^Ii, Uue^Ii, Qlf^Ii, Uue^Ii, Uue^Ii, Uue, Uue^Ii, Xue^Ii, Qlf^Ii, Uue^Ii, Xue^Ii, Uue, Uue^Ii, Dd^Ii, Dd^Ii, Hd, Hd^Ii, Xue, Xue, Xue
Xue, Xue, Xue, Xue, Xue, Hd, Hd, Dd, Dd, Uh, Xue, Xue, Uue, Uue, Xue, Uue, Xue, Xue, Uue, Xue, Qlf^Ii, Qlf^Ii, Uue^Ii, Qlf^Ii, Uue^Ii, Uue^Ii, Uue^Ii, Uue^Ii, Xue^Ii, Uue^Ii, Uue, Uue^Ii, Xue^Ii, Uue, Uue, Dd^Ii, Uh^Ii, Dd^Ii, Hd^Ii, Hd^Ii, Xue, Xue
Xue, Xue, Xue, Xue, Xue, Hd, Hd, Dd, Xue, Xue, Uh, Uue, Xue, Uue, Dd, Dd, Dd, Uue, Uue, Xue^Ii, Qlf^Ii, Uue^Ii, Xue^Ii, Qlf^Ii, Uue^Ii, Qlf^Ii, Xue^Ii, Uue^Ii, Qlf^Ii, Xue^Ii, Xue^Ii, Uue, Uue^Ii, Xue^Ii, Dd^Ii, Dd^Ii, Xue^Ii, Dd, Hd^Ii, Hd^Ii, Xue, Xue
Xue, Xue, Xue, Xue, Xue, Hd, Hd, Dd, Xue, Xue, Uh, Uue, Uue, Dd, Xue, Dd, Dd, Uue, Xue^Ii, Uue^Ii, Uue^Ii, Uh^Ii, Uue^Ii, Uue, Qlf^Ii, Qlf^Ii, Uue^Ii, Qlf^Ii, Dd^Ii, Uh^Ii, Xue^Ii, Uue, Dd, Uue^Ii, Uh, Xue^Ii, Xue^Ii, Dd, Hd^Ii, Hd^Ii, Xue, Xue
Xue, Xue, Xue, Xue, Xue, Xue, Hd, Dd, Dd, Xue, Dd, Xue, Uue, Dd, Uue, Uue, Xue, Uue, Dd^Ii, Qlf^Ii, Xue^Ii, Uh^Ii, Qlf^Ii, Uue^Ii, Xue^Ii, Uue, Uh^Ii, Qlf^Ii, Uh^Ii, Xue^Ii, Uh, Dd, Uh^Ii, Xue^Ii, Dd, Uh, Xue^Ii, Dd, Dd^Ii, Hd^Ii, Xue, Xue
Xue, Xue, Xue, Xue, Xue, Xue, Hd, Hd, Hd, Dd, Dd, Uh, Dd, Uue, Uue, Uue, Xue, Xue, Uue, Dd^Ii, Xue^Ii, Qlf^Ii, Uh, Qlf^Ii, Uh, Uh, Uh^Ii, Dd^Ii, Dd^Ii, Xue^Ii, Dd, Dd, Xue^Ii, Xue^Ii, Dd, Dd^Ii, Uh^Ii, Dd, Dd^Ii, Hd^Ii, Xue, Xue
Xue, Xue, Xue, Xue, Xue, Xue, Xue, Hd, Hd, Hd, Hd, Dd, Xue, Uue, Uue, Dd, Dd, Uue, Uue, Dd^Ii, Uh^Ii, Xue^Ii, Xue^Ii, Xue^Ii, Uue, Uh^Ii, Xue^Ii, Xue^Ii, Dd^Ii, Uue^Ii, Uue^Ii, Dd^Ii, Xue^Ii, Uh, Uue, Dd^Ii, Uh^Ii, Dd^Ii, Hd^Ii, Hd^Ii, Xue, Xue
Xue, Xue, Xue, Xue, Xue, Xue, Xue, Xue, Hd, Hd, Hd, Dd, Dd, Uue, Xue, Uue, Dd, Uue, Uue, Dd^Ii, Dd^Ii, Uh^Ii, Dd^Ii, Xue^Ii, Uue, Qlf^Ii, Xue^Ii, Uh, Dd^Ii, Xue^Ii, Uue, Uue^Ii, Xue^Ii, Xue^Ii, Uue, Dd^Ii, Dd^Ii, Dd^Ii, Hd^Ii, Hd^Ii, Xue, Xue
Xue, Xue, Xue, Xue, Xue, Xue, Xue, Xue, Xue, Hd, Hd, Dd, Dd, Uue, Xue, Uue, Xue, Xue, Xue, Uue^Ii, Uue^Ii, Dd^Ii, Uue^Ii, Uue^Ii, Dd^Ii, Uue^Ii, Uue^Ii, Uue^Ii, Dd^Ii, Xue^Ii, Xue^Ii, Uue, Uue^Ii, Dd^Ii, Uue^Ii, Uue^Ii, Dd^Ii, Dd^Ii, Hd^Ii, Hd^Ii, Xue, Xue
Xue, Xue, Xue, Xue, Xue, Xue, Xue, Xue, Xue, Xue, Hd, Hd, Dd, Xue, Uh, Uue, Dd, Uh, Xue, Uue, Xue^Ii, Uue, Xue^Ii, Uue^Ii, Dd^Ii, Uue^Ii, Xue^Ii, Uue, Dd^Ii, Uh^Ii, Uue^Ii, Uue, Dd^Ii, Dd^Ii, Uue, Dd^Ii, Dd^Ii, Hd^Ii, Hd^Ii, Hd^Ii, Xue, Xue
Xue, Xue, Xue, Xue, Xue, Xue, Xue, Xue, Xue, Xue, Hd, Hd, Dd, Xue, Xue, Uh, Dd, Uh, Xue, Uue, Uue, Uue^Ii, Xue^Ii, Dd, Uh^Ii, Xue^Ii, Xue^Ii, Xue^Ii, Uue, Dd^Ii, Uue^Ii, Uue^Ii, Uh^Ii, Xue^Ii, Xue^Ii, Dd, Hd^Ii, Hd^Ii, Xue, Xue, Xue, Xue
Xue, Xue, Xue, Xue, Xue, Xue, Xue, Xue, Xue, Xue, Hd, Hd, Hd, Dd, Dd, Xue, Uue, Dd, Uue, Uue, Uue, Uue^Ii, Xue^Ii, Uue, Uue, Xue^Ii, Uue, Uue, Uue^Ii, Xue^Ii, Xue^Ii, Xue^Ii, Xue^Ii, Xue^Ii, Xue^Ii, Hd, Hd^Ii, Hd^Ii, Xue, Xue, Xue, Xue
Xue, Xue, Xue, Xue, Xue, Xue, Xue, Xue, Xue, Xue, Xue, Hd, Hd, Dd, Dd, Uue, Dd, Dd, Uue, Uue, Xue, Xue^Ii, Uh, Uue, Dd^Ii, Uue^Ii, Uue^Ii, Uue^Ii, Uue^Ii, Xue^Ii, Dd^Ii, Xue^Ii, Hd^Ii, Hd^Ii, Hd^Ii, Hd, Xue, Xue, Xue, Xue, Xue, Xue
Xue, Xue, Xue, Xue, Xue, Xue, Xue, Xue, Xue, Xue, Xue, Xue, Hd, Hd, Dd, Xue, Xue, Uue, Dd, Xue, Xue, Uh, Xue^Ii, Dd, Dd^Ii, Xue^Ii, Xue^Ii, Uue^Ii, Xue^Ii, Uue^Ii, Dd^Ii, Dd^Ii, Hd^Ii, Hd^Ii, Xue, Xue, Xue, Xue, Xue, Xue, Xue, Xue
Xue, Xue, Xue, Xue, Xue, Xue, Xue, Xue, Xue, Xue, Xue, Xue, Hd, Hd, Hd, Dd, Xue, Uue, Dd, Uue, Uue, Xue^Ii, Uue^Ii, Uue^Ii, Dd^Ii, Uh^Ii, Uh^Ii, Xue^Ii, Xue^Ii, Xue^Ii, Dd, Hd^Ii, Xue, Xue, Xue, Xue, Xue, Xue, Xue, Xue, Xue, Xue
Xue, Xue, Xue, Xue, Xue, Xue, Xue, Xue, Xue, Xue, Xue, Xue, Xue, Hd, Hd, Xue, Xue, Uue, Uue, Dd, Uue^Ii, Uue^Ii, Uue^Ii, Uue^Ii, Uh, Dd^Ii, Dd^Ii, Uh^Ii, Xue^Ii, Xue^Ii, Hd, Hd^Ii, Xue, Xue, Xue, Xue, Xue, Xue, Xue, Xue, Xue, Xue
Xue, Xue, Xue, Xue, Xue, Xue, Xue, Xue, Xue, Xue, Xue, Xue, Xue, Xue, Hd, Hd, Hd, Xue, Uue, Dd, Xue^Ii, Xue^Ii, Dd, Xue^Ii, Uh, Dd^Ii, Hd^Ii, Xue^Ii, Hd, Hd, Hd^Ii, Hd^Ii, Xue, Xue, Xue, Xue, Xue, Xue, Xue, Xue, Xue, Xue
Xue, Xue, Xue, Xue, Xue, Xue, Xue, Xue, Xue, Xue, Xue, Xue, Xue, Xue, Xue, Hd, Hd, Hd, Dd, Dd, Xue^Ii, Uh, Dd^Ii, Dd^Ii, Hd^Ii, Hd^Ii, Hd^Ii, Hd^Ii, Hd^Ii, Hd^Ii, Xue, Xue, Xue, Xue, Xue, Xue, Xue, Xue, Xue, Xue, Xue, Xue
Xue, Xue, Xue, Xue, Xue, Xue, Xue, Xue, Xue, Xue, Xue, Xue, Xue, Xue, Xue, Xue, Xue, Hd, Hd, Dd, Xue^Ii, Dd, Dd^Ii, Hd^Ii, Xue, Hd^Ii, Xue, Xue, Xue, Xue, Xue, Xue, Xue, Xue, Xue, Xue, Xue, Xue, Xue, Xue, Xue, Xue
Xue, Xue, Xue, Xue, Xue, Xue, Xue, Xue, Xue, Xue, Xue, Xue, Xue, Xue, Xue, Xue, Xue, Hd, Hd, Dd, Dd^Cov, Dd, Hd, Hd, Xue, Xue, Xue, Xue, Xue, Xue, Xue, Xue, Xue, Xue, Xue, Xue, Xue, Xue, Xue, Xue, Xue, Xue
Xue, Xue, Xue, Xue, Xue, Xue, Xue, Xue, Xue, Xue, Xue, Xue, Xue, Xue, Xue, Xue, Xue, Hd, Hd, Dd^Cov, 1 Dd^Kov, Dd^Cov, Hd, Xue, Xue, Xue, Xue, Xue, Xue, Xue, Xue, Xue, Xue, Xue, Xue, Xue, Xue, Xue, Xue, Xue, Xue, Xue
Xue, Xue, Xue, Xue, Xue, Xue, Xue, Xue, Xue, Xue, Xue, Xue, Xue, Xue, Xue, Xue, Xue, Hd, Hd, Hd^Cov, Hd^Cov, Hd^Cov, Hd, Xue, Xue, Xue, Xue, Xue, Xue, Xue, Xue, Xue, Xue, Xue, Xue, Xue, Xue, Xue, Xue, Xue, Xue, Xue
Xue, Xue, Xue, Xue, Xue, Xue, Xue, Xue, Xue, Xue, Xue, Xue, Xue, Xue, Xue, Xue, Xue, Xue, Xue, Hd, Hd, Hd, Xue, Xue, Xue, Xue, Xue, Xue, Xue, Xue, Xue, Xue, Xue, Xue, Xue, Xue, Xue, Xue, Xue, Xue, Xue, Xue
Xue, Xue, Xue, Xue, Xue, Xue, Xue, Xue, Xue, Xue, Xue, Xue, Xue, Xue, Xue, Xue, Xue, Xue, Xue, Xue, Xue, Xue, Xue, Xue, Xue, Xue, Xue, Xue, Xue, Xue, Xue, Xue, Xue, Xue, Xue, Xue, Xue, Xue, Xue, Xue, Xue, Xue
Xue, Xue, Xue, Xue, Xue, Xue, Xue, Xue, Xue, Xue, Xue, Xue, Xue, Xue, Xue, Xue, Xue, Xue, Xue, Xue, Xue, Xue, Xue, Xue, Xue, Xue, Xue, Xue, Xue, Xue, Xue, Xue, Xue, Xue, Xue, Xue, Xue, Xue, Xue, Xue, Xue, Xue
Xue, Xue, Xue, Xue, Xue, Xue, Xue, Xue, Xue, Xue, Xue, Xue, Xue, Xue, Xue, Xue, Xue, Xue, Xue, Xue, Xue, Xue, Xue, Xue, Xue, Xue, Xue, Xue, Xue, Xue, Xue, Xue, Xue, Xue, Xue, Xue, Xue, Xue, Xue, Xue, Xue, Xue
