border_size=1
usage=map

Mm, Mm, Mm, Mm, Mm, Mm, Mm, Mm, Mm, Mm, Mm, Mm, Mm, Mm, Mm, Mm, Mm, Mm, Mm, Mm, Mm, Gg, Hh^Fp, Gll^Fp, Rp, Hh^Fp, Mm, Mm, Mm, Mm, Mm, Mm, Mm, Ww, Mm, Mm, Mm, Mm, Mm, Mm, Mm, Mm, Mm, Mm, Mm, Mm, Mm, Mm, Mm, Mm, Mm
Mm, Mm, Mm, Mm, Mm, Mm, Mm, Mm, Mm, Mm, Mm, Mm, Mm, Mm, Mm, Mm, Mm, Mm, Mm, Mm, Mm, Mm, Hh^Fp, Gll^Fp, Rp, Hh^Fp, Mm, Mm, Mm, Mm, Mm, Mm, Mm, Ww, Mm, Mm, Mm, Mm, Mm, Mm, Mm, Mm, Mm, Mm, Mm, Mm, Mm, Mm, Mm, Mm, Mm
Mm, Mm, Mm, Mm, Mm, Mm, Mm, Mm, Mm, Mm, Mm, Mm, Mm, Mm, Mm, Mm, Mm, Mm, Mm, Mm, Mm, Mm, Hh^Fp, Gll^Fp, Rp, Hh^Fp, Mm, Mm, Mm, Mm, Mm, Mm, Mm, Ww, Ww, Mm, Ww, Mm, Mm, Mm, Mm, Mm, Mm, Mm, Mm, Mm, Mm, Mm, Mm, Mm, Mm
Mm, Mm, Mm, Mm, Mm, Mm, Mm, Mm, Mm, Mm, Mm, Mm, Mm, Mm, Mm, Mm, Mm, Mm, Mm, Mm, Hh^Fp, Hh^Fp, Gll^Fp, Rp, Hh^Fp, Mm, Mm, Mm, Mm, Mm, Mm, Mm, Mm, Ww, Ww, Ww, Ww, Ww, Ww, Mm, Ww, Ww, Ww, Mm, Mm, Mm, Mm, Mm, Mm, Mm, Mm
Mm, Mm, Mm, Mm, Mm, Mm, Mm, Mm, Mm, Mm, Mm, Mm, Mm, Mm, Mm, Mm, Mm, Mm, Gll^Fp, Hh^Fp, Gll^Fp, Gll^Fp, Rp, Rp, Hh^Fp, Mm, Mm, Mm, Mm, Mm, Mm, Mm, Mm, Mm, Mm, Ww, Ww, Ww, Ww, Ww, Mm, Ww, Ww, Wwg, Ww, Hh^Fp, Mm, Mm, Mm, Mm, Mm
Mm, Mm, Mm, Mm, Mm, Mm, Mm, Mm, Mm, Mm, Hh^Fp, Mm, Gll^Fp, Gll^Fp, Gll^Fp, Gll^Fp, Gll^Fp, Gll^Fp, Hh^Fp, Gll^Fp, Gll^Fp, Rp, Gll^Fp, Hh^Fp, Mm, Mm, Mm, Mm, Mm, Mm, Mm, Mm, Mm, Mm, Mm, Mm, Mm, Ww, Ww, Mm, Mm, Mm, Mm, Wwg, Wwg, Ww, Ww, Mm, Mm, Mm, Mm
Mm, Mm, Mm, Mm, Mm, Mm, Mm, Mm, Hh^Fp, Hh^Fp, Gll^Fp, Gll^Fp, Mm, Mm, Mm, Mm, Mm, Mm, Mm, Hh^Fp, Gll^Fp, Rp, Gll^Fp, Hh^Fp, Mm, Mm, Mm, Mm, Mm, Mm, Mm, Mm, Mm, Mm, Mm, Mm, Mm, Ww, Ww, Mm, Mm, Mm, Mm, Mm, Mm, Wwg, Wwg, Mm, Mm, Mm, Mm
Mm, Mm, Mm, Mm, Mm, Mm, Hh^Fp, Hh^Fp, Gll^Fp, Gll^Fp, Gll^Fp, Gll^Fp, Mm, Mm, Mm, Mm, Mm, Mm, Mm, Hh^Fp, Gll^Fp, Rp, Gll^Fp, Hh^Fp, Mm, Mm, Mm, Mm, Mm, Mm, Mm, Mm, Mm, Mm, Gll^Fp, Mm, Gll^Fp, Ww, Ww, Hh^Fp, Mm, Mm, Mm, Mm, Mm, Ww, Wwg, Mm, Mm, Mm, Mm
Mm, Mm, Mm, Mm, Mm, Hh^Fp, Gll^Fp, Gll^Fp, Gll^Fp, Gll^Fp, Gll^Fp, Gll^Fp, Gll^Fp, Mm, Mm, Mm, Mm, Mm, Hh^Fp, Hh^Fp, Gll^Fp, Rp, Gll^Fp, Gll^Fp, Gll^Fp, Mm, Mm, Mm, Gll^Fp, Gll^Fp, Gll^Fp, Gll^Fp, Gll^Fp, Gll^Fp, Gll^Fp, Gll^Fp, Gll^Fp, Ww, Ww, Hh^Fp, Hh^Fp, Mm, Mm, Mm, Mm, Mm, Ww, Wwg, Wwg, Mm, Gd
Mm, Mm, Mm, Mm, Hh^Fp, Hh^Fp, Gll^Fp, Gll^Fp, Gll^Fp, Gll^Fp, Gll^Fp, Gll^Fp, Gll^Fp, Gll^Fp, Gll^Fp, Hh^Fp, Hh^Fp, Hh^Fp, Gll^Fp, Gll^Fp, Gll^Fp, Rp, Rp, Gll^Fp, Gll^Fp, Gll^Fp, Gll^Fp, Gll^Fp, Gll^Fp, Gll^Fp, Gll^Fp, Gll^Fp, Gll^Fp, Gll^Fp, Gll^Fp, Gll^Fp, Gll^Fp, Ds, Ww, Ww, Hh^Fp, Hh^Fp, Hh^Fp, Mm, Mm, Mm, Mm, Wwg, Ww, Wwg, Ww
Mm, Mm, Mm, Mm, Hh^Fp, Gll^Fp, Mm, Hh^Fp, Hh^Fp, Gll^Fp, Hh^Fp, Gll^Fp, Hh^Fp, Hh^Fp, Hh^Fp, Gll^Fp, Gll^Fp, Gll^Fp, Gll^Fp, Gll^Fp, Gll^Fp, Gll^Fp, Gll^Fp, Rp, Gll^Fp, Gll^Fp, Gs^Vl, Gll^Fp, Gll^Fp, Gll^Fp, Gll^Fp, Gll^Fp, Gll^Fp, Gll^Fp, Gll^Fp, Gll^Fp, Gll^Fp, Hh^Fp, Ww, Ww, Ww, Hh^Fp, Hh^Fp, Mm, Mm, Mm, Mm, Mm, Mm, Wwg, Ww
Mm, Mm, Mm, Mm, Hh^Fp, Hh^Fp, Mm, Mm, Mm, Hh^Fp, Hh^Fp, Mm, Mm, Mm, Mm, Hh^Fp, Gll^Fp, Gll^Fp, Gs^Vl, Gll^Fp, Gll^Fp, Gll^Fp, Gll^Fp, Rp, Gll^Fp, Gll^Fp, Gll^Fp, Gll^Fp, Gll^Fp, Gll^Fp, Gll^Fp, Gll^Fp, Gll^Fp, Gll^Fp, Gll^Fp, Gll^Fp, Gll^Fp, Ww, Wo, Ww, Ww, Hh^Fp, Hh^Fp, Mm, Mm, Mm, Mm, Mm, Mm, Mm, Mm
Mm, Mm, Mm, Hh^Fp, Gll^Fp, Hh^Fp, Mm, Mm, Mm, Mm, Mm, Mm, Mm, Mm, Mm, Hh^Fp, Gll^Fp, Gll^Fp, Gll^Fp, Gll^Fp, Gll^Es, Gll^Fp, Gll^Fp, Rp, Gll, Gll^Fp, Gll, Gll, Gll, Gll, Ww, Gll^Fp, Gll^Fp, Gll^Fp, Gll^Fp, Gll^Fp, Ww, Ww, Wo, Wo, Ww, Ww, Hh^Fp, Hh^Fp, Hh^Fp, Mm, Mm, Mm, Mm, Mm, Mm
Mm, Mm, Mm, Hh^Fp, Gll^Fp, Hh^Fp, Hh^Fp, Mm, Mm, Mm, Mm, Mm, Mm, Mm, Hh^Fp, Hh^Fp, Gll^Fp, Gll^Fp, Gll, Gll, Gll, Gll, Gll, Rp, Gll, Gll^Es, Ww, Ww, Ww, Ww, Ww, Ww, Ww, Gll^Fp, Ww, Ww, Ww, Ww, Wo, Wo, Ww, Ww, Ww, Hh^Fp, Hh^Fp, Hh^Fp, Hh^Fp, Mm, Mm, Mm, Mm
Mm, Mm, Hh^Fp, Hh^Fp, Gll^Fp, Gll^Fp, Gll^Fp, Hh^Fp, Mm, Mm, Mm, Mm, Mm, Mm, Hh^Fp, Gll^Fp, Gll^Fp, Ds, Ww, Ww, Ww, Ww, Ww, Ww^Bsb|, Ww, Ww, Ww, Ww, Ww, Ww, Ww, Ww, Ww, Ww, Ww, Ww, Wo, Ww, Wo, Wo, Wo, Ww, Ww, Ww, Hh^Fp, Hh^Fp, Hh^Fp, Hh^Fp, Hh^Fp, Hh^Fp, Hh^Fp
Mm, Mm, Hh^Fp, Gll^Fp, Gll^Fp, Gll^Fp, Gll^Fp, Hh^Fp, Hh^Fp, Mm, Hh^Fp, Mm, Hh^Fp, Hh^Fp, Gll^Fp, Gll^Fp, Ww, Ww, Ww, Ww, Ww, Ww, Ww, Ww^Bsb|, Ww, Ww, Cw, Ww, Gll^Fp, Kw, Kw, Ww, Ww, Ww, Ww, Ww, Wo, Wo, Wo, Wo, Wo, Wo, Ww, Ww, Gll^Fp, Gll^Fp, Gll^Fp, Hh^Fp, Gll^Fp, Hh^Fp, Hh^Fp
Hh^Fp, Hh^Fp, Gll^Fp, Gll^Fp, Gll^Fp, Gs^Vl, Gll^Fp, Gll^Fp, Gll^Fp, Hh^Fp, Gll^Fp, Hh^Fp, Gll^Fp, Gll^Fp, Ww, Ww, Ww, Ww, Kw, Cw, Cw, Kw, Mm, Cw, Mm, Kw, Mm^Xm, Cw, Cw, Gll^Fp, Gll^Fp, Gs^Vl, Ww, Ww, Ww, Wo, Wo, Wo, Wo, Wo, Wo, Wo, Ww, Ww, Gll, Gll, Gll^Fp, Gll^Fp, Gll^Fp, Gll^Fp, Gll^Fp
Gll^Fp, Gll^Fp, Gll^Fp, Gll^Fp, Hh^Fp, Gll^Fp, Gll^Fp, Gll^Fp, Gll^Fp, Gll^Fp, Gll^Fp, Gll^Fp, Ww, Ww, Ww, Ww, Ww, Ww, Cw, Ms^Xm, Cw, Mm, Mm, Cw, Mm, Mm, Mm, Cw, Ms^Xm, Cw, Gll^Fp, Gll^Fp, Ww, Ww, Ww, Ww, Wo, Wo, Wo, Wo, Wo, Wo, Wo, Ww, Ds, Gll, Gd, Gll^Fp, Gll^Fp, Gll^Fp, Gll^Fp
Hh^Fp, Gll^Fp, Hh^Fp, Hh^Fp, Mm, Hh^Fp, Hh^Fp, Gll^Fp, Gll^Fp, Gll^Fp, Ww, Ww, Ww, Ww, Ds, Ww, Ww, Kw, Ms^Xm, Ms^Xm, Cw, Mm, Cw, Cw, Mm, Rr^Vhc, Mm, Cw, Ms^Xm, Rr^Vhc, Cw, Gll^Fp, Ww, Ww, Ds, Ww, Ww, Wo, Wo, Wo, Wo, Wo, Wo, Ww, Ww, Gd, Gd, Gll^Fp, Gll^Fp, Gll^Fp, Gll^Fp
Mm, Hh^Fp, Mm, Mm, Mm, Mm, Mm, Hh^Fp, Gll^Fp, Gll^Fp, Wwf, Ww, Gll^Fp, Gll^Fp, Gll^Fp, Ww, Mm, Rr^Vhc, Ms^Xm, Mm, Rr^Vhc, Cw, Ms^Xm, Mm, Ms^Xm, Ms^Xm, Ms^Xm, Cw, Ms^Xm, Ms^Xm, Cw, Kw, Ww, Ds, Ww, Ww, Ww, Ww, Ww, Ww, Ww, Ww, Ww, Ww, Ww, Gs, Gll, Gll^Fp, Gll, Gll^Fp, Gll^Fp
Mm, Mm, Mm, Mm, Mm, Mm, Mm, Hh^Fp, Wwf, Wwf, Hh^Fp, Gll^Fp, Mm, Gll^Fp, Gll^Fp, Ww, Mm, Ms^Xm, Ms^Xm, Mm, Mm, Cw, Rr^Vhc, Ms^Xm, Ai, Ms^Xm, Mm^Xm, Cw, Rr^Vhc, Cw, Mm, Kw, Ww, Ww, Ds, Ds, Gd, Ww, Ds, Ww, Ww, Ww, Ww, Ww, Gs, Gs, Gs, Gll, Gs^Es, Gll, Gll
Mm, Mm, Mm, Mm, Mm, Mm, Mm, Hh^Fp, Wwf, Hh^Fp, Mm, Mm, Mm, Mm, Mm, Ww, Mm, Mm, Mm, Mm, Mm, Cw, Cw, Ms^Xm, Ms^Xm, Ms^Xm, Cw, Cw, Cw, Cw, Mm, Mm, Ww, Ds, Gd, Gd, Gll^Fp, Gd, Gd, Ds, Ds, Ww, Ds, Ds, Gs^Es, Gs, Gd, Gd, Gd, Gll, Gll
Mm, Mm, Mm, Mm, Mm, Mm, Hh^Fp, Hh^Fp, Wwf, Hh^Fp, Mm, Mm, Mm, Mm, Mm, Ww, Kw, Mm, Rr^Vhc, Mm, Rr^Vhc, Kw, Ms^Xm, Cw, 1 Kw, Cw, Ms^Xm, Kw, Cw, Rr^Vhc, Mm, Mm^Xm, Ww, Ww, Gd, Gll^Fp, Gll^Fp, Gll^Fp, Gll^Fp, Gd, Gd, Ww, Ds, Gs, Gs, Gd, Gll^Fp, Gd, Gll^Fp, Gll^Fp, Gll^Fp
Mm, Mm, Hh^Fp, Hh^Fp, Hh^Fp, Hh^Fp, Ww, Ww, Ww, Hh^Fp, Hh^Fp, Mm, Mm, Mm, Mm, Ww, Cw, Cw, Cw, Cw, Cw, Cw, Cw, Cw, Cw, Cw, Cw, Cw, Rr^Vhc, Cw, Cw, Mm, Kw, Ww, Gll^Fp, Gll^Fp, Gll^Fp, Gll^Fp, Gll^Fp, Gll^Fp, Gd, Ww, Ww, Gs, Gs, Gd, Gll^Fp, Gll^Fp, Gll^Fp, Gll^Fp, Gll^Fp
Mm, Mm, Hh^Fp, Hh^Fp, Ww, Ww, Ww, Ww, Hh^Fp, Hh^Fp, Mm, Mm, Mm, Mm, Gll^Fp, Ww, Kw, Mm, Mm, Mm, Mm, Cw, Kw, Ms^Xm, Ms^Xm, Ms^Xm, Kw, Cw, Mm, Mm, Mm, Cw, Kw, Ww, Hh^Fp, Hh^Fp, Hh^Fp, Gll^Fp, Gll^Fp, Gll^Fp, Gll^Fp, Gd, Ds, Ww, Gs, Gd, Gll^Fp, Gll^Fp, Gll^Fp, Gll^Fp, Gll^Fp
Hh^Fp, Hh^Fp, Hh^Fp, Ww, Ww, Ww, Hh^Fp, Hh^Fp, Mm, Mm, Mm, Mm, Mm, Mm, Mm, Ww, Ww, Mm, Mm, Mm, Mm, Mm, Rr^Vhc, Cw, Kw, Cw, Cw, Mm, Mm, Mm, Ww, Kw, Ww, Ww, Mm, Mm, Mm, Hh^Fp, Hh^Fp, Gll^Fp, Gll^Fp, Gd, Gs, Ww, Gs, Gd, Gd, Gll^Fp, Gll^Fp, Gll^Fp, Gll^Fp
Ww, Ww, Ww, Ww, Ww, Hh^Fp, Mm, Mm, Mm, Mm, Mm, Mm, Mm, Mm, Mm, Gll^Fp, Gll^Fp, Ww, Ww, Rr^Vhc, Kw, Mm, Cw, Cw, Cw, Rr^Vhc, Mm, Cw, Kw, Kw, Ww, Ww, Gll^Fp, Gll^Fp, Mm, Mm, Mm, Mm, Mm, Hh^Fp, Gll^Fp, Gd, Gs, Ww, Gs, Gs, Gs, Gd, Gd, Gll^Fp, Gll^Fp
Hh^Fp, Ww, Hh^Fp, Ww, Hh^Fp, Hh^Fp, Mm, Mm, Mm, Mm, Mm, Mm, Mm, Mm, Mm, Mm, Mm, Gll^Fp, Gll^Fp, Ww, Kw, Cw, Mm, Mm, Cw, Mm, Ww, Kw, Ww, Ww, Gll^Fp, Gll^Fp, Mm, Mm, Mm, Mm, Mm, Mm, Mm, Hh^Fp, Gll^Fp, Gd, Gs, Ww, Gs, Gs^Efm, Gs^Efm, Gs^Es, Gll, Gll^Fp, Gll^Fp
Mm, Hh^Fp, Mm, Hh^Fp, Mm, Mm, Mm, Mm, Mm, Mm, Mm, Mm, Mm, Mm, Mm, Mm, Mm, Mm, Hh^Fp, Ww, Ww, Kw, Ww, Cw, Cw, Cw, Ww, Ww, Ww, Gll^Fp, Mm, Mm, Mm, Mm, Mm, Mm, Mm, Mm, Mm, Gll^Fp, Gd, Gd, Gs, Ww, Gs, Gs^Efm, Gs, Gs^Efm, Gll, Gll, Gll
Mm, Mm, Mm, Mm, Mm, Mm, Mm, Mm, Mm, Mm, Mm, Mm, Mm, Mm, Mm, Mm, Mm, Mm, Mm, Gll^Fp, Gll^Fp, Ww, Ww, Kw, Ww^Bsb|, Kw, Ww, Ww, Gll^Fp, Gll^Fp, Mm, Mm, Mm, Mm, Mm, Mm, Mm, Mm, Mm, Gd, Gs^Gvs, Gs, Gs, Ww, Gs, Gs, Gd, Gd, Gll^Fp, Gll, Gll
Mm, Mm, Mm, Mm, Mm, Mm, Mm, Mm, Mm, Mm, Mm, Mm, Hh^Fp, Hh^Fp, Hh^Fp, Mm, Mm, Mm, Mm, Gll^Fp, Gd, Ww, Ww, Ww, Ww^Bsb|, Ww, Ww, Gll^Fp, Gll^Fp, Mm, Mm, Mm, Mm, Mm, Mm, Mm, Mm, Mm, Gs^Gvs, Gs^Gvs, Gs^Gvs, Gs^Gvs, Gs^Gvs, Ww, Gs, Gs, Gd, Gll^Fp, Gll^Fp, Gll^Fp, Gll^Fp
Mm, Mm, Mm, Mm, Mm, Mm, Mm, Mm, Mm, Mm, Mm, Mm, Hh^Fp, Hh^Fp, Hh, Hh^Fp, Hh^Fp, Hh^Fp, Hh^Fp, Hh^Fp, Gs, Gs, Gs, Ww, Rp, Ww, Gs, Gll^Fp, Hh^Fp, Mm, Mm, Mm, Mm, Mm, Mm, Mm, Gs, Gs, Gs, Gs^Gvs, Gs^Vc, Gs^Gvs, Ww, Ww, Gs, Gs, Gd, Gll^Fp, Gll^Fp, Gll^Fp, Gll^Fp
Mm, Mm, Mm, Mm, Mm, Mm, Mm, Mm, Mm, Mm, Hh^Fp, Hh^Fp, Gll^Fp, Gll^Fp, Gll^Fp, Gll^Fp, Gll^Fp, Gll^Fp, Gll^Fp, Gd, Gs, Gs, Gs, Rp, Rp, Rp, Gs, Gll^Fp, Hh^Fp, Mm, Mm, Mm, Mm, Mm, Gs^Gvs, Gs^Gvs, Gs^Gvs, Gs, Gs, Gs, Gs, Ww, Gs^Wm, Gs, Gs^Gvs, Gs, Gs, Gd, Gd, Gll^Es, Gll^Fp
Mm, Mm, Mm, Mm, Mm, Mm, Mm, Mm, Mm, Hh^Fp, Hh^Fp, Gll^Fp, Gll^Fp, Gll^Fp, Gs^Vl, Gll^Fp, Gll^Fp, Gll^Fp, Gd, Gd, Gs, Gs, Gs^Vc, Rp, Rp, Rp, Gs, Gll^Fp, Gll^Fp, Hh^Fp, Hh^Fp, Hh^Fp, Gs, Gs^Gvs, Gs^Gvs, Gs^Gvs, Gs^Vc, Gs^Gvs, Gs, Gs, Ww, Ww, Gs^Vc, Gs^Gvs, Gs^Gvs, Gs^Gvs, Gs^Gvs, Gs, Gs, Gd, Gd
Hh^Fp, Mm, Mm, Mm, Mm, Mm, Hh^Fp, Mm, Hh^Fp, Hh^Fp, Gll^Fp, Gll^Fp, Gll, Gll^Fp, Gd, Gd, Gd, Gd, Gs, Gs, Gd, Gs, Cw, Rp, Rp, Rp, Cw, Gd, Gs, Gll^Fp, Gs, Gs, Gs^Gvs, Gs, Gs, Gs^Gvs, Ww, Gs, Ww, Ww, Gs, Gs, Gs, Gs^Gvs, Gs^Gvs, Gs^Gvs, Gs, Gs, Gs, Gs, Gs
Gll^Fp, Hh^Fp, Hh^Fp, Mm, Hh^Fp, Hh^Fp, Gll^Fp, Hh^Fp, Gll^Fp, Gll^Fp, Gll^Fp, Gll, Gs, Gs, Gs, Gs, Gs, Gs, Gs, Gs^Efm, Gs, Cw, Kw, Rp, Rp, Rp, Kw, Cw, Gs^Efm, Gs, Gs^Gvs, Gs^Gvs, Gs^Gvs, Gs^Gvs, Gs^Gvs, Gs, Gs^Wm, Ww, Ww, Gs^Wm, Gs, Gs, Gs, Gs, Gs, Gs, Gs^Efm, Gs^Efm, Gd^Efm, Gs, Gs
Gll^Fp, Gll^Fp, Gll^Fp, Hh^Fp, Gll^Fp, Gll^Fp, Gll^Fp, Gll^Fp, Gll^Fp, Gll^Fp, Gd, Gd, Gs, Gs, Gd, Gs, Gs^Es, Gd^Efm, Gs^Efm, Gs, Gs^Efm, Cw, Rp, Rp, Rp, Rp, Cw, Cw, Gd, Gs, Gs, Gs^Gvs, Gs^Vc, Gs^Gvs, Ww, Gs, Ww, Ww, Gs, Ww, Gs^Gvs, Gs^Gvs, Gs^Gvs, Gs, Gs, Gs, Gs, Gs^Es, Gs^Efm, Gs, Gs
Gll^Fp, Gll^Fp, Gll^Fp, Gll^Fp, Gll^Fp, Gll^Fp, Gd, Gd, Gd, Gd, Gd, Gs, Gd, Gd, Gs, Gd, Gs, Gs, Gs^Efm, Gs^Efm, Rp, Rp, Rp, Rp, Rp, Rp, Gs, Gs, Gs, Gs, Gs, Gs, Gs, Gs, Gs, Ww, Ww, Gs, Gs, Gs^Vc, Gs^Gvs, Gs^Gvs, Gs^Gvs, Gs^Gvs, Gs, Gd, Gd, Gs, Gd, Gs, Gs
Gll^Fp, Gll^Fp, Gll, Gll^Fp, Gd, Gd, Gs, Gd, Gs^Efm, Gs, Gs^Efm, Gs, Gd, Gs, Gs^Es, Gs^Vc, Gs, Gs, Rp, Rp, Rp, Rp, Rp, Rp, Gs^Vc, Gs, Gs, Gs, Gs^Gvs, Gs^Vc, Gs^Gvs, Gs, Gs, Gs, Ww, Ww, Gs^Wm, Ww, Gs^Gvs, Gs, Gs, Gs^Gvs, Gs, Gs, Gs, Gs, Gd, Gd, Gll^Fp, Gd, Gd
Gll^Fp, Gll, Gs, Gs, Gll, Gs, Gs, Gs, Gs^Efm, Gs, Gs^Efm, Gs, Gs, Gs, Gs, Gs, Rp, Rp, Rp, Rp, Rp, Rp, Gs^Gvs, Gs^Gvs, Gs^Gvs, Gs, Gs^Cov, Gs^Gvs, Gs^Gvs, Gs^Gvs, Gs^Gvs, Gs^Gvs, Ww, Ww, Gs, Gs, Gs^Vc, Gs^Gvs, Gs^Gvs, Gs^Gvs, Gs^Gvs, Gs, Gs, Gs, Gs^Es, Gd, Gd, Gll^Fp, Gll^Fp, Gll^Fp, Gll^Fp
Gll, Gll, Gs, Gs, Gll, Gll, Gll, Gs^Es, Gs, Gs^Efm, Gd^Efm, Gd, Gs, Gs, Rp, Rp, Rp, Rp, Rp, Rp, Gs, Gs^Gvs, Gs^Gvs, Gs^Gvs, Gs^Gvs, Gs^Gvs, Gs^Cov, Gs^Cov, Gs, Gs^Gvs, Ww, Ww, Gs, Ww, Ww, Gs, Gs, Gs^Gvs, Gs^Gvs, Gs^Gvs, Gs, Gs, Gs, Gs, Gs, Gs, Gd, Gll^Fp, Gll^Fp, Gll^Fp, Gll^Fp
Gs, Gs^Es, Gll, Gll, Gll^Fp, Gll^Fp, Gll^Fp, Gll, Gd, Gs^Efm, Gs, Gd, Gs^Es, Gs, Rp, Rp, Rp, Rp, Gs, Gs, Gs^Gvs, Gs^Vc, Gs, Gs^Gvs, Ww, Gs^Cov, 2 Ds^Kov, Gs^Cov, Ww, Ww, Gs, Gs, Gs^Gvs, Gs^Gvs, Gs^Gvs, Gs, Gs, Gs, Gs, Gs, Gs, Gs, Gs, Gs, Gd, Gd, Gll^Fp, Gll^Fp, Gll^Fp, Gll^Fp, Gll^Fp
Gs, Gs, Gll, Gll^Fp, Gll^Fp, Gll^Fp, Gll^Fp, Gll^Fp, Gll^Fp, Gd, Gs, Gd, Gs, Gs, Rp, Rp, Rp, Gs, Gs^Gvs, Gs^Gvs, Gs^Gvs, Gs^Gvs, Gs^Gvs, Ww, Ww, Ww^Cov, Ww^Cov, Ww^Cov, Ww, Ds, Gs, Gs^Vc, Gs^Gvs, Gs^Gvs, Gs^Gvs, Gs^Gvs, Gs, Gs, Gs, Gs, Gs, Gs, Gs^Es, Gd, Gd, Gll^Fp, Gll^Fp, Gll^Fp, Gll^Fp, Gll^Fp, Gll^Fp
Gs, Gd, Gll^Fp, Gll^Fp, Gll^Fp, Gll^Fp, Gll^Fp, Gll^Fp, Gs^Vl, Gd, Gd, Gs, Gs, Gs, Rp, Rp, Rp, Gs, Gs, Gs^Gvs, Gs^Gvs, Gs^Gvs, Gs, Ww, Ds, Ww, Ww, Ww, Ww, Ds, Gs, Gs, Gs, Gs^Gvs, Gs, Gs, Gs, Gs, Gd, Gd, Gd, Gs, Gs, Gs, Gd, Gll^Fp, Gll^Fp, Gll^Fp, Gll^Fp, Gll^Fp, Gll^Fp
Gs, Gd, Gd, Gll^Fp, Gll^Fp, Gll^Fp, Gll^Fp, Gll^Fp, Gll^Fp, Gd, Gd, Gs, Gs, Gs, Rp, Rp, Rp, Gs, Gs, Gs, Gs, Gs, Gs, Gs, Ds, Ww, Ww, Ww, Ww, Ww, Gs, Gs, Gs, Gs, Gs, Gs, Gs, Gd, Gll^Fp, Gll^Fp, Gll^Fp, Gll, Gll, Gll, Gll, Gll^Fp, Gll^Fp, Gll^Fp, Gll^Fp, Gll^Fp, Gll
Gs, Gs, Gd, Gll^Fp, Gll^Fp, Gll^Fp, Gll^Fp, Gll^Fp, Gll^Fp, Gll^Fp, Gd, Gs, Gs, Gs, Rp, Rp, Rp, Gs, Gd, Gs, Gs, Gs, Gd, Gs, Gs, Ds, Ds, Ds, Gs, Gs, Gs^Gvs, Gs^Gvs, Gs^Gvs, Gs, Gs, Gs, Gd, Gd, Gll^Fp, Gll^Fp, Gll^Fp, Gll^Fp, Gll, Gll, Gd, Gll, Gll, Gll^Fp, Gll^Fp, Gll^Fp, Gll
Gs, Gs, Gs^Es, Gd, Gd, Gll^Fp, Gll^Fp, Gll^Fp, Gll^Fp, Gd, Gs, Gs, Gs^Es, Gs, Rp, Rp, Rp, Gs, Gs, Gs^Es, Gd, Gd, Gll^Fp, Gd, Gd, Gs, Gs, Gs, Gs, Gs^Gvs, Gs^Gvs, Gs^Gvs, Gs^Gvs, Gs^Gvs, Gs, Gd, Gll^Fp, Gll^Fp, Gll^Fp, Gll^Fp, Gll^Fp, Gll^Fp, Gll^Fp, Gll, Gll, Gd, Gd^Es, Gll, Gll, Gll, Gll
Gs, Gs, Gs, Gs, Gs, Gd, Gd, Gd, Gd, Gd, Gs, Gs, Gs, Gs, Rp, Rp, Rp, Gs, Gs, Gs, Gd, Gd, Gll^Fp, Gll^Fp, Gll^Fp, Gd, Gs^Es, Gs, Gs, Gs, Gs, Gs^Gvs, Gs, Gs, Gd, Gd, Gll^Fp, Gll^Fp, Gll^Fp, Gll^Fp, Gll^Fp, Gll^Fp, Gll^Fp, Gll^Fp, Gll^Fp, Gll, Gd, Gd, Gd, Gd, Gd
Gs, Gs, Gs, Gs, Gs, Gs, Gs, Gs, Gs, Gs, Gs, Gs, Gs, Gs, Gs, Rp, Rp, Gs, Gs, Gs, Gs, Gll^Fp, Gll^Fp, Gll^Fp, Gll^Fp, Gd, Gs, Gs, Gs, Gs, Gll^Fp, Gs, Gs, Gs, Gd, Gll^Fp, Gll^Fp, Gll^Fp, Gs, Gll^Fp, Gll^Fp, Gll^Fp, Gll^Fp, Gll^Fp, Gs, Gll, Gs, Gd, Gs, Gd, Gd
